"filename", "language", "C#", "Markdown", "XML", "JSON", "Properties", "comment", "blank", "total"
"c:\Users\chris\source\repos\Cell\Cell\App.xaml", "XML", 0, 0, 19, 0, 0, 0, 1, 20
"c:\Users\chris\source\repos\Cell\Cell\App.xaml.cs", "C#", 7, 0, 0, 0, 0, 3, 2, 12
"c:\Users\chris\source\repos\Cell\Cell\AssemblyInfo.cs", "C#", 5, 0, 0, 0, 0, 4, 2, 11
"c:\Users\chris\source\repos\Cell\Cell\Cell.csproj", "XML", 0, 0, 33, 0, 0, 0, 8, 41
"c:\Users\chris\source\repos\Cell\Cell\Common\Utilities.cs", "C#", 53, 0, 0, 0, 0, 0, 8, 61
"c:\Users\chris\source\repos\Cell\Cell\Data\Cells.cs", "C#", 105, 0, 0, 0, 0, 5, 16, 126
"c:\Users\chris\source\repos\Cell\Cell\Exceptions\PluginFunctionSyntaxTransformException.cs", "C#", 16, 0, 0, 0, 0, 0, 2, 18
"c:\Users\chris\source\repos\Cell\Cell\Exceptions\ProjectLoadException.cs", "C#", 16, 0, 0, 0, 0, 0, 2, 18
"c:\Users\chris\source\repos\Cell\Cell\Model\ApplicationSettings.cs", "C#", 60, 0, 0, 0, 0, 0, 11, 71
"c:\Users\chris\source\repos\Cell\Cell\Model\CellLocation.cs", "C#", 13, 0, 0, 0, 0, 0, 8, 21
"c:\Users\chris\source\repos\Cell\Cell\Model\CellModel.cs", "C#", 262, 0, 0, 0, 0, 2, 42, 306
"c:\Users\chris\source\repos\Cell\Cell\Model\CellModelExtensions.cs", "C#", 22, 0, 0, 0, 0, 0, 6, 28
"c:\Users\chris\source\repos\Cell\Cell\Model\CellModelFactory.cs", "C#", 34, 0, 0, 0, 0, 0, 4, 38
"c:\Users\chris\source\repos\Cell\Cell\Model\CellType.cs", "C#", 26, 0, 0, 0, 0, 0, 3, 29
"c:\Users\chris\source\repos\Cell\Cell\Model\ColorFor.cs", "C#", 12, 0, 0, 0, 0, 0, 2, 14
"c:\Users\chris\source\repos\Cell\Cell\Model\PluginFunction.cs", "C#", 131, 0, 0, 0, 0, 0, 27, 158
"c:\Users\chris\source\repos\Cell\Cell\Model\Plugin\PluginModel.cs", "C#", 23, 0, 0, 0, 0, 0, 7, 30
"c:\Users\chris\source\repos\Cell\Cell\Model\Plugin\TodoItem.cs", "C#", 59, 0, 0, 0, 0, 0, 11, 70
"c:\Users\chris\source\repos\Cell\Cell\Model\PropertyChangedBase.cs", "C#", 17, 0, 0, 0, 0, 0, 4, 21
"c:\Users\chris\source\repos\Cell\Cell\Persistence\CellLoader.cs", "C#", 59, 0, 0, 0, 0, 0, 10, 69
"c:\Users\chris\source\repos\Cell\Cell\Persistence\PersistenceManager.cs", "C#", 59, 0, 0, 0, 0, 0, 10, 69
"c:\Users\chris\source\repos\Cell\Cell\Persistence\PluginFunctionLoader.cs", "C#", 87, 0, 0, 0, 0, 0, 11, 98
"c:\Users\chris\source\repos\Cell\Cell\Persistence\UserCollectionLoader.cs", "C#", 114, 0, 0, 0, 0, 0, 20, 134
"c:\Users\chris\source\repos\Cell\Cell\Plugin\CellPopulateManager.cs", "C#", 178, 0, 0, 0, 0, 3, 24, 205
"c:\Users\chris\source\repos\Cell\Cell\Plugin\CellTriggerManager.cs", "C#", 28, 0, 0, 0, 0, 3, 5, 36
"c:\Users\chris\source\repos\Cell\Cell\Plugin\CellValueProvider.cs", "C#", 7, 0, 0, 0, 0, 0, 2, 9
"c:\Users\chris\source\repos\Cell\Cell\Plugin\CompileResult.cs", "C#", 8, 0, 0, 0, 0, 0, 3, 11
"c:\Users\chris\source\repos\Cell\Cell\Plugin\DynamicCellPluginExecutor.cs", "C#", 42, 0, 0, 0, 0, 0, 5, 47
"c:\Users\chris\source\repos\Cell\Cell\Plugin\EditContext.cs", "C#", 10, 0, 0, 0, 0, 0, 5, 15
"c:\Users\chris\source\repos\Cell\Cell\Plugin\PluginContext.cs", "C#", 32, 0, 0, 0, 0, 0, 9, 41
"c:\Users\chris\source\repos\Cell\Cell\Plugin\RoslynCompiler.cs", "C#", 68, 0, 0, 0, 0, 0, 10, 78
"c:\Users\chris\source\repos\Cell\Cell\Plugin\SyntaxRewriters\CellReferenceSyntaxWalker.cs", "C#", 69, 0, 0, 0, 0, 0, 12, 81
"c:\Users\chris\source\repos\Cell\Cell\Plugin\SyntaxRewriters\CellReferenceToCodeSyntaxWalker.cs", "C#", 89, 0, 0, 0, 0, 0, 13, 102
"c:\Users\chris\source\repos\Cell\Cell\Plugin\SyntaxRewriters\CodeToCellReferenceSyntaxRewriter.cs", "C#", 48, 0, 0, 0, 0, 0, 8, 56
"c:\Users\chris\source\repos\Cell\Cell\Plugin\SyntaxRewriters\FindAndReplaceCollectionReferencesSyntaxWalker.cs", "C#", 32, 0, 0, 0, 0, 0, 7, 39
"c:\Users\chris\source\repos\Cell\Cell\Plugin\UserCollection.cs", "C#", 49, 0, 0, 0, 0, 1, 12, 62
"c:\Users\chris\source\repos\Cell\Cell\Plugin\UserList.cs", "C#", 57, 0, 0, 0, 0, 0, 14, 71
"c:\Users\chris\source\repos\Cell\Cell\T2.md", "Markdown", 0, 4, 0, 0, 0, 0, 2, 6
"c:\Users\chris\source\repos\Cell\Cell\ViewModel\ApplicationViewModel.cs", "C#", 182, 0, 0, 0, 0, 0, 26, 208
"c:\Users\chris\source\repos\Cell\Cell\ViewModel\CellClipboard.cs", "C#", 83, 0, 0, 0, 0, 0, 10, 93
"c:\Users\chris\source\repos\Cell\Cell\ViewModel\CellLayout.cs", "C#", 110, 0, 0, 0, 0, 0, 15, 125
"c:\Users\chris\source\repos\Cell\Cell\ViewModel\Cells\CellViewModel.cs", "C#", 353, 0, 0, 0, 0, 19, 56, 428
"c:\Users\chris\source\repos\Cell\Cell\ViewModel\Cells\CellViewModelFactory.cs", "C#", 30, 0, 0, 0, 0, 0, 3, 33
"c:\Users\chris\source\repos\Cell\Cell\ViewModel\Cells\Types\ButtonCellViewModel.cs", "C#", 22, 0, 0, 0, 0, 0, 3, 25
"c:\Users\chris\source\repos\Cell\Cell\ViewModel\Cells\Types\CheckboxCellViewModel.cs", "C#", 57, 0, 0, 0, 0, 0, 11, 68
"c:\Users\chris\source\repos\Cell\Cell\ViewModel\Cells\Types\DropdownCellViewModel.cs", "C#", 39, 0, 0, 0, 0, 0, 5, 44
"c:\Users\chris\source\repos\Cell\Cell\ViewModel\Cells\Types\GraphCellViewModel.cs", "C#", 84, 0, 0, 0, 0, 3, 13, 100
"c:\Users\chris\source\repos\Cell\Cell\ViewModel\Cells\Types\LabelCellViewModel.cs", "C#", 7, 0, 0, 0, 0, 0, 1, 8
"c:\Users\chris\source\repos\Cell\Cell\ViewModel\Cells\Types\ListCellViewModel.cs", "C#", 72, 0, 0, 0, 0, 0, 7, 79
"c:\Users\chris\source\repos\Cell\Cell\ViewModel\Cells\Types\ProgressCellViewModel.cs", "C#", 32, 0, 0, 0, 0, 0, 5, 37
"c:\Users\chris\source\repos\Cell\Cell\ViewModel\Cells\Types\Special\ColumnCellViewModel.cs", "C#", 102, 0, 0, 0, 0, 0, 16, 118
"c:\Users\chris\source\repos\Cell\Cell\ViewModel\Cells\Types\Special\CornerCellViewModel.cs", "C#", 15, 0, 0, 0, 0, 0, 5, 20
"c:\Users\chris\source\repos\Cell\Cell\ViewModel\Cells\Types\Special\RowCellViewModel.cs", "C#", 87, 0, 0, 0, 0, 0, 15, 102
"c:\Users\chris\source\repos\Cell\Cell\ViewModel\Cells\Types\Special\SpecialCellViewModel.cs", "C#", 7, 0, 0, 0, 0, 0, 3, 10
"c:\Users\chris\source\repos\Cell\Cell\ViewModel\Cells\Types\TextboxCellViewModel.cs", "C#", 30, 0, 0, 0, 0, 0, 3, 33
"c:\Users\chris\source\repos\Cell\Cell\ViewModel\CodeCompletionWindowFactory.cs", "C#", 125, 0, 0, 0, 0, 3, 13, 141
"c:\Users\chris\source\repos\Cell\Cell\ViewModel\CodeEditorViewModel.cs", "C#", 16, 0, 0, 0, 0, 0, 4, 20
"c:\Users\chris\source\repos\Cell\Cell\ViewModel\RelayCommand.cs", "C#", 22, 0, 0, 0, 0, 0, 5, 27
"c:\Users\chris\source\repos\Cell\Cell\ViewModel\SheetViewModel.cs", "C#", 249, 0, 0, 0, 0, 0, 33, 282
"c:\Users\chris\source\repos\Cell\Cell\ViewModel\SheetViewModelFactory.cs", "C#", 20, 0, 0, 0, 0, 0, 2, 22
"c:\Users\chris\source\repos\Cell\Cell\View\ApplicationView.xaml", "XML", 0, 0, 119, 0, 0, 0, 4, 123
"c:\Users\chris\source\repos\Cell\Cell\View\ApplicationView.xaml.cs", "C#", 151, 0, 0, 0, 0, 0, 17, 168
"c:\Users\chris\source\repos\Cell\Cell\View\CellTextEditBar.xaml", "XML", 0, 0, 36, 0, 0, 0, 1, 37
"c:\Users\chris\source\repos\Cell\Cell\View\CellTextEditBar.xaml.cs", "C#", 20, 0, 0, 0, 0, 3, 3, 26
"c:\Users\chris\source\repos\Cell\Cell\View\CodeEditor.xaml", "XML", 0, 0, 119, 0, 0, 0, 1, 120
"c:\Users\chris\source\repos\Cell\Cell\View\CodeEditor.xaml.cs", "C#", 228, 0, 0, 0, 0, 7, 37, 272
"c:\Users\chris\source\repos\Cell\Cell\View\Controls\BetterCheckBox.cs", "C#", 58, 0, 0, 0, 0, 0, 12, 70
"c:\Users\chris\source\repos\Cell\Cell\View\Controls\BetterComboBox.cs", "C#", 16, 0, 0, 0, 0, 0, 3, 19
"c:\Users\chris\source\repos\Cell\Cell\View\Controls\generic.xaml", "XML", 0, 0, 47, 0, 0, 0, 0, 47
"c:\Users\chris\source\repos\Cell\Cell\View\Converters\BrushToColorConverter.cs", "C#", 22, 0, 0, 0, 0, 0, 3, 25
"c:\Users\chris\source\repos\Cell\Cell\View\Converters\Converters.xaml", "XML", 0, 0, 14, 0, 0, 0, 0, 14
"c:\Users\chris\source\repos\Cell\Cell\View\Converters\EnumToStringConverter.cs", "C#", 24, 0, 0, 0, 0, 1, 3, 28
"c:\Users\chris\source\repos\Cell\Cell\View\Converters\RGBHexColorConverter.cs", "C#", 32, 0, 0, 0, 0, 0, 4, 36
"c:\Users\chris\source\repos\Cell\Cell\View\EditCellPanel.xaml", "XML", 0, 0, 387, 0, 0, 0, 1, 388
"c:\Users\chris\source\repos\Cell\Cell\View\EditCellPanel.xaml.cs", "C#", 279, 0, 0, 0, 0, 3, 38, 320
"c:\Users\chris\source\repos\Cell\Cell\View\PanAndZoomCanvas.xaml", "XML", 0, 0, 11, 0, 0, 0, 1, 12
"c:\Users\chris\source\repos\Cell\Cell\View\PanAndZoomCanvas.xaml.cs", "C#", 189, 0, 0, 0, 0, 4, 28, 221
"c:\Users\chris\source\repos\Cell\Cell\View\PluginContextCompletionData.cs", "C#", 28, 0, 0, 0, 0, 1, 7, 36
"c:\Users\chris\source\repos\Cell\Cell\View\SheetView.xaml", "XML", 0, 0, 292, 0, 0, 1, 5, 298
"c:\Users\chris\source\repos\Cell\Cell\View\SheetView.xaml.cs", "C#", 155, 0, 0, 0, 0, 3, 14, 172
"c:\Users\chris\source\repos\Cell\Cell\View\Skin\ColorPicker.xaml", "XML", 0, 0, 332, 0, 0, 10, 9, 351
"c:\Users\chris\source\repos\Cell\Cell\View\Skin\Controls.xaml", "XML", 0, 0, 43, 0, 0, 0, 3, 46
"c:\Users\chris\source\repos\Cell\Cell\View\Skin\Dark.xaml", "XML", 0, 0, 8, 0, 0, 0, 2, 10
"c:\Users\chris\source\repos\Cell\Cell\View\Skin\Light.xaml", "XML", 0, 0, 8, 0, 0, 0, 0, 8
"c:\Users\chris\source\repos\Cell\Cell\View\Skin\Styles.xaml", "XML", 0, 0, 348, 0, 0, 0, 14, 362
"c:\Users\chris\source\repos\Cell\Cell\View\TitleBarSheetNavigation.xaml", "XML", 0, 0, 51, 0, 0, 0, 1, 52
"c:\Users\chris\source\repos\Cell\Cell\View\TitleBarSheetNavigation.xaml.cs", "C#", 57, 0, 0, 0, 0, 3, 5, 65
"c:\Users\chris\source\repos\Cell\Cell\View\TypeSpecificEditCellPanel.xaml", "XML", 0, 0, 48, 0, 0, 0, 1, 49
"c:\Users\chris\source\repos\Cell\Cell\View\TypeSpecificEditCellPanel.xaml.cs", "C#", 16, 0, 0, 0, 0, 3, 3, 22
"c:\Users\chris\source\repos\Cell\Cell\View\ViewUtilities.cs", "C#", 21, 0, 0, 0, 0, 0, 3, 24
"c:\Users\chris\source\repos\Cell\Cell\bin\Debug\net8.0-windows\Cell.deps.json", "JSON", 0, 0, 0, 313, 0, 0, 0, 313
"c:\Users\chris\source\repos\Cell\Cell\bin\Debug\net8.0-windows\Cell.runtimeconfig.json", "JSON", 0, 0, 0, 18, 0, 0, 0, 18
"c:\Users\chris\source\repos\Cell\Cell\obj\Cell.csproj.nuget.dgspec.json", "JSON", 0, 0, 0, 94, 0, 0, 0, 94
"c:\Users\chris\source\repos\Cell\Cell\obj\Cell.csproj.nuget.g.props", "XML", 0, 0, 23, 0, 0, 0, 0, 23
"c:\Users\chris\source\repos\Cell\Cell\obj\Cell.csproj.nuget.g.targets", "XML", 0, 0, 6, 0, 0, 0, 0, 6
"c:\Users\chris\source\repos\Cell\Cell\obj\Cell_00pilcrb_wpftmp.csproj.nuget.dgspec.json", "JSON", 0, 0, 0, 94, 0, 0, 0, 94
"c:\Users\chris\source\repos\Cell\Cell\obj\Cell_00pilcrb_wpftmp.csproj.nuget.g.props", "XML", 0, 0, 23, 0, 0, 0, 0, 23
"c:\Users\chris\source\repos\Cell\Cell\obj\Cell_00pilcrb_wpftmp.csproj.nuget.g.targets", "XML", 0, 0, 6, 0, 0, 0, 0, 6
"c:\Users\chris\source\repos\Cell\Cell\obj\Cell_023y4x5e_wpftmp.csproj.nuget.dgspec.json", "JSON", 0, 0, 0, 82, 0, 0, 0, 82
"c:\Users\chris\source\repos\Cell\Cell\obj\Cell_023y4x5e_wpftmp.csproj.nuget.g.props", "XML", 0, 0, 16, 0, 0, 0, 0, 16
"c:\Users\chris\source\repos\Cell\Cell\obj\Cell_023y4x5e_wpftmp.csproj.nuget.g.targets", "XML", 0, 0, 2, 0, 0, 0, 0, 2
"c:\Users\chris\source\repos\Cell\Cell\obj\Cell_0wt303gk_wpftmp.csproj.nuget.dgspec.json", "JSON", 0, 0, 0, 90, 0, 0, 0, 90
"c:\Users\chris\source\repos\Cell\Cell\obj\Cell_0wt303gk_wpftmp.csproj.nuget.g.props", "XML", 0, 0, 22, 0, 0, 0, 0, 22
"c:\Users\chris\source\repos\Cell\Cell\obj\Cell_0wt303gk_wpftmp.csproj.nuget.g.targets", "XML", 0, 0, 6, 0, 0, 0, 0, 6
"c:\Users\chris\source\repos\Cell\Cell\obj\Cell_1bj05i12_wpftmp.csproj.nuget.dgspec.json", "JSON", 0, 0, 0, 76, 0, 0, 0, 76
"c:\Users\chris\source\repos\Cell\Cell\obj\Cell_1bj05i12_wpftmp.csproj.nuget.g.props", "XML", 0, 0, 16, 0, 0, 0, 0, 16
"c:\Users\chris\source\repos\Cell\Cell\obj\Cell_1bj05i12_wpftmp.csproj.nuget.g.targets", "XML", 0, 0, 2, 0, 0, 0, 0, 2
"c:\Users\chris\source\repos\Cell\Cell\obj\Cell_1mhrplhv_wpftmp.csproj.nuget.dgspec.json", "JSON", 0, 0, 0, 94, 0, 0, 0, 94
"c:\Users\chris\source\repos\Cell\Cell\obj\Cell_1mhrplhv_wpftmp.csproj.nuget.g.props", "XML", 0, 0, 23, 0, 0, 0, 0, 23
"c:\Users\chris\source\repos\Cell\Cell\obj\Cell_1mhrplhv_wpftmp.csproj.nuget.g.targets", "XML", 0, 0, 6, 0, 0, 0, 0, 6
"c:\Users\chris\source\repos\Cell\Cell\obj\Cell_2b1fvgde_wpftmp.csproj.nuget.dgspec.json", "JSON", 0, 0, 0, 90, 0, 0, 0, 90
"c:\Users\chris\source\repos\Cell\Cell\obj\Cell_2b1fvgde_wpftmp.csproj.nuget.g.props", "XML", 0, 0, 22, 0, 0, 0, 0, 22
"c:\Users\chris\source\repos\Cell\Cell\obj\Cell_2b1fvgde_wpftmp.csproj.nuget.g.targets", "XML", 0, 0, 6, 0, 0, 0, 0, 6
"c:\Users\chris\source\repos\Cell\Cell\obj\Cell_2g1imaoa_wpftmp.csproj.nuget.dgspec.json", "JSON", 0, 0, 0, 90, 0, 0, 0, 90
"c:\Users\chris\source\repos\Cell\Cell\obj\Cell_2g1imaoa_wpftmp.csproj.nuget.g.props", "XML", 0, 0, 22, 0, 0, 0, 0, 22
"c:\Users\chris\source\repos\Cell\Cell\obj\Cell_2g1imaoa_wpftmp.csproj.nuget.g.targets", "XML", 0, 0, 6, 0, 0, 0, 0, 6
"c:\Users\chris\source\repos\Cell\Cell\obj\Cell_2gaspjmb_wpftmp.csproj.nuget.dgspec.json", "JSON", 0, 0, 0, 82, 0, 0, 0, 82
"c:\Users\chris\source\repos\Cell\Cell\obj\Cell_2gaspjmb_wpftmp.csproj.nuget.g.props", "XML", 0, 0, 16, 0, 0, 0, 0, 16
"c:\Users\chris\source\repos\Cell\Cell\obj\Cell_2gaspjmb_wpftmp.csproj.nuget.g.targets", "XML", 0, 0, 2, 0, 0, 0, 0, 2
"c:\Users\chris\source\repos\Cell\Cell\obj\Cell_2outgekp_wpftmp.csproj.nuget.dgspec.json", "JSON", 0, 0, 0, 90, 0, 0, 0, 90
"c:\Users\chris\source\repos\Cell\Cell\obj\Cell_2outgekp_wpftmp.csproj.nuget.g.props", "XML", 0, 0, 22, 0, 0, 0, 0, 22
"c:\Users\chris\source\repos\Cell\Cell\obj\Cell_2outgekp_wpftmp.csproj.nuget.g.targets", "XML", 0, 0, 6, 0, 0, 0, 0, 6
"c:\Users\chris\source\repos\Cell\Cell\obj\Cell_2uaiqxuk_wpftmp.csproj.nuget.dgspec.json", "JSON", 0, 0, 0, 90, 0, 0, 0, 90
"c:\Users\chris\source\repos\Cell\Cell\obj\Cell_2uaiqxuk_wpftmp.csproj.nuget.g.props", "XML", 0, 0, 22, 0, 0, 0, 0, 22
"c:\Users\chris\source\repos\Cell\Cell\obj\Cell_2uaiqxuk_wpftmp.csproj.nuget.g.targets", "XML", 0, 0, 6, 0, 0, 0, 0, 6
"c:\Users\chris\source\repos\Cell\Cell\obj\Cell_2vbwsgjg_wpftmp.csproj.nuget.dgspec.json", "JSON", 0, 0, 0, 90, 0, 0, 0, 90
"c:\Users\chris\source\repos\Cell\Cell\obj\Cell_2vbwsgjg_wpftmp.csproj.nuget.g.props", "XML", 0, 0, 22, 0, 0, 0, 0, 22
"c:\Users\chris\source\repos\Cell\Cell\obj\Cell_2vbwsgjg_wpftmp.csproj.nuget.g.targets", "XML", 0, 0, 6, 0, 0, 0, 0, 6
"c:\Users\chris\source\repos\Cell\Cell\obj\Cell_2wrhjhwo_wpftmp.csproj.nuget.dgspec.json", "JSON", 0, 0, 0, 94, 0, 0, 0, 94
"c:\Users\chris\source\repos\Cell\Cell\obj\Cell_2wrhjhwo_wpftmp.csproj.nuget.g.props", "XML", 0, 0, 23, 0, 0, 0, 0, 23
"c:\Users\chris\source\repos\Cell\Cell\obj\Cell_2wrhjhwo_wpftmp.csproj.nuget.g.targets", "XML", 0, 0, 6, 0, 0, 0, 0, 6
"c:\Users\chris\source\repos\Cell\Cell\obj\Cell_2ymv4gap_wpftmp.csproj.nuget.dgspec.json", "JSON", 0, 0, 0, 90, 0, 0, 0, 90
"c:\Users\chris\source\repos\Cell\Cell\obj\Cell_2ymv4gap_wpftmp.csproj.nuget.g.props", "XML", 0, 0, 22, 0, 0, 0, 0, 22
"c:\Users\chris\source\repos\Cell\Cell\obj\Cell_2ymv4gap_wpftmp.csproj.nuget.g.targets", "XML", 0, 0, 6, 0, 0, 0, 0, 6
"c:\Users\chris\source\repos\Cell\Cell\obj\Cell_3l0aoo2t_wpftmp.csproj.nuget.dgspec.json", "JSON", 0, 0, 0, 86, 0, 0, 0, 86
"c:\Users\chris\source\repos\Cell\Cell\obj\Cell_3l0aoo2t_wpftmp.csproj.nuget.g.props", "XML", 0, 0, 22, 0, 0, 0, 0, 22
"c:\Users\chris\source\repos\Cell\Cell\obj\Cell_3l0aoo2t_wpftmp.csproj.nuget.g.targets", "XML", 0, 0, 6, 0, 0, 0, 0, 6
"c:\Users\chris\source\repos\Cell\Cell\obj\Cell_3ygp0mfu_wpftmp.csproj.nuget.dgspec.json", "JSON", 0, 0, 0, 90, 0, 0, 0, 90
"c:\Users\chris\source\repos\Cell\Cell\obj\Cell_3ygp0mfu_wpftmp.csproj.nuget.g.props", "XML", 0, 0, 22, 0, 0, 0, 0, 22
"c:\Users\chris\source\repos\Cell\Cell\obj\Cell_3ygp0mfu_wpftmp.csproj.nuget.g.targets", "XML", 0, 0, 6, 0, 0, 0, 0, 6
"c:\Users\chris\source\repos\Cell\Cell\obj\Cell_4oqbedkb_wpftmp.csproj.nuget.dgspec.json", "JSON", 0, 0, 0, 90, 0, 0, 0, 90
"c:\Users\chris\source\repos\Cell\Cell\obj\Cell_4oqbedkb_wpftmp.csproj.nuget.g.props", "XML", 0, 0, 22, 0, 0, 0, 0, 22
"c:\Users\chris\source\repos\Cell\Cell\obj\Cell_4oqbedkb_wpftmp.csproj.nuget.g.targets", "XML", 0, 0, 6, 0, 0, 0, 0, 6
"c:\Users\chris\source\repos\Cell\Cell\obj\Cell_4r4li3l0_wpftmp.csproj.nuget.dgspec.json", "JSON", 0, 0, 0, 94, 0, 0, 0, 94
"c:\Users\chris\source\repos\Cell\Cell\obj\Cell_4r4li3l0_wpftmp.csproj.nuget.g.props", "XML", 0, 0, 23, 0, 0, 0, 0, 23
"c:\Users\chris\source\repos\Cell\Cell\obj\Cell_4r4li3l0_wpftmp.csproj.nuget.g.targets", "XML", 0, 0, 6, 0, 0, 0, 0, 6
"c:\Users\chris\source\repos\Cell\Cell\obj\Cell_4wbpa2mz_wpftmp.csproj.nuget.dgspec.json", "JSON", 0, 0, 0, 94, 0, 0, 0, 94
"c:\Users\chris\source\repos\Cell\Cell\obj\Cell_4wbpa2mz_wpftmp.csproj.nuget.g.props", "XML", 0, 0, 23, 0, 0, 0, 0, 23
"c:\Users\chris\source\repos\Cell\Cell\obj\Cell_4wbpa2mz_wpftmp.csproj.nuget.g.targets", "XML", 0, 0, 6, 0, 0, 0, 0, 6
"c:\Users\chris\source\repos\Cell\Cell\obj\Cell_4ykfjcti_wpftmp.csproj.nuget.dgspec.json", "JSON", 0, 0, 0, 90, 0, 0, 0, 90
"c:\Users\chris\source\repos\Cell\Cell\obj\Cell_4ykfjcti_wpftmp.csproj.nuget.g.props", "XML", 0, 0, 22, 0, 0, 0, 0, 22
"c:\Users\chris\source\repos\Cell\Cell\obj\Cell_4ykfjcti_wpftmp.csproj.nuget.g.targets", "XML", 0, 0, 6, 0, 0, 0, 0, 6
"c:\Users\chris\source\repos\Cell\Cell\obj\Cell_5mdjzw2a_wpftmp.csproj.nuget.dgspec.json", "JSON", 0, 0, 0, 82, 0, 0, 0, 82
"c:\Users\chris\source\repos\Cell\Cell\obj\Cell_5mdjzw2a_wpftmp.csproj.nuget.g.props", "XML", 0, 0, 16, 0, 0, 0, 0, 16
"c:\Users\chris\source\repos\Cell\Cell\obj\Cell_5mdjzw2a_wpftmp.csproj.nuget.g.targets", "XML", 0, 0, 2, 0, 0, 0, 0, 2
"c:\Users\chris\source\repos\Cell\Cell\obj\Cell_5pyygvu1_wpftmp.csproj.nuget.dgspec.json", "JSON", 0, 0, 0, 94, 0, 0, 0, 94
"c:\Users\chris\source\repos\Cell\Cell\obj\Cell_5pyygvu1_wpftmp.csproj.nuget.g.props", "XML", 0, 0, 23, 0, 0, 0, 0, 23
"c:\Users\chris\source\repos\Cell\Cell\obj\Cell_5pyygvu1_wpftmp.csproj.nuget.g.targets", "XML", 0, 0, 6, 0, 0, 0, 0, 6
"c:\Users\chris\source\repos\Cell\Cell\obj\Cell_amkqytkq_wpftmp.csproj.nuget.dgspec.json", "JSON", 0, 0, 0, 86, 0, 0, 0, 86
"c:\Users\chris\source\repos\Cell\Cell\obj\Cell_amkqytkq_wpftmp.csproj.nuget.g.props", "XML", 0, 0, 22, 0, 0, 0, 0, 22
"c:\Users\chris\source\repos\Cell\Cell\obj\Cell_amkqytkq_wpftmp.csproj.nuget.g.targets", "XML", 0, 0, 6, 0, 0, 0, 0, 6
"c:\Users\chris\source\repos\Cell\Cell\obj\Cell_aoewnvbe_wpftmp.csproj.nuget.dgspec.json", "JSON", 0, 0, 0, 86, 0, 0, 0, 86
"c:\Users\chris\source\repos\Cell\Cell\obj\Cell_aoewnvbe_wpftmp.csproj.nuget.g.props", "XML", 0, 0, 22, 0, 0, 0, 0, 22
"c:\Users\chris\source\repos\Cell\Cell\obj\Cell_aoewnvbe_wpftmp.csproj.nuget.g.targets", "XML", 0, 0, 6, 0, 0, 0, 0, 6
"c:\Users\chris\source\repos\Cell\Cell\obj\Cell_azyye23s_wpftmp.csproj.nuget.dgspec.json", "JSON", 0, 0, 0, 86, 0, 0, 0, 86
"c:\Users\chris\source\repos\Cell\Cell\obj\Cell_azyye23s_wpftmp.csproj.nuget.g.props", "XML", 0, 0, 22, 0, 0, 0, 0, 22
"c:\Users\chris\source\repos\Cell\Cell\obj\Cell_azyye23s_wpftmp.csproj.nuget.g.targets", "XML", 0, 0, 6, 0, 0, 0, 0, 6
"c:\Users\chris\source\repos\Cell\Cell\obj\Cell_b1nsfnlp_wpftmp.csproj.nuget.dgspec.json", "JSON", 0, 0, 0, 90, 0, 0, 0, 90
"c:\Users\chris\source\repos\Cell\Cell\obj\Cell_b1nsfnlp_wpftmp.csproj.nuget.g.props", "XML", 0, 0, 22, 0, 0, 0, 0, 22
"c:\Users\chris\source\repos\Cell\Cell\obj\Cell_b1nsfnlp_wpftmp.csproj.nuget.g.targets", "XML", 0, 0, 6, 0, 0, 0, 0, 6
"c:\Users\chris\source\repos\Cell\Cell\obj\Cell_bibrhvnx_wpftmp.csproj.nuget.dgspec.json", "JSON", 0, 0, 0, 82, 0, 0, 0, 82
"c:\Users\chris\source\repos\Cell\Cell\obj\Cell_bibrhvnx_wpftmp.csproj.nuget.g.props", "XML", 0, 0, 16, 0, 0, 0, 0, 16
"c:\Users\chris\source\repos\Cell\Cell\obj\Cell_bibrhvnx_wpftmp.csproj.nuget.g.targets", "XML", 0, 0, 2, 0, 0, 0, 0, 2
"c:\Users\chris\source\repos\Cell\Cell\obj\Cell_c2njdxts_wpftmp.csproj.nuget.dgspec.json", "JSON", 0, 0, 0, 94, 0, 0, 0, 94
"c:\Users\chris\source\repos\Cell\Cell\obj\Cell_c2njdxts_wpftmp.csproj.nuget.g.props", "XML", 0, 0, 23, 0, 0, 0, 0, 23
"c:\Users\chris\source\repos\Cell\Cell\obj\Cell_c2njdxts_wpftmp.csproj.nuget.g.targets", "XML", 0, 0, 6, 0, 0, 0, 0, 6
"c:\Users\chris\source\repos\Cell\Cell\obj\Cell_cef0nuct_wpftmp.csproj.nuget.dgspec.json", "JSON", 0, 0, 0, 82, 0, 0, 0, 82
"c:\Users\chris\source\repos\Cell\Cell\obj\Cell_cef0nuct_wpftmp.csproj.nuget.g.props", "XML", 0, 0, 16, 0, 0, 0, 0, 16
"c:\Users\chris\source\repos\Cell\Cell\obj\Cell_cef0nuct_wpftmp.csproj.nuget.g.targets", "XML", 0, 0, 2, 0, 0, 0, 0, 2
"c:\Users\chris\source\repos\Cell\Cell\obj\Cell_corkxbon_wpftmp.csproj.nuget.dgspec.json", "JSON", 0, 0, 0, 94, 0, 0, 0, 94
"c:\Users\chris\source\repos\Cell\Cell\obj\Cell_corkxbon_wpftmp.csproj.nuget.g.props", "XML", 0, 0, 23, 0, 0, 0, 0, 23
"c:\Users\chris\source\repos\Cell\Cell\obj\Cell_corkxbon_wpftmp.csproj.nuget.g.targets", "XML", 0, 0, 6, 0, 0, 0, 0, 6
"c:\Users\chris\source\repos\Cell\Cell\obj\Cell_cvdguapx_wpftmp.csproj.nuget.dgspec.json", "JSON", 0, 0, 0, 94, 0, 0, 0, 94
"c:\Users\chris\source\repos\Cell\Cell\obj\Cell_cvdguapx_wpftmp.csproj.nuget.g.props", "XML", 0, 0, 23, 0, 0, 0, 0, 23
"c:\Users\chris\source\repos\Cell\Cell\obj\Cell_cvdguapx_wpftmp.csproj.nuget.g.targets", "XML", 0, 0, 6, 0, 0, 0, 0, 6
"c:\Users\chris\source\repos\Cell\Cell\obj\Cell_d5ju1l5y_wpftmp.csproj.nuget.dgspec.json", "JSON", 0, 0, 0, 90, 0, 0, 0, 90
"c:\Users\chris\source\repos\Cell\Cell\obj\Cell_d5ju1l5y_wpftmp.csproj.nuget.g.props", "XML", 0, 0, 22, 0, 0, 0, 0, 22
"c:\Users\chris\source\repos\Cell\Cell\obj\Cell_d5ju1l5y_wpftmp.csproj.nuget.g.targets", "XML", 0, 0, 6, 0, 0, 0, 0, 6
"c:\Users\chris\source\repos\Cell\Cell\obj\Cell_dhl1hw2f_wpftmp.csproj.nuget.dgspec.json", "JSON", 0, 0, 0, 94, 0, 0, 0, 94
"c:\Users\chris\source\repos\Cell\Cell\obj\Cell_dhl1hw2f_wpftmp.csproj.nuget.g.props", "XML", 0, 0, 23, 0, 0, 0, 0, 23
"c:\Users\chris\source\repos\Cell\Cell\obj\Cell_dhl1hw2f_wpftmp.csproj.nuget.g.targets", "XML", 0, 0, 6, 0, 0, 0, 0, 6
"c:\Users\chris\source\repos\Cell\Cell\obj\Cell_di2bg4f0_wpftmp.csproj.nuget.dgspec.json", "JSON", 0, 0, 0, 94, 0, 0, 0, 94
"c:\Users\chris\source\repos\Cell\Cell\obj\Cell_di2bg4f0_wpftmp.csproj.nuget.g.props", "XML", 0, 0, 23, 0, 0, 0, 0, 23
"c:\Users\chris\source\repos\Cell\Cell\obj\Cell_di2bg4f0_wpftmp.csproj.nuget.g.targets", "XML", 0, 0, 6, 0, 0, 0, 0, 6
"c:\Users\chris\source\repos\Cell\Cell\obj\Cell_dj31b51m_wpftmp.csproj.nuget.dgspec.json", "JSON", 0, 0, 0, 94, 0, 0, 0, 94
"c:\Users\chris\source\repos\Cell\Cell\obj\Cell_dj31b51m_wpftmp.csproj.nuget.g.props", "XML", 0, 0, 23, 0, 0, 0, 0, 23
"c:\Users\chris\source\repos\Cell\Cell\obj\Cell_dj31b51m_wpftmp.csproj.nuget.g.targets", "XML", 0, 0, 6, 0, 0, 0, 0, 6
"c:\Users\chris\source\repos\Cell\Cell\obj\Cell_dsmuj4x2_wpftmp.csproj.nuget.dgspec.json", "JSON", 0, 0, 0, 90, 0, 0, 0, 90
"c:\Users\chris\source\repos\Cell\Cell\obj\Cell_dsmuj4x2_wpftmp.csproj.nuget.g.props", "XML", 0, 0, 22, 0, 0, 0, 0, 22
"c:\Users\chris\source\repos\Cell\Cell\obj\Cell_dsmuj4x2_wpftmp.csproj.nuget.g.targets", "XML", 0, 0, 6, 0, 0, 0, 0, 6
"c:\Users\chris\source\repos\Cell\Cell\obj\Cell_dy5mqma2_wpftmp.csproj.nuget.dgspec.json", "JSON", 0, 0, 0, 90, 0, 0, 0, 90
"c:\Users\chris\source\repos\Cell\Cell\obj\Cell_dy5mqma2_wpftmp.csproj.nuget.g.props", "XML", 0, 0, 22, 0, 0, 0, 0, 22
"c:\Users\chris\source\repos\Cell\Cell\obj\Cell_dy5mqma2_wpftmp.csproj.nuget.g.targets", "XML", 0, 0, 6, 0, 0, 0, 0, 6
"c:\Users\chris\source\repos\Cell\Cell\obj\Cell_dyglifi2_wpftmp.csproj.nuget.dgspec.json", "JSON", 0, 0, 0, 94, 0, 0, 0, 94
"c:\Users\chris\source\repos\Cell\Cell\obj\Cell_dyglifi2_wpftmp.csproj.nuget.g.props", "XML", 0, 0, 23, 0, 0, 0, 0, 23
"c:\Users\chris\source\repos\Cell\Cell\obj\Cell_dyglifi2_wpftmp.csproj.nuget.g.targets", "XML", 0, 0, 6, 0, 0, 0, 0, 6
"c:\Users\chris\source\repos\Cell\Cell\obj\Cell_eilmvckx_wpftmp.csproj.nuget.dgspec.json", "JSON", 0, 0, 0, 86, 0, 0, 0, 86
"c:\Users\chris\source\repos\Cell\Cell\obj\Cell_eilmvckx_wpftmp.csproj.nuget.g.props", "XML", 0, 0, 22, 0, 0, 0, 0, 22
"c:\Users\chris\source\repos\Cell\Cell\obj\Cell_eilmvckx_wpftmp.csproj.nuget.g.targets", "XML", 0, 0, 6, 0, 0, 0, 0, 6
"c:\Users\chris\source\repos\Cell\Cell\obj\Cell_exq2swh4_wpftmp.csproj.nuget.dgspec.json", "JSON", 0, 0, 0, 82, 0, 0, 0, 82
"c:\Users\chris\source\repos\Cell\Cell\obj\Cell_exq2swh4_wpftmp.csproj.nuget.g.props", "XML", 0, 0, 16, 0, 0, 0, 0, 16
"c:\Users\chris\source\repos\Cell\Cell\obj\Cell_exq2swh4_wpftmp.csproj.nuget.g.targets", "XML", 0, 0, 2, 0, 0, 0, 0, 2
"c:\Users\chris\source\repos\Cell\Cell\obj\Cell_fi4gqplr_wpftmp.csproj.nuget.dgspec.json", "JSON", 0, 0, 0, 90, 0, 0, 0, 90
"c:\Users\chris\source\repos\Cell\Cell\obj\Cell_fi4gqplr_wpftmp.csproj.nuget.g.props", "XML", 0, 0, 22, 0, 0, 0, 0, 22
"c:\Users\chris\source\repos\Cell\Cell\obj\Cell_fi4gqplr_wpftmp.csproj.nuget.g.targets", "XML", 0, 0, 6, 0, 0, 0, 0, 6
"c:\Users\chris\source\repos\Cell\Cell\obj\Cell_fpbqxzaf_wpftmp.csproj.nuget.dgspec.json", "JSON", 0, 0, 0, 90, 0, 0, 0, 90
"c:\Users\chris\source\repos\Cell\Cell\obj\Cell_fpbqxzaf_wpftmp.csproj.nuget.g.props", "XML", 0, 0, 22, 0, 0, 0, 0, 22
"c:\Users\chris\source\repos\Cell\Cell\obj\Cell_fpbqxzaf_wpftmp.csproj.nuget.g.targets", "XML", 0, 0, 6, 0, 0, 0, 0, 6
"c:\Users\chris\source\repos\Cell\Cell\obj\Cell_glxke43s_wpftmp.csproj.nuget.dgspec.json", "JSON", 0, 0, 0, 90, 0, 0, 0, 90
"c:\Users\chris\source\repos\Cell\Cell\obj\Cell_glxke43s_wpftmp.csproj.nuget.g.props", "XML", 0, 0, 22, 0, 0, 0, 0, 22
"c:\Users\chris\source\repos\Cell\Cell\obj\Cell_glxke43s_wpftmp.csproj.nuget.g.targets", "XML", 0, 0, 6, 0, 0, 0, 0, 6
"c:\Users\chris\source\repos\Cell\Cell\obj\Cell_gw3wwbrw_wpftmp.csproj.nuget.dgspec.json", "JSON", 0, 0, 0, 94, 0, 0, 0, 94
"c:\Users\chris\source\repos\Cell\Cell\obj\Cell_gw3wwbrw_wpftmp.csproj.nuget.g.props", "XML", 0, 0, 23, 0, 0, 0, 0, 23
"c:\Users\chris\source\repos\Cell\Cell\obj\Cell_gw3wwbrw_wpftmp.csproj.nuget.g.targets", "XML", 0, 0, 6, 0, 0, 0, 0, 6
"c:\Users\chris\source\repos\Cell\Cell\obj\Cell_h1hpemxc_wpftmp.csproj.nuget.dgspec.json", "JSON", 0, 0, 0, 94, 0, 0, 0, 94
"c:\Users\chris\source\repos\Cell\Cell\obj\Cell_h1hpemxc_wpftmp.csproj.nuget.g.props", "XML", 0, 0, 23, 0, 0, 0, 0, 23
"c:\Users\chris\source\repos\Cell\Cell\obj\Cell_h1hpemxc_wpftmp.csproj.nuget.g.targets", "XML", 0, 0, 6, 0, 0, 0, 0, 6
"c:\Users\chris\source\repos\Cell\Cell\obj\Cell_hmwqemvo_wpftmp.csproj.nuget.dgspec.json", "JSON", 0, 0, 0, 90, 0, 0, 0, 90
"c:\Users\chris\source\repos\Cell\Cell\obj\Cell_hmwqemvo_wpftmp.csproj.nuget.g.props", "XML", 0, 0, 22, 0, 0, 0, 0, 22
"c:\Users\chris\source\repos\Cell\Cell\obj\Cell_hmwqemvo_wpftmp.csproj.nuget.g.targets", "XML", 0, 0, 6, 0, 0, 0, 0, 6
"c:\Users\chris\source\repos\Cell\Cell\obj\Cell_hurpvzt1_wpftmp.csproj.nuget.dgspec.json", "JSON", 0, 0, 0, 94, 0, 0, 0, 94
"c:\Users\chris\source\repos\Cell\Cell\obj\Cell_hurpvzt1_wpftmp.csproj.nuget.g.props", "XML", 0, 0, 23, 0, 0, 0, 0, 23
"c:\Users\chris\source\repos\Cell\Cell\obj\Cell_hurpvzt1_wpftmp.csproj.nuget.g.targets", "XML", 0, 0, 6, 0, 0, 0, 0, 6
"c:\Users\chris\source\repos\Cell\Cell\obj\Cell_i4yp1mql_wpftmp.csproj.nuget.dgspec.json", "JSON", 0, 0, 0, 90, 0, 0, 0, 90
"c:\Users\chris\source\repos\Cell\Cell\obj\Cell_i4yp1mql_wpftmp.csproj.nuget.g.props", "XML", 0, 0, 22, 0, 0, 0, 0, 22
"c:\Users\chris\source\repos\Cell\Cell\obj\Cell_i4yp1mql_wpftmp.csproj.nuget.g.targets", "XML", 0, 0, 6, 0, 0, 0, 0, 6
"c:\Users\chris\source\repos\Cell\Cell\obj\Cell_iehboesx_wpftmp.csproj.nuget.dgspec.json", "JSON", 0, 0, 0, 94, 0, 0, 0, 94
"c:\Users\chris\source\repos\Cell\Cell\obj\Cell_iehboesx_wpftmp.csproj.nuget.g.props", "XML", 0, 0, 23, 0, 0, 0, 0, 23
"c:\Users\chris\source\repos\Cell\Cell\obj\Cell_iehboesx_wpftmp.csproj.nuget.g.targets", "XML", 0, 0, 6, 0, 0, 0, 0, 6
"c:\Users\chris\source\repos\Cell\Cell\obj\Cell_ieiger4u_wpftmp.csproj.nuget.dgspec.json", "JSON", 0, 0, 0, 82, 0, 0, 0, 82
"c:\Users\chris\source\repos\Cell\Cell\obj\Cell_ieiger4u_wpftmp.csproj.nuget.g.props", "XML", 0, 0, 16, 0, 0, 0, 0, 16
"c:\Users\chris\source\repos\Cell\Cell\obj\Cell_ieiger4u_wpftmp.csproj.nuget.g.targets", "XML", 0, 0, 2, 0, 0, 0, 0, 2
"c:\Users\chris\source\repos\Cell\Cell\obj\Cell_ioewq04q_wpftmp.csproj.nuget.dgspec.json", "JSON", 0, 0, 0, 86, 0, 0, 0, 86
"c:\Users\chris\source\repos\Cell\Cell\obj\Cell_ioewq04q_wpftmp.csproj.nuget.g.props", "XML", 0, 0, 22, 0, 0, 0, 0, 22
"c:\Users\chris\source\repos\Cell\Cell\obj\Cell_ioewq04q_wpftmp.csproj.nuget.g.targets", "XML", 0, 0, 6, 0, 0, 0, 0, 6
"c:\Users\chris\source\repos\Cell\Cell\obj\Cell_j0xxksig_wpftmp.csproj.nuget.dgspec.json", "JSON", 0, 0, 0, 76, 0, 0, 0, 76
"c:\Users\chris\source\repos\Cell\Cell\obj\Cell_j0xxksig_wpftmp.csproj.nuget.g.props", "XML", 0, 0, 16, 0, 0, 0, 0, 16
"c:\Users\chris\source\repos\Cell\Cell\obj\Cell_j0xxksig_wpftmp.csproj.nuget.g.targets", "XML", 0, 0, 2, 0, 0, 0, 0, 2
"c:\Users\chris\source\repos\Cell\Cell\obj\Cell_jat5esxy_wpftmp.csproj.nuget.dgspec.json", "JSON", 0, 0, 0, 94, 0, 0, 0, 94
"c:\Users\chris\source\repos\Cell\Cell\obj\Cell_jat5esxy_wpftmp.csproj.nuget.g.props", "XML", 0, 0, 23, 0, 0, 0, 0, 23
"c:\Users\chris\source\repos\Cell\Cell\obj\Cell_jat5esxy_wpftmp.csproj.nuget.g.targets", "XML", 0, 0, 6, 0, 0, 0, 0, 6
"c:\Users\chris\source\repos\Cell\Cell\obj\Cell_jdatfxxb_wpftmp.csproj.nuget.dgspec.json", "JSON", 0, 0, 0, 90, 0, 0, 0, 90
"c:\Users\chris\source\repos\Cell\Cell\obj\Cell_jdatfxxb_wpftmp.csproj.nuget.g.props", "XML", 0, 0, 22, 0, 0, 0, 0, 22
"c:\Users\chris\source\repos\Cell\Cell\obj\Cell_jdatfxxb_wpftmp.csproj.nuget.g.targets", "XML", 0, 0, 6, 0, 0, 0, 0, 6
"c:\Users\chris\source\repos\Cell\Cell\obj\Cell_kdznilla_wpftmp.csproj.nuget.dgspec.json", "JSON", 0, 0, 0, 82, 0, 0, 0, 82
"c:\Users\chris\source\repos\Cell\Cell\obj\Cell_kdznilla_wpftmp.csproj.nuget.g.props", "XML", 0, 0, 16, 0, 0, 0, 0, 16
"c:\Users\chris\source\repos\Cell\Cell\obj\Cell_kdznilla_wpftmp.csproj.nuget.g.targets", "XML", 0, 0, 2, 0, 0, 0, 0, 2
"c:\Users\chris\source\repos\Cell\Cell\obj\Cell_kszqrfsw_wpftmp.csproj.nuget.dgspec.json", "JSON", 0, 0, 0, 82, 0, 0, 0, 82
"c:\Users\chris\source\repos\Cell\Cell\obj\Cell_kszqrfsw_wpftmp.csproj.nuget.g.props", "XML", 0, 0, 16, 0, 0, 0, 0, 16
"c:\Users\chris\source\repos\Cell\Cell\obj\Cell_kszqrfsw_wpftmp.csproj.nuget.g.targets", "XML", 0, 0, 2, 0, 0, 0, 0, 2
"c:\Users\chris\source\repos\Cell\Cell\obj\Cell_l1hgujpk_wpftmp.csproj.nuget.dgspec.json", "JSON", 0, 0, 0, 76, 0, 0, 0, 76
"c:\Users\chris\source\repos\Cell\Cell\obj\Cell_l1hgujpk_wpftmp.csproj.nuget.g.props", "XML", 0, 0, 16, 0, 0, 0, 0, 16
"c:\Users\chris\source\repos\Cell\Cell\obj\Cell_l1hgujpk_wpftmp.csproj.nuget.g.targets", "XML", 0, 0, 2, 0, 0, 0, 0, 2
"c:\Users\chris\source\repos\Cell\Cell\obj\Cell_ll15oyo5_wpftmp.csproj.nuget.dgspec.json", "JSON", 0, 0, 0, 86, 0, 0, 0, 86
"c:\Users\chris\source\repos\Cell\Cell\obj\Cell_ll15oyo5_wpftmp.csproj.nuget.g.props", "XML", 0, 0, 22, 0, 0, 0, 0, 22
"c:\Users\chris\source\repos\Cell\Cell\obj\Cell_ll15oyo5_wpftmp.csproj.nuget.g.targets", "XML", 0, 0, 6, 0, 0, 0, 0, 6
"c:\Users\chris\source\repos\Cell\Cell\obj\Cell_llwchcws_wpftmp.csproj.nuget.dgspec.json", "JSON", 0, 0, 0, 86, 0, 0, 0, 86
"c:\Users\chris\source\repos\Cell\Cell\obj\Cell_llwchcws_wpftmp.csproj.nuget.g.props", "XML", 0, 0, 22, 0, 0, 0, 0, 22
"c:\Users\chris\source\repos\Cell\Cell\obj\Cell_llwchcws_wpftmp.csproj.nuget.g.targets", "XML", 0, 0, 6, 0, 0, 0, 0, 6
"c:\Users\chris\source\repos\Cell\Cell\obj\Cell_llypnbc3_wpftmp.csproj.nuget.dgspec.json", "JSON", 0, 0, 0, 86, 0, 0, 0, 86
"c:\Users\chris\source\repos\Cell\Cell\obj\Cell_llypnbc3_wpftmp.csproj.nuget.g.props", "XML", 0, 0, 22, 0, 0, 0, 0, 22
"c:\Users\chris\source\repos\Cell\Cell\obj\Cell_llypnbc3_wpftmp.csproj.nuget.g.targets", "XML", 0, 0, 6, 0, 0, 0, 0, 6
"c:\Users\chris\source\repos\Cell\Cell\obj\Cell_lseaiibo_wpftmp.csproj.nuget.dgspec.json", "JSON", 0, 0, 0, 86, 0, 0, 0, 86
"c:\Users\chris\source\repos\Cell\Cell\obj\Cell_lseaiibo_wpftmp.csproj.nuget.g.props", "XML", 0, 0, 22, 0, 0, 0, 0, 22
"c:\Users\chris\source\repos\Cell\Cell\obj\Cell_lseaiibo_wpftmp.csproj.nuget.g.targets", "XML", 0, 0, 6, 0, 0, 0, 0, 6
"c:\Users\chris\source\repos\Cell\Cell\obj\Cell_n2gkbzgm_wpftmp.csproj.nuget.dgspec.json", "JSON", 0, 0, 0, 94, 0, 0, 0, 94
"c:\Users\chris\source\repos\Cell\Cell\obj\Cell_n2gkbzgm_wpftmp.csproj.nuget.g.props", "XML", 0, 0, 23, 0, 0, 0, 0, 23
"c:\Users\chris\source\repos\Cell\Cell\obj\Cell_n2gkbzgm_wpftmp.csproj.nuget.g.targets", "XML", 0, 0, 6, 0, 0, 0, 0, 6
"c:\Users\chris\source\repos\Cell\Cell\obj\Cell_odsmdje2_wpftmp.csproj.nuget.dgspec.json", "JSON", 0, 0, 0, 86, 0, 0, 0, 86
"c:\Users\chris\source\repos\Cell\Cell\obj\Cell_odsmdje2_wpftmp.csproj.nuget.g.props", "XML", 0, 0, 22, 0, 0, 0, 0, 22
"c:\Users\chris\source\repos\Cell\Cell\obj\Cell_odsmdje2_wpftmp.csproj.nuget.g.targets", "XML", 0, 0, 6, 0, 0, 0, 0, 6
"c:\Users\chris\source\repos\Cell\Cell\obj\Cell_ovtzultd_wpftmp.csproj.nuget.dgspec.json", "JSON", 0, 0, 0, 82, 0, 0, 0, 82
"c:\Users\chris\source\repos\Cell\Cell\obj\Cell_ovtzultd_wpftmp.csproj.nuget.g.props", "XML", 0, 0, 16, 0, 0, 0, 0, 16
"c:\Users\chris\source\repos\Cell\Cell\obj\Cell_ovtzultd_wpftmp.csproj.nuget.g.targets", "XML", 0, 0, 2, 0, 0, 0, 0, 2
"c:\Users\chris\source\repos\Cell\Cell\obj\Cell_oxwlkaox_wpftmp.csproj.nuget.dgspec.json", "JSON", 0, 0, 0, 86, 0, 0, 0, 86
"c:\Users\chris\source\repos\Cell\Cell\obj\Cell_oxwlkaox_wpftmp.csproj.nuget.g.props", "XML", 0, 0, 22, 0, 0, 0, 0, 22
"c:\Users\chris\source\repos\Cell\Cell\obj\Cell_oxwlkaox_wpftmp.csproj.nuget.g.targets", "XML", 0, 0, 6, 0, 0, 0, 0, 6
"c:\Users\chris\source\repos\Cell\Cell\obj\Cell_p1gntrq4_wpftmp.csproj.nuget.dgspec.json", "JSON", 0, 0, 0, 90, 0, 0, 0, 90
"c:\Users\chris\source\repos\Cell\Cell\obj\Cell_p1gntrq4_wpftmp.csproj.nuget.g.props", "XML", 0, 0, 22, 0, 0, 0, 0, 22
"c:\Users\chris\source\repos\Cell\Cell\obj\Cell_p1gntrq4_wpftmp.csproj.nuget.g.targets", "XML", 0, 0, 6, 0, 0, 0, 0, 6
"c:\Users\chris\source\repos\Cell\Cell\obj\Cell_p3xvhdb1_wpftmp.csproj.nuget.dgspec.json", "JSON", 0, 0, 0, 90, 0, 0, 0, 90
"c:\Users\chris\source\repos\Cell\Cell\obj\Cell_p3xvhdb1_wpftmp.csproj.nuget.g.props", "XML", 0, 0, 22, 0, 0, 0, 0, 22
"c:\Users\chris\source\repos\Cell\Cell\obj\Cell_p3xvhdb1_wpftmp.csproj.nuget.g.targets", "XML", 0, 0, 6, 0, 0, 0, 0, 6
"c:\Users\chris\source\repos\Cell\Cell\obj\Cell_pwyskcvf_wpftmp.csproj.nuget.dgspec.json", "JSON", 0, 0, 0, 94, 0, 0, 0, 94
"c:\Users\chris\source\repos\Cell\Cell\obj\Cell_pwyskcvf_wpftmp.csproj.nuget.g.props", "XML", 0, 0, 23, 0, 0, 0, 0, 23
"c:\Users\chris\source\repos\Cell\Cell\obj\Cell_pwyskcvf_wpftmp.csproj.nuget.g.targets", "XML", 0, 0, 6, 0, 0, 0, 0, 6
"c:\Users\chris\source\repos\Cell\Cell\obj\Cell_pythisgv_wpftmp.csproj.nuget.dgspec.json", "JSON", 0, 0, 0, 94, 0, 0, 0, 94
"c:\Users\chris\source\repos\Cell\Cell\obj\Cell_pythisgv_wpftmp.csproj.nuget.g.props", "XML", 0, 0, 23, 0, 0, 0, 0, 23
"c:\Users\chris\source\repos\Cell\Cell\obj\Cell_pythisgv_wpftmp.csproj.nuget.g.targets", "XML", 0, 0, 6, 0, 0, 0, 0, 6
"c:\Users\chris\source\repos\Cell\Cell\obj\Cell_r0adj4kd_wpftmp.csproj.nuget.dgspec.json", "JSON", 0, 0, 0, 82, 0, 0, 0, 82
"c:\Users\chris\source\repos\Cell\Cell\obj\Cell_r0adj4kd_wpftmp.csproj.nuget.g.props", "XML", 0, 0, 16, 0, 0, 0, 0, 16
"c:\Users\chris\source\repos\Cell\Cell\obj\Cell_r0adj4kd_wpftmp.csproj.nuget.g.targets", "XML", 0, 0, 2, 0, 0, 0, 0, 2
"c:\Users\chris\source\repos\Cell\Cell\obj\Cell_rd0x23x2_wpftmp.csproj.nuget.dgspec.json", "JSON", 0, 0, 0, 94, 0, 0, 0, 94
"c:\Users\chris\source\repos\Cell\Cell\obj\Cell_rd0x23x2_wpftmp.csproj.nuget.g.props", "XML", 0, 0, 23, 0, 0, 0, 0, 23
"c:\Users\chris\source\repos\Cell\Cell\obj\Cell_rd0x23x2_wpftmp.csproj.nuget.g.targets", "XML", 0, 0, 6, 0, 0, 0, 0, 6
"c:\Users\chris\source\repos\Cell\Cell\obj\Cell_recixlid_wpftmp.csproj.nuget.dgspec.json", "JSON", 0, 0, 0, 90, 0, 0, 0, 90
"c:\Users\chris\source\repos\Cell\Cell\obj\Cell_recixlid_wpftmp.csproj.nuget.g.props", "XML", 0, 0, 22, 0, 0, 0, 0, 22
"c:\Users\chris\source\repos\Cell\Cell\obj\Cell_recixlid_wpftmp.csproj.nuget.g.targets", "XML", 0, 0, 6, 0, 0, 0, 0, 6
"c:\Users\chris\source\repos\Cell\Cell\obj\Cell_rfnrw11e_wpftmp.csproj.nuget.dgspec.json", "JSON", 0, 0, 0, 94, 0, 0, 0, 94
"c:\Users\chris\source\repos\Cell\Cell\obj\Cell_rfnrw11e_wpftmp.csproj.nuget.g.props", "XML", 0, 0, 23, 0, 0, 0, 0, 23
"c:\Users\chris\source\repos\Cell\Cell\obj\Cell_rfnrw11e_wpftmp.csproj.nuget.g.targets", "XML", 0, 0, 6, 0, 0, 0, 0, 6
"c:\Users\chris\source\repos\Cell\Cell\obj\Cell_rmasjeoa_wpftmp.csproj.nuget.dgspec.json", "JSON", 0, 0, 0, 94, 0, 0, 0, 94
"c:\Users\chris\source\repos\Cell\Cell\obj\Cell_rmasjeoa_wpftmp.csproj.nuget.g.props", "XML", 0, 0, 23, 0, 0, 0, 0, 23
"c:\Users\chris\source\repos\Cell\Cell\obj\Cell_rmasjeoa_wpftmp.csproj.nuget.g.targets", "XML", 0, 0, 6, 0, 0, 0, 0, 6
"c:\Users\chris\source\repos\Cell\Cell\obj\Cell_rszjuiap_wpftmp.csproj.nuget.dgspec.json", "JSON", 0, 0, 0, 94, 0, 0, 0, 94
"c:\Users\chris\source\repos\Cell\Cell\obj\Cell_rszjuiap_wpftmp.csproj.nuget.g.props", "XML", 0, 0, 23, 0, 0, 0, 0, 23
"c:\Users\chris\source\repos\Cell\Cell\obj\Cell_rszjuiap_wpftmp.csproj.nuget.g.targets", "XML", 0, 0, 6, 0, 0, 0, 0, 6
"c:\Users\chris\source\repos\Cell\Cell\obj\Cell_s2njvgyk_wpftmp.csproj.nuget.dgspec.json", "JSON", 0, 0, 0, 90, 0, 0, 0, 90
"c:\Users\chris\source\repos\Cell\Cell\obj\Cell_s2njvgyk_wpftmp.csproj.nuget.g.props", "XML", 0, 0, 22, 0, 0, 0, 0, 22
"c:\Users\chris\source\repos\Cell\Cell\obj\Cell_s2njvgyk_wpftmp.csproj.nuget.g.targets", "XML", 0, 0, 6, 0, 0, 0, 0, 6
"c:\Users\chris\source\repos\Cell\Cell\obj\Cell_s4ljwcj4_wpftmp.csproj.nuget.dgspec.json", "JSON", 0, 0, 0, 86, 0, 0, 0, 86
"c:\Users\chris\source\repos\Cell\Cell\obj\Cell_s4ljwcj4_wpftmp.csproj.nuget.g.props", "XML", 0, 0, 22, 0, 0, 0, 0, 22
"c:\Users\chris\source\repos\Cell\Cell\obj\Cell_s4ljwcj4_wpftmp.csproj.nuget.g.targets", "XML", 0, 0, 6, 0, 0, 0, 0, 6
"c:\Users\chris\source\repos\Cell\Cell\obj\Cell_svnhndi5_wpftmp.csproj.nuget.dgspec.json", "JSON", 0, 0, 0, 82, 0, 0, 0, 82
"c:\Users\chris\source\repos\Cell\Cell\obj\Cell_svnhndi5_wpftmp.csproj.nuget.g.props", "XML", 0, 0, 16, 0, 0, 0, 0, 16
"c:\Users\chris\source\repos\Cell\Cell\obj\Cell_svnhndi5_wpftmp.csproj.nuget.g.targets", "XML", 0, 0, 2, 0, 0, 0, 0, 2
"c:\Users\chris\source\repos\Cell\Cell\obj\Cell_tbfb52vi_wpftmp.csproj.nuget.dgspec.json", "JSON", 0, 0, 0, 90, 0, 0, 0, 90
"c:\Users\chris\source\repos\Cell\Cell\obj\Cell_tbfb52vi_wpftmp.csproj.nuget.g.props", "XML", 0, 0, 22, 0, 0, 0, 0, 22
"c:\Users\chris\source\repos\Cell\Cell\obj\Cell_tbfb52vi_wpftmp.csproj.nuget.g.targets", "XML", 0, 0, 6, 0, 0, 0, 0, 6
"c:\Users\chris\source\repos\Cell\Cell\obj\Cell_tcdsmgnv_wpftmp.csproj.nuget.dgspec.json", "JSON", 0, 0, 0, 94, 0, 0, 0, 94
"c:\Users\chris\source\repos\Cell\Cell\obj\Cell_tcdsmgnv_wpftmp.csproj.nuget.g.props", "XML", 0, 0, 23, 0, 0, 0, 0, 23
"c:\Users\chris\source\repos\Cell\Cell\obj\Cell_tcdsmgnv_wpftmp.csproj.nuget.g.targets", "XML", 0, 0, 6, 0, 0, 0, 0, 6
"c:\Users\chris\source\repos\Cell\Cell\obj\Cell_tnofmsd2_wpftmp.csproj.nuget.dgspec.json", "JSON", 0, 0, 0, 94, 0, 0, 0, 94
"c:\Users\chris\source\repos\Cell\Cell\obj\Cell_tnofmsd2_wpftmp.csproj.nuget.g.props", "XML", 0, 0, 23, 0, 0, 0, 0, 23
"c:\Users\chris\source\repos\Cell\Cell\obj\Cell_tnofmsd2_wpftmp.csproj.nuget.g.targets", "XML", 0, 0, 6, 0, 0, 0, 0, 6
"c:\Users\chris\source\repos\Cell\Cell\obj\Cell_u5vg41rt_wpftmp.csproj.nuget.dgspec.json", "JSON", 0, 0, 0, 94, 0, 0, 0, 94
"c:\Users\chris\source\repos\Cell\Cell\obj\Cell_u5vg41rt_wpftmp.csproj.nuget.g.props", "XML", 0, 0, 23, 0, 0, 0, 0, 23
"c:\Users\chris\source\repos\Cell\Cell\obj\Cell_u5vg41rt_wpftmp.csproj.nuget.g.targets", "XML", 0, 0, 6, 0, 0, 0, 0, 6
"c:\Users\chris\source\repos\Cell\Cell\obj\Cell_u5xslcwg_wpftmp.csproj.nuget.dgspec.json", "JSON", 0, 0, 0, 82, 0, 0, 0, 82
"c:\Users\chris\source\repos\Cell\Cell\obj\Cell_u5xslcwg_wpftmp.csproj.nuget.g.props", "XML", 0, 0, 16, 0, 0, 0, 0, 16
"c:\Users\chris\source\repos\Cell\Cell\obj\Cell_u5xslcwg_wpftmp.csproj.nuget.g.targets", "XML", 0, 0, 2, 0, 0, 0, 0, 2
"c:\Users\chris\source\repos\Cell\Cell\obj\Cell_uh22i0jc_wpftmp.csproj.nuget.dgspec.json", "JSON", 0, 0, 0, 86, 0, 0, 0, 86
"c:\Users\chris\source\repos\Cell\Cell\obj\Cell_uh22i0jc_wpftmp.csproj.nuget.g.props", "XML", 0, 0, 22, 0, 0, 0, 0, 22
"c:\Users\chris\source\repos\Cell\Cell\obj\Cell_uh22i0jc_wpftmp.csproj.nuget.g.targets", "XML", 0, 0, 6, 0, 0, 0, 0, 6
"c:\Users\chris\source\repos\Cell\Cell\obj\Cell_ujncld5u_wpftmp.csproj.nuget.dgspec.json", "JSON", 0, 0, 0, 90, 0, 0, 0, 90
"c:\Users\chris\source\repos\Cell\Cell\obj\Cell_ujncld5u_wpftmp.csproj.nuget.g.props", "XML", 0, 0, 22, 0, 0, 0, 0, 22
"c:\Users\chris\source\repos\Cell\Cell\obj\Cell_ujncld5u_wpftmp.csproj.nuget.g.targets", "XML", 0, 0, 6, 0, 0, 0, 0, 6
"c:\Users\chris\source\repos\Cell\Cell\obj\Cell_uofghery_wpftmp.csproj.nuget.dgspec.json", "JSON", 0, 0, 0, 90, 0, 0, 0, 90
"c:\Users\chris\source\repos\Cell\Cell\obj\Cell_uofghery_wpftmp.csproj.nuget.g.props", "XML", 0, 0, 22, 0, 0, 0, 0, 22
"c:\Users\chris\source\repos\Cell\Cell\obj\Cell_uofghery_wpftmp.csproj.nuget.g.targets", "XML", 0, 0, 6, 0, 0, 0, 0, 6
"c:\Users\chris\source\repos\Cell\Cell\obj\Cell_ur4pk3m0_wpftmp.csproj.nuget.dgspec.json", "JSON", 0, 0, 0, 76, 0, 0, 0, 76
"c:\Users\chris\source\repos\Cell\Cell\obj\Cell_ur4pk3m0_wpftmp.csproj.nuget.g.props", "XML", 0, 0, 16, 0, 0, 0, 0, 16
"c:\Users\chris\source\repos\Cell\Cell\obj\Cell_ur4pk3m0_wpftmp.csproj.nuget.g.targets", "XML", 0, 0, 2, 0, 0, 0, 0, 2
"c:\Users\chris\source\repos\Cell\Cell\obj\Cell_vsm34wfo_wpftmp.csproj.nuget.dgspec.json", "JSON", 0, 0, 0, 86, 0, 0, 0, 86
"c:\Users\chris\source\repos\Cell\Cell\obj\Cell_vsm34wfo_wpftmp.csproj.nuget.g.props", "XML", 0, 0, 22, 0, 0, 0, 0, 22
"c:\Users\chris\source\repos\Cell\Cell\obj\Cell_vsm34wfo_wpftmp.csproj.nuget.g.targets", "XML", 0, 0, 6, 0, 0, 0, 0, 6
"c:\Users\chris\source\repos\Cell\Cell\obj\Cell_vxo1kkhj_wpftmp.csproj.nuget.dgspec.json", "JSON", 0, 0, 0, 90, 0, 0, 0, 90
"c:\Users\chris\source\repos\Cell\Cell\obj\Cell_vxo1kkhj_wpftmp.csproj.nuget.g.props", "XML", 0, 0, 22, 0, 0, 0, 0, 22
"c:\Users\chris\source\repos\Cell\Cell\obj\Cell_vxo1kkhj_wpftmp.csproj.nuget.g.targets", "XML", 0, 0, 6, 0, 0, 0, 0, 6
"c:\Users\chris\source\repos\Cell\Cell\obj\Cell_vyl1piil_wpftmp.csproj.nuget.dgspec.json", "JSON", 0, 0, 0, 94, 0, 0, 0, 94
"c:\Users\chris\source\repos\Cell\Cell\obj\Cell_vyl1piil_wpftmp.csproj.nuget.g.props", "XML", 0, 0, 23, 0, 0, 0, 0, 23
"c:\Users\chris\source\repos\Cell\Cell\obj\Cell_vyl1piil_wpftmp.csproj.nuget.g.targets", "XML", 0, 0, 6, 0, 0, 0, 0, 6
"c:\Users\chris\source\repos\Cell\Cell\obj\Cell_w5skc1pg_wpftmp.csproj.nuget.dgspec.json", "JSON", 0, 0, 0, 94, 0, 0, 0, 94
"c:\Users\chris\source\repos\Cell\Cell\obj\Cell_w5skc1pg_wpftmp.csproj.nuget.g.props", "XML", 0, 0, 23, 0, 0, 0, 0, 23
"c:\Users\chris\source\repos\Cell\Cell\obj\Cell_w5skc1pg_wpftmp.csproj.nuget.g.targets", "XML", 0, 0, 6, 0, 0, 0, 0, 6
"c:\Users\chris\source\repos\Cell\Cell\obj\Cell_wpqnssad_wpftmp.csproj.nuget.dgspec.json", "JSON", 0, 0, 0, 90, 0, 0, 0, 90
"c:\Users\chris\source\repos\Cell\Cell\obj\Cell_wpqnssad_wpftmp.csproj.nuget.g.props", "XML", 0, 0, 22, 0, 0, 0, 0, 22
"c:\Users\chris\source\repos\Cell\Cell\obj\Cell_wpqnssad_wpftmp.csproj.nuget.g.targets", "XML", 0, 0, 6, 0, 0, 0, 0, 6
"c:\Users\chris\source\repos\Cell\Cell\obj\Cell_wq01vfnz_wpftmp.csproj.nuget.dgspec.json", "JSON", 0, 0, 0, 90, 0, 0, 0, 90
"c:\Users\chris\source\repos\Cell\Cell\obj\Cell_wq01vfnz_wpftmp.csproj.nuget.g.props", "XML", 0, 0, 22, 0, 0, 0, 0, 22
"c:\Users\chris\source\repos\Cell\Cell\obj\Cell_wq01vfnz_wpftmp.csproj.nuget.g.targets", "XML", 0, 0, 6, 0, 0, 0, 0, 6
"c:\Users\chris\source\repos\Cell\Cell\obj\Cell_wveucork_wpftmp.csproj.nuget.dgspec.json", "JSON", 0, 0, 0, 90, 0, 0, 0, 90
"c:\Users\chris\source\repos\Cell\Cell\obj\Cell_wveucork_wpftmp.csproj.nuget.g.props", "XML", 0, 0, 22, 0, 0, 0, 0, 22
"c:\Users\chris\source\repos\Cell\Cell\obj\Cell_wveucork_wpftmp.csproj.nuget.g.targets", "XML", 0, 0, 6, 0, 0, 0, 0, 6
"c:\Users\chris\source\repos\Cell\Cell\obj\Cell_wzov2pfa_wpftmp.csproj.nuget.dgspec.json", "JSON", 0, 0, 0, 86, 0, 0, 0, 86
"c:\Users\chris\source\repos\Cell\Cell\obj\Cell_wzov2pfa_wpftmp.csproj.nuget.g.props", "XML", 0, 0, 22, 0, 0, 0, 0, 22
"c:\Users\chris\source\repos\Cell\Cell\obj\Cell_wzov2pfa_wpftmp.csproj.nuget.g.targets", "XML", 0, 0, 6, 0, 0, 0, 0, 6
"c:\Users\chris\source\repos\Cell\Cell\obj\Cell_x2g3d05b_wpftmp.csproj.nuget.dgspec.json", "JSON", 0, 0, 0, 94, 0, 0, 0, 94
"c:\Users\chris\source\repos\Cell\Cell\obj\Cell_x2g3d05b_wpftmp.csproj.nuget.g.props", "XML", 0, 0, 23, 0, 0, 0, 0, 23
"c:\Users\chris\source\repos\Cell\Cell\obj\Cell_x2g3d05b_wpftmp.csproj.nuget.g.targets", "XML", 0, 0, 6, 0, 0, 0, 0, 6
"c:\Users\chris\source\repos\Cell\Cell\obj\Cell_xi2s52do_wpftmp.csproj.nuget.dgspec.json", "JSON", 0, 0, 0, 90, 0, 0, 0, 90
"c:\Users\chris\source\repos\Cell\Cell\obj\Cell_xi2s52do_wpftmp.csproj.nuget.g.props", "XML", 0, 0, 22, 0, 0, 0, 0, 22
"c:\Users\chris\source\repos\Cell\Cell\obj\Cell_xi2s52do_wpftmp.csproj.nuget.g.targets", "XML", 0, 0, 6, 0, 0, 0, 0, 6
"c:\Users\chris\source\repos\Cell\Cell\obj\Cell_xl0kwjyu_wpftmp.csproj.nuget.dgspec.json", "JSON", 0, 0, 0, 90, 0, 0, 0, 90
"c:\Users\chris\source\repos\Cell\Cell\obj\Cell_xl0kwjyu_wpftmp.csproj.nuget.g.props", "XML", 0, 0, 22, 0, 0, 0, 0, 22
"c:\Users\chris\source\repos\Cell\Cell\obj\Cell_xl0kwjyu_wpftmp.csproj.nuget.g.targets", "XML", 0, 0, 6, 0, 0, 0, 0, 6
"c:\Users\chris\source\repos\Cell\Cell\obj\Cell_xm33s3lp_wpftmp.csproj.nuget.dgspec.json", "JSON", 0, 0, 0, 86, 0, 0, 0, 86
"c:\Users\chris\source\repos\Cell\Cell\obj\Cell_xm33s3lp_wpftmp.csproj.nuget.g.props", "XML", 0, 0, 22, 0, 0, 0, 0, 22
"c:\Users\chris\source\repos\Cell\Cell\obj\Cell_xm33s3lp_wpftmp.csproj.nuget.g.targets", "XML", 0, 0, 6, 0, 0, 0, 0, 6
"c:\Users\chris\source\repos\Cell\Cell\obj\Cell_y2ogbqot_wpftmp.csproj.nuget.dgspec.json", "JSON", 0, 0, 0, 76, 0, 0, 0, 76
"c:\Users\chris\source\repos\Cell\Cell\obj\Cell_y2ogbqot_wpftmp.csproj.nuget.g.props", "XML", 0, 0, 16, 0, 0, 0, 0, 16
"c:\Users\chris\source\repos\Cell\Cell\obj\Cell_y2ogbqot_wpftmp.csproj.nuget.g.targets", "XML", 0, 0, 2, 0, 0, 0, 0, 2
"c:\Users\chris\source\repos\Cell\Cell\obj\Cell_yujupgro_wpftmp.csproj.nuget.dgspec.json", "JSON", 0, 0, 0, 82, 0, 0, 0, 82
"c:\Users\chris\source\repos\Cell\Cell\obj\Cell_yujupgro_wpftmp.csproj.nuget.g.props", "XML", 0, 0, 16, 0, 0, 0, 0, 16
"c:\Users\chris\source\repos\Cell\Cell\obj\Cell_yujupgro_wpftmp.csproj.nuget.g.targets", "XML", 0, 0, 2, 0, 0, 0, 0, 2
"c:\Users\chris\source\repos\Cell\Cell\obj\Cell_zclw3sg1_wpftmp.csproj.nuget.dgspec.json", "JSON", 0, 0, 0, 86, 0, 0, 0, 86
"c:\Users\chris\source\repos\Cell\Cell\obj\Cell_zclw3sg1_wpftmp.csproj.nuget.g.props", "XML", 0, 0, 22, 0, 0, 0, 0, 22
"c:\Users\chris\source\repos\Cell\Cell\obj\Cell_zclw3sg1_wpftmp.csproj.nuget.g.targets", "XML", 0, 0, 6, 0, 0, 0, 0, 6
"c:\Users\chris\source\repos\Cell\Cell\obj\Cell_zddwz4tg_wpftmp.csproj.nuget.dgspec.json", "JSON", 0, 0, 0, 94, 0, 0, 0, 94
"c:\Users\chris\source\repos\Cell\Cell\obj\Cell_zddwz4tg_wpftmp.csproj.nuget.g.props", "XML", 0, 0, 23, 0, 0, 0, 0, 23
"c:\Users\chris\source\repos\Cell\Cell\obj\Cell_zddwz4tg_wpftmp.csproj.nuget.g.targets", "XML", 0, 0, 6, 0, 0, 0, 0, 6
"c:\Users\chris\source\repos\Cell\Cell\obj\Cell_zdlnavfh_wpftmp.csproj.nuget.dgspec.json", "JSON", 0, 0, 0, 94, 0, 0, 0, 94
"c:\Users\chris\source\repos\Cell\Cell\obj\Cell_zdlnavfh_wpftmp.csproj.nuget.g.props", "XML", 0, 0, 23, 0, 0, 0, 0, 23
"c:\Users\chris\source\repos\Cell\Cell\obj\Cell_zdlnavfh_wpftmp.csproj.nuget.g.targets", "XML", 0, 0, 6, 0, 0, 0, 0, 6
"c:\Users\chris\source\repos\Cell\Cell\obj\Cell_zg0j4igr_wpftmp.csproj.nuget.dgspec.json", "JSON", 0, 0, 0, 94, 0, 0, 0, 94
"c:\Users\chris\source\repos\Cell\Cell\obj\Cell_zg0j4igr_wpftmp.csproj.nuget.g.props", "XML", 0, 0, 23, 0, 0, 0, 0, 23
"c:\Users\chris\source\repos\Cell\Cell\obj\Cell_zg0j4igr_wpftmp.csproj.nuget.g.targets", "XML", 0, 0, 6, 0, 0, 0, 0, 6
"c:\Users\chris\source\repos\Cell\Cell\obj\Cell_zoes0zn2_wpftmp.csproj.nuget.dgspec.json", "JSON", 0, 0, 0, 82, 0, 0, 0, 82
"c:\Users\chris\source\repos\Cell\Cell\obj\Cell_zoes0zn2_wpftmp.csproj.nuget.g.props", "XML", 0, 0, 16, 0, 0, 0, 0, 16
"c:\Users\chris\source\repos\Cell\Cell\obj\Cell_zoes0zn2_wpftmp.csproj.nuget.g.targets", "XML", 0, 0, 2, 0, 0, 0, 0, 2
"c:\Users\chris\source\repos\Cell\Cell\obj\Cell_zp0abt4x_wpftmp.csproj.nuget.dgspec.json", "JSON", 0, 0, 0, 90, 0, 0, 0, 90
"c:\Users\chris\source\repos\Cell\Cell\obj\Cell_zp0abt4x_wpftmp.csproj.nuget.g.props", "XML", 0, 0, 22, 0, 0, 0, 0, 22
"c:\Users\chris\source\repos\Cell\Cell\obj\Cell_zp0abt4x_wpftmp.csproj.nuget.g.targets", "XML", 0, 0, 6, 0, 0, 0, 0, 6
"c:\Users\chris\source\repos\Cell\Cell\obj\Cell_zshk2r0q_wpftmp.csproj.nuget.dgspec.json", "JSON", 0, 0, 0, 86, 0, 0, 0, 86
"c:\Users\chris\source\repos\Cell\Cell\obj\Cell_zshk2r0q_wpftmp.csproj.nuget.g.props", "XML", 0, 0, 22, 0, 0, 0, 0, 22
"c:\Users\chris\source\repos\Cell\Cell\obj\Cell_zshk2r0q_wpftmp.csproj.nuget.g.targets", "XML", 0, 0, 6, 0, 0, 0, 0, 6
"c:\Users\chris\source\repos\Cell\Cell\obj\Debug\net8.0-windows\.NETCoreApp,Version=v8.0.AssemblyAttributes.cs", "C#", 3, 0, 0, 0, 0, 1, 1, 5
"c:\Users\chris\source\repos\Cell\Cell\obj\Debug\net8.0-windows\App.g.cs", "C#", 54, 0, 0, 0, 0, 18, 14, 86
"c:\Users\chris\source\repos\Cell\Cell\obj\Debug\net8.0-windows\App.g.i.cs", "C#", 54, 0, 0, 0, 0, 18, 14, 86
"c:\Users\chris\source\repos\Cell\Cell\obj\Debug\net8.0-windows\Cell.AssemblyInfo.cs", "C#", 11, 0, 0, 0, 0, 10, 5, 26
"c:\Users\chris\source\repos\Cell\Cell\obj\Debug\net8.0-windows\Cell.GeneratedMSBuildEditorConfig.editorconfig", "Properties", 0, 0, 0, 0, 21, 0, 1, 22
"c:\Users\chris\source\repos\Cell\Cell\obj\Debug\net8.0-windows\Cell.GlobalUsings.g.cs", "C#", 5, 0, 0, 0, 0, 1, 1, 7
"c:\Users\chris\source\repos\Cell\Cell\obj\Debug\net8.0-windows\Cell.designer.deps.json", "JSON", 0, 0, 0, 310, 0, 0, 0, 310
"c:\Users\chris\source\repos\Cell\Cell\obj\Debug\net8.0-windows\Cell.designer.runtimeconfig.json", "JSON", 0, 0, 0, 24, 0, 0, 0, 24
"c:\Users\chris\source\repos\Cell\Cell\obj\Debug\net8.0-windows\Cell.sourcelink.json", "JSON", 0, 0, 0, 1, 0, 0, 0, 1
"c:\Users\chris\source\repos\Cell\Cell\obj\Debug\net8.0-windows\Cell_00hyjq33_wpftmp.AssemblyInfo.cs", "C#", 11, 0, 0, 0, 0, 10, 5, 26
"c:\Users\chris\source\repos\Cell\Cell\obj\Debug\net8.0-windows\Cell_00hyjq33_wpftmp.GeneratedMSBuildEditorConfig.editorconfig", "Properties", 0, 0, 0, 0, 21, 0, 1, 22
"c:\Users\chris\source\repos\Cell\Cell\obj\Debug\net8.0-windows\Cell_00hyjq33_wpftmp.GlobalUsings.g.cs", "C#", 5, 0, 0, 0, 0, 1, 1, 7
"c:\Users\chris\source\repos\Cell\Cell\obj\Debug\net8.0-windows\Cell_00hyjq33_wpftmp.sourcelink.json", "JSON", 0, 0, 0, 1, 0, 0, 0, 1
"c:\Users\chris\source\repos\Cell\Cell\obj\Debug\net8.0-windows\Cell_00pilcrb_wpftmp.AssemblyInfo.cs", "C#", 11, 0, 0, 0, 0, 10, 5, 26
"c:\Users\chris\source\repos\Cell\Cell\obj\Debug\net8.0-windows\Cell_00pilcrb_wpftmp.GeneratedMSBuildEditorConfig.editorconfig", "Properties", 0, 0, 0, 0, 21, 0, 1, 22
"c:\Users\chris\source\repos\Cell\Cell\obj\Debug\net8.0-windows\Cell_00pilcrb_wpftmp.GlobalUsings.g.cs", "C#", 5, 0, 0, 0, 0, 1, 1, 7
"c:\Users\chris\source\repos\Cell\Cell\obj\Debug\net8.0-windows\Cell_00pilcrb_wpftmp.sourcelink.json", "JSON", 0, 0, 0, 1, 0, 0, 0, 1
"c:\Users\chris\source\repos\Cell\Cell\obj\Debug\net8.0-windows\Cell_01pp0as4_wpftmp.AssemblyInfo.cs", "C#", 11, 0, 0, 0, 0, 10, 5, 26
"c:\Users\chris\source\repos\Cell\Cell\obj\Debug\net8.0-windows\Cell_01pp0as4_wpftmp.GeneratedMSBuildEditorConfig.editorconfig", "Properties", 0, 0, 0, 0, 21, 0, 1, 22
"c:\Users\chris\source\repos\Cell\Cell\obj\Debug\net8.0-windows\Cell_01pp0as4_wpftmp.GlobalUsings.g.cs", "C#", 5, 0, 0, 0, 0, 1, 1, 7
"c:\Users\chris\source\repos\Cell\Cell\obj\Debug\net8.0-windows\Cell_01pp0as4_wpftmp.sourcelink.json", "JSON", 0, 0, 0, 1, 0, 0, 0, 1
"c:\Users\chris\source\repos\Cell\Cell\obj\Debug\net8.0-windows\Cell_023y4x5e_wpftmp.AssemblyInfo.cs", "C#", 11, 0, 0, 0, 0, 10, 5, 26
"c:\Users\chris\source\repos\Cell\Cell\obj\Debug\net8.0-windows\Cell_023y4x5e_wpftmp.GeneratedMSBuildEditorConfig.editorconfig", "Properties", 0, 0, 0, 0, 13, 0, 1, 14
"c:\Users\chris\source\repos\Cell\Cell\obj\Debug\net8.0-windows\Cell_023y4x5e_wpftmp.GlobalUsings.g.cs", "C#", 5, 0, 0, 0, 0, 1, 1, 7
"c:\Users\chris\source\repos\Cell\Cell\obj\Debug\net8.0-windows\Cell_02iut4i0_wpftmp.AssemblyInfo.cs", "C#", 11, 0, 0, 0, 0, 10, 5, 26
"c:\Users\chris\source\repos\Cell\Cell\obj\Debug\net8.0-windows\Cell_02iut4i0_wpftmp.GeneratedMSBuildEditorConfig.editorconfig", "Properties", 0, 0, 0, 0, 21, 0, 1, 22
"c:\Users\chris\source\repos\Cell\Cell\obj\Debug\net8.0-windows\Cell_02iut4i0_wpftmp.GlobalUsings.g.cs", "C#", 5, 0, 0, 0, 0, 1, 1, 7
"c:\Users\chris\source\repos\Cell\Cell\obj\Debug\net8.0-windows\Cell_02iut4i0_wpftmp.sourcelink.json", "JSON", 0, 0, 0, 1, 0, 0, 0, 1
"c:\Users\chris\source\repos\Cell\Cell\obj\Debug\net8.0-windows\Cell_02qb0hpx_wpftmp.AssemblyInfo.cs", "C#", 11, 0, 0, 0, 0, 10, 5, 26
"c:\Users\chris\source\repos\Cell\Cell\obj\Debug\net8.0-windows\Cell_02qb0hpx_wpftmp.GeneratedMSBuildEditorConfig.editorconfig", "Properties", 0, 0, 0, 0, 21, 0, 1, 22
"c:\Users\chris\source\repos\Cell\Cell\obj\Debug\net8.0-windows\Cell_02qb0hpx_wpftmp.GlobalUsings.g.cs", "C#", 5, 0, 0, 0, 0, 1, 1, 7
"c:\Users\chris\source\repos\Cell\Cell\obj\Debug\net8.0-windows\Cell_02qb0hpx_wpftmp.sourcelink.json", "JSON", 0, 0, 0, 1, 0, 0, 0, 1
"c:\Users\chris\source\repos\Cell\Cell\obj\Debug\net8.0-windows\Cell_05gt00lp_wpftmp.AssemblyInfo.cs", "C#", 11, 0, 0, 0, 0, 10, 5, 26
"c:\Users\chris\source\repos\Cell\Cell\obj\Debug\net8.0-windows\Cell_05gt00lp_wpftmp.GeneratedMSBuildEditorConfig.editorconfig", "Properties", 0, 0, 0, 0, 21, 0, 1, 22
"c:\Users\chris\source\repos\Cell\Cell\obj\Debug\net8.0-windows\Cell_05gt00lp_wpftmp.GlobalUsings.g.cs", "C#", 5, 0, 0, 0, 0, 1, 1, 7
"c:\Users\chris\source\repos\Cell\Cell\obj\Debug\net8.0-windows\Cell_05gt00lp_wpftmp.sourcelink.json", "JSON", 0, 0, 0, 1, 0, 0, 0, 1
"c:\Users\chris\source\repos\Cell\Cell\obj\Debug\net8.0-windows\Cell_0buvqmao_wpftmp.AssemblyInfo.cs", "C#", 11, 0, 0, 0, 0, 10, 5, 26
"c:\Users\chris\source\repos\Cell\Cell\obj\Debug\net8.0-windows\Cell_0buvqmao_wpftmp.GeneratedMSBuildEditorConfig.editorconfig", "Properties", 0, 0, 0, 0, 21, 0, 1, 22
"c:\Users\chris\source\repos\Cell\Cell\obj\Debug\net8.0-windows\Cell_0buvqmao_wpftmp.GlobalUsings.g.cs", "C#", 5, 0, 0, 0, 0, 1, 1, 7
"c:\Users\chris\source\repos\Cell\Cell\obj\Debug\net8.0-windows\Cell_0buvqmao_wpftmp.sourcelink.json", "JSON", 0, 0, 0, 1, 0, 0, 0, 1
"c:\Users\chris\source\repos\Cell\Cell\obj\Debug\net8.0-windows\Cell_0czhdcy2_wpftmp.AssemblyInfo.cs", "C#", 11, 0, 0, 0, 0, 10, 5, 26
"c:\Users\chris\source\repos\Cell\Cell\obj\Debug\net8.0-windows\Cell_0czhdcy2_wpftmp.GeneratedMSBuildEditorConfig.editorconfig", "Properties", 0, 0, 0, 0, 21, 0, 1, 22
"c:\Users\chris\source\repos\Cell\Cell\obj\Debug\net8.0-windows\Cell_0czhdcy2_wpftmp.GlobalUsings.g.cs", "C#", 5, 0, 0, 0, 0, 1, 1, 7
"c:\Users\chris\source\repos\Cell\Cell\obj\Debug\net8.0-windows\Cell_0czhdcy2_wpftmp.sourcelink.json", "JSON", 0, 0, 0, 1, 0, 0, 0, 1
"c:\Users\chris\source\repos\Cell\Cell\obj\Debug\net8.0-windows\Cell_0gaijiyr_wpftmp.AssemblyInfo.cs", "C#", 11, 0, 0, 0, 0, 10, 5, 26
"c:\Users\chris\source\repos\Cell\Cell\obj\Debug\net8.0-windows\Cell_0gaijiyr_wpftmp.GeneratedMSBuildEditorConfig.editorconfig", "Properties", 0, 0, 0, 0, 21, 0, 1, 22
"c:\Users\chris\source\repos\Cell\Cell\obj\Debug\net8.0-windows\Cell_0gaijiyr_wpftmp.GlobalUsings.g.cs", "C#", 5, 0, 0, 0, 0, 1, 1, 7
"c:\Users\chris\source\repos\Cell\Cell\obj\Debug\net8.0-windows\Cell_0gaijiyr_wpftmp.sourcelink.json", "JSON", 0, 0, 0, 1, 0, 0, 0, 1
"c:\Users\chris\source\repos\Cell\Cell\obj\Debug\net8.0-windows\Cell_0hauwox2_wpftmp.AssemblyInfo.cs", "C#", 11, 0, 0, 0, 0, 10, 5, 26
"c:\Users\chris\source\repos\Cell\Cell\obj\Debug\net8.0-windows\Cell_0hauwox2_wpftmp.GeneratedMSBuildEditorConfig.editorconfig", "Properties", 0, 0, 0, 0, 13, 0, 1, 14
"c:\Users\chris\source\repos\Cell\Cell\obj\Debug\net8.0-windows\Cell_0hauwox2_wpftmp.GlobalUsings.g.cs", "C#", 5, 0, 0, 0, 0, 1, 1, 7
"c:\Users\chris\source\repos\Cell\Cell\obj\Debug\net8.0-windows\Cell_0hcmnehb_wpftmp.AssemblyInfo.cs", "C#", 11, 0, 0, 0, 0, 10, 5, 26
"c:\Users\chris\source\repos\Cell\Cell\obj\Debug\net8.0-windows\Cell_0hcmnehb_wpftmp.GeneratedMSBuildEditorConfig.editorconfig", "Properties", 0, 0, 0, 0, 21, 0, 1, 22
"c:\Users\chris\source\repos\Cell\Cell\obj\Debug\net8.0-windows\Cell_0hcmnehb_wpftmp.GlobalUsings.g.cs", "C#", 5, 0, 0, 0, 0, 1, 1, 7
"c:\Users\chris\source\repos\Cell\Cell\obj\Debug\net8.0-windows\Cell_0hcmnehb_wpftmp.sourcelink.json", "JSON", 0, 0, 0, 1, 0, 0, 0, 1
"c:\Users\chris\source\repos\Cell\Cell\obj\Debug\net8.0-windows\Cell_0iapaa2l_wpftmp.AssemblyInfo.cs", "C#", 11, 0, 0, 0, 0, 10, 5, 26
"c:\Users\chris\source\repos\Cell\Cell\obj\Debug\net8.0-windows\Cell_0iapaa2l_wpftmp.GeneratedMSBuildEditorConfig.editorconfig", "Properties", 0, 0, 0, 0, 21, 0, 1, 22
"c:\Users\chris\source\repos\Cell\Cell\obj\Debug\net8.0-windows\Cell_0iapaa2l_wpftmp.GlobalUsings.g.cs", "C#", 5, 0, 0, 0, 0, 1, 1, 7
"c:\Users\chris\source\repos\Cell\Cell\obj\Debug\net8.0-windows\Cell_0iapaa2l_wpftmp.sourcelink.json", "JSON", 0, 0, 0, 1, 0, 0, 0, 1
"c:\Users\chris\source\repos\Cell\Cell\obj\Debug\net8.0-windows\Cell_0jtcob15_wpftmp.AssemblyInfo.cs", "C#", 11, 0, 0, 0, 0, 10, 5, 26
"c:\Users\chris\source\repos\Cell\Cell\obj\Debug\net8.0-windows\Cell_0jtcob15_wpftmp.GeneratedMSBuildEditorConfig.editorconfig", "Properties", 0, 0, 0, 0, 21, 0, 1, 22
"c:\Users\chris\source\repos\Cell\Cell\obj\Debug\net8.0-windows\Cell_0jtcob15_wpftmp.GlobalUsings.g.cs", "C#", 5, 0, 0, 0, 0, 1, 1, 7
"c:\Users\chris\source\repos\Cell\Cell\obj\Debug\net8.0-windows\Cell_0jtcob15_wpftmp.sourcelink.json", "JSON", 0, 0, 0, 1, 0, 0, 0, 1
"c:\Users\chris\source\repos\Cell\Cell\obj\Debug\net8.0-windows\Cell_0k0pmymf_wpftmp.AssemblyInfo.cs", "C#", 11, 0, 0, 0, 0, 10, 5, 26
"c:\Users\chris\source\repos\Cell\Cell\obj\Debug\net8.0-windows\Cell_0k0pmymf_wpftmp.GeneratedMSBuildEditorConfig.editorconfig", "Properties", 0, 0, 0, 0, 13, 0, 1, 14
"c:\Users\chris\source\repos\Cell\Cell\obj\Debug\net8.0-windows\Cell_0k0pmymf_wpftmp.GlobalUsings.g.cs", "C#", 5, 0, 0, 0, 0, 1, 1, 7
"c:\Users\chris\source\repos\Cell\Cell\obj\Debug\net8.0-windows\Cell_0kn5dnuj_wpftmp.AssemblyInfo.cs", "C#", 11, 0, 0, 0, 0, 10, 5, 26
"c:\Users\chris\source\repos\Cell\Cell\obj\Debug\net8.0-windows\Cell_0kn5dnuj_wpftmp.GeneratedMSBuildEditorConfig.editorconfig", "Properties", 0, 0, 0, 0, 21, 0, 1, 22
"c:\Users\chris\source\repos\Cell\Cell\obj\Debug\net8.0-windows\Cell_0kn5dnuj_wpftmp.GlobalUsings.g.cs", "C#", 5, 0, 0, 0, 0, 1, 1, 7
"c:\Users\chris\source\repos\Cell\Cell\obj\Debug\net8.0-windows\Cell_0kn5dnuj_wpftmp.sourcelink.json", "JSON", 0, 0, 0, 1, 0, 0, 0, 1
"c:\Users\chris\source\repos\Cell\Cell\obj\Debug\net8.0-windows\Cell_0lhoaaol_wpftmp.AssemblyInfo.cs", "C#", 11, 0, 0, 0, 0, 10, 5, 26
"c:\Users\chris\source\repos\Cell\Cell\obj\Debug\net8.0-windows\Cell_0lhoaaol_wpftmp.GeneratedMSBuildEditorConfig.editorconfig", "Properties", 0, 0, 0, 0, 13, 0, 1, 14
"c:\Users\chris\source\repos\Cell\Cell\obj\Debug\net8.0-windows\Cell_0lhoaaol_wpftmp.GlobalUsings.g.cs", "C#", 5, 0, 0, 0, 0, 1, 1, 7
"c:\Users\chris\source\repos\Cell\Cell\obj\Debug\net8.0-windows\Cell_0lvz30kn_wpftmp.AssemblyInfo.cs", "C#", 11, 0, 0, 0, 0, 10, 5, 26
"c:\Users\chris\source\repos\Cell\Cell\obj\Debug\net8.0-windows\Cell_0lvz30kn_wpftmp.GeneratedMSBuildEditorConfig.editorconfig", "Properties", 0, 0, 0, 0, 21, 0, 1, 22
"c:\Users\chris\source\repos\Cell\Cell\obj\Debug\net8.0-windows\Cell_0lvz30kn_wpftmp.GlobalUsings.g.cs", "C#", 5, 0, 0, 0, 0, 1, 1, 7
"c:\Users\chris\source\repos\Cell\Cell\obj\Debug\net8.0-windows\Cell_0lvz30kn_wpftmp.sourcelink.json", "JSON", 0, 0, 0, 1, 0, 0, 0, 1
"c:\Users\chris\source\repos\Cell\Cell\obj\Debug\net8.0-windows\Cell_0lxfqayy_wpftmp.AssemblyInfo.cs", "C#", 11, 0, 0, 0, 0, 10, 5, 26
"c:\Users\chris\source\repos\Cell\Cell\obj\Debug\net8.0-windows\Cell_0lxfqayy_wpftmp.GeneratedMSBuildEditorConfig.editorconfig", "Properties", 0, 0, 0, 0, 21, 0, 1, 22
"c:\Users\chris\source\repos\Cell\Cell\obj\Debug\net8.0-windows\Cell_0lxfqayy_wpftmp.GlobalUsings.g.cs", "C#", 5, 0, 0, 0, 0, 1, 1, 7
"c:\Users\chris\source\repos\Cell\Cell\obj\Debug\net8.0-windows\Cell_0lxfqayy_wpftmp.sourcelink.json", "JSON", 0, 0, 0, 1, 0, 0, 0, 1
"c:\Users\chris\source\repos\Cell\Cell\obj\Debug\net8.0-windows\Cell_0nnvio3c_wpftmp.AssemblyInfo.cs", "C#", 11, 0, 0, 0, 0, 10, 5, 26
"c:\Users\chris\source\repos\Cell\Cell\obj\Debug\net8.0-windows\Cell_0nnvio3c_wpftmp.GeneratedMSBuildEditorConfig.editorconfig", "Properties", 0, 0, 0, 0, 21, 0, 1, 22
"c:\Users\chris\source\repos\Cell\Cell\obj\Debug\net8.0-windows\Cell_0nnvio3c_wpftmp.GlobalUsings.g.cs", "C#", 5, 0, 0, 0, 0, 1, 1, 7
"c:\Users\chris\source\repos\Cell\Cell\obj\Debug\net8.0-windows\Cell_0nnvio3c_wpftmp.sourcelink.json", "JSON", 0, 0, 0, 1, 0, 0, 0, 1
"c:\Users\chris\source\repos\Cell\Cell\obj\Debug\net8.0-windows\Cell_0nzk4z45_wpftmp.AssemblyInfo.cs", "C#", 11, 0, 0, 0, 0, 10, 5, 26
"c:\Users\chris\source\repos\Cell\Cell\obj\Debug\net8.0-windows\Cell_0nzk4z45_wpftmp.GeneratedMSBuildEditorConfig.editorconfig", "Properties", 0, 0, 0, 0, 13, 0, 1, 14
"c:\Users\chris\source\repos\Cell\Cell\obj\Debug\net8.0-windows\Cell_0nzk4z45_wpftmp.GlobalUsings.g.cs", "C#", 5, 0, 0, 0, 0, 1, 1, 7
"c:\Users\chris\source\repos\Cell\Cell\obj\Debug\net8.0-windows\Cell_0ozwxnsy_wpftmp.AssemblyInfo.cs", "C#", 11, 0, 0, 0, 0, 10, 5, 26
"c:\Users\chris\source\repos\Cell\Cell\obj\Debug\net8.0-windows\Cell_0ozwxnsy_wpftmp.GeneratedMSBuildEditorConfig.editorconfig", "Properties", 0, 0, 0, 0, 21, 0, 1, 22
"c:\Users\chris\source\repos\Cell\Cell\obj\Debug\net8.0-windows\Cell_0ozwxnsy_wpftmp.GlobalUsings.g.cs", "C#", 5, 0, 0, 0, 0, 1, 1, 7
"c:\Users\chris\source\repos\Cell\Cell\obj\Debug\net8.0-windows\Cell_0ozwxnsy_wpftmp.sourcelink.json", "JSON", 0, 0, 0, 1, 0, 0, 0, 1
"c:\Users\chris\source\repos\Cell\Cell\obj\Debug\net8.0-windows\Cell_0qhonokw_wpftmp.AssemblyInfo.cs", "C#", 11, 0, 0, 0, 0, 10, 5, 26
"c:\Users\chris\source\repos\Cell\Cell\obj\Debug\net8.0-windows\Cell_0qhonokw_wpftmp.GeneratedMSBuildEditorConfig.editorconfig", "Properties", 0, 0, 0, 0, 21, 0, 1, 22
"c:\Users\chris\source\repos\Cell\Cell\obj\Debug\net8.0-windows\Cell_0qhonokw_wpftmp.GlobalUsings.g.cs", "C#", 5, 0, 0, 0, 0, 1, 1, 7
"c:\Users\chris\source\repos\Cell\Cell\obj\Debug\net8.0-windows\Cell_0qhonokw_wpftmp.sourcelink.json", "JSON", 0, 0, 0, 1, 0, 0, 0, 1
"c:\Users\chris\source\repos\Cell\Cell\obj\Debug\net8.0-windows\Cell_0r3ktobe_wpftmp.AssemblyInfo.cs", "C#", 11, 0, 0, 0, 0, 10, 5, 26
"c:\Users\chris\source\repos\Cell\Cell\obj\Debug\net8.0-windows\Cell_0r3ktobe_wpftmp.GeneratedMSBuildEditorConfig.editorconfig", "Properties", 0, 0, 0, 0, 21, 0, 1, 22
"c:\Users\chris\source\repos\Cell\Cell\obj\Debug\net8.0-windows\Cell_0r3ktobe_wpftmp.GlobalUsings.g.cs", "C#", 5, 0, 0, 0, 0, 1, 1, 7
"c:\Users\chris\source\repos\Cell\Cell\obj\Debug\net8.0-windows\Cell_0r3ktobe_wpftmp.sourcelink.json", "JSON", 0, 0, 0, 1, 0, 0, 0, 1
"c:\Users\chris\source\repos\Cell\Cell\obj\Debug\net8.0-windows\Cell_0rotewkj_wpftmp.AssemblyInfo.cs", "C#", 11, 0, 0, 0, 0, 10, 5, 26
"c:\Users\chris\source\repos\Cell\Cell\obj\Debug\net8.0-windows\Cell_0rotewkj_wpftmp.GeneratedMSBuildEditorConfig.editorconfig", "Properties", 0, 0, 0, 0, 21, 0, 1, 22
"c:\Users\chris\source\repos\Cell\Cell\obj\Debug\net8.0-windows\Cell_0rotewkj_wpftmp.GlobalUsings.g.cs", "C#", 5, 0, 0, 0, 0, 1, 1, 7
"c:\Users\chris\source\repos\Cell\Cell\obj\Debug\net8.0-windows\Cell_0rotewkj_wpftmp.sourcelink.json", "JSON", 0, 0, 0, 1, 0, 0, 0, 1
"c:\Users\chris\source\repos\Cell\Cell\obj\Debug\net8.0-windows\Cell_0u0khiwl_wpftmp.AssemblyInfo.cs", "C#", 11, 0, 0, 0, 0, 10, 5, 26
"c:\Users\chris\source\repos\Cell\Cell\obj\Debug\net8.0-windows\Cell_0u0khiwl_wpftmp.GeneratedMSBuildEditorConfig.editorconfig", "Properties", 0, 0, 0, 0, 21, 0, 1, 22
"c:\Users\chris\source\repos\Cell\Cell\obj\Debug\net8.0-windows\Cell_0u0khiwl_wpftmp.GlobalUsings.g.cs", "C#", 5, 0, 0, 0, 0, 1, 1, 7
"c:\Users\chris\source\repos\Cell\Cell\obj\Debug\net8.0-windows\Cell_0u0khiwl_wpftmp.sourcelink.json", "JSON", 0, 0, 0, 1, 0, 0, 0, 1
"c:\Users\chris\source\repos\Cell\Cell\obj\Debug\net8.0-windows\Cell_0ukrv31b_wpftmp.AssemblyInfo.cs", "C#", 11, 0, 0, 0, 0, 10, 5, 26
"c:\Users\chris\source\repos\Cell\Cell\obj\Debug\net8.0-windows\Cell_0ukrv31b_wpftmp.GeneratedMSBuildEditorConfig.editorconfig", "Properties", 0, 0, 0, 0, 21, 0, 1, 22
"c:\Users\chris\source\repos\Cell\Cell\obj\Debug\net8.0-windows\Cell_0ukrv31b_wpftmp.GlobalUsings.g.cs", "C#", 5, 0, 0, 0, 0, 1, 1, 7
"c:\Users\chris\source\repos\Cell\Cell\obj\Debug\net8.0-windows\Cell_0ukrv31b_wpftmp.sourcelink.json", "JSON", 0, 0, 0, 1, 0, 0, 0, 1
"c:\Users\chris\source\repos\Cell\Cell\obj\Debug\net8.0-windows\Cell_0uqeua5g_wpftmp.AssemblyInfo.cs", "C#", 11, 0, 0, 0, 0, 10, 5, 26
"c:\Users\chris\source\repos\Cell\Cell\obj\Debug\net8.0-windows\Cell_0uqeua5g_wpftmp.GeneratedMSBuildEditorConfig.editorconfig", "Properties", 0, 0, 0, 0, 21, 0, 1, 22
"c:\Users\chris\source\repos\Cell\Cell\obj\Debug\net8.0-windows\Cell_0uqeua5g_wpftmp.GlobalUsings.g.cs", "C#", 5, 0, 0, 0, 0, 1, 1, 7
"c:\Users\chris\source\repos\Cell\Cell\obj\Debug\net8.0-windows\Cell_0uqeua5g_wpftmp.sourcelink.json", "JSON", 0, 0, 0, 1, 0, 0, 0, 1
"c:\Users\chris\source\repos\Cell\Cell\obj\Debug\net8.0-windows\Cell_0vueojk1_wpftmp.AssemblyInfo.cs", "C#", 11, 0, 0, 0, 0, 10, 5, 26
"c:\Users\chris\source\repos\Cell\Cell\obj\Debug\net8.0-windows\Cell_0vueojk1_wpftmp.GeneratedMSBuildEditorConfig.editorconfig", "Properties", 0, 0, 0, 0, 21, 0, 1, 22
"c:\Users\chris\source\repos\Cell\Cell\obj\Debug\net8.0-windows\Cell_0vueojk1_wpftmp.GlobalUsings.g.cs", "C#", 5, 0, 0, 0, 0, 1, 1, 7
"c:\Users\chris\source\repos\Cell\Cell\obj\Debug\net8.0-windows\Cell_0vueojk1_wpftmp.sourcelink.json", "JSON", 0, 0, 0, 1, 0, 0, 0, 1
"c:\Users\chris\source\repos\Cell\Cell\obj\Debug\net8.0-windows\Cell_0wnalqgf_wpftmp.AssemblyInfo.cs", "C#", 11, 0, 0, 0, 0, 10, 5, 26
"c:\Users\chris\source\repos\Cell\Cell\obj\Debug\net8.0-windows\Cell_0wnalqgf_wpftmp.GeneratedMSBuildEditorConfig.editorconfig", "Properties", 0, 0, 0, 0, 21, 0, 1, 22
"c:\Users\chris\source\repos\Cell\Cell\obj\Debug\net8.0-windows\Cell_0wnalqgf_wpftmp.GlobalUsings.g.cs", "C#", 5, 0, 0, 0, 0, 1, 1, 7
"c:\Users\chris\source\repos\Cell\Cell\obj\Debug\net8.0-windows\Cell_0wnalqgf_wpftmp.sourcelink.json", "JSON", 0, 0, 0, 1, 0, 0, 0, 1
"c:\Users\chris\source\repos\Cell\Cell\obj\Debug\net8.0-windows\Cell_0wt303gk_wpftmp.AssemblyInfo.cs", "C#", 11, 0, 0, 0, 0, 10, 5, 26
"c:\Users\chris\source\repos\Cell\Cell\obj\Debug\net8.0-windows\Cell_0wt303gk_wpftmp.GeneratedMSBuildEditorConfig.editorconfig", "Properties", 0, 0, 0, 0, 21, 0, 1, 22
"c:\Users\chris\source\repos\Cell\Cell\obj\Debug\net8.0-windows\Cell_0wt303gk_wpftmp.GlobalUsings.g.cs", "C#", 5, 0, 0, 0, 0, 1, 1, 7
"c:\Users\chris\source\repos\Cell\Cell\obj\Debug\net8.0-windows\Cell_0wt303gk_wpftmp.sourcelink.json", "JSON", 0, 0, 0, 1, 0, 0, 0, 1
"c:\Users\chris\source\repos\Cell\Cell\obj\Debug\net8.0-windows\Cell_0x0jxtaw_wpftmp.AssemblyInfo.cs", "C#", 11, 0, 0, 0, 0, 10, 5, 26
"c:\Users\chris\source\repos\Cell\Cell\obj\Debug\net8.0-windows\Cell_0x0jxtaw_wpftmp.GeneratedMSBuildEditorConfig.editorconfig", "Properties", 0, 0, 0, 0, 21, 0, 1, 22
"c:\Users\chris\source\repos\Cell\Cell\obj\Debug\net8.0-windows\Cell_0x0jxtaw_wpftmp.GlobalUsings.g.cs", "C#", 5, 0, 0, 0, 0, 1, 1, 7
"c:\Users\chris\source\repos\Cell\Cell\obj\Debug\net8.0-windows\Cell_0x0jxtaw_wpftmp.sourcelink.json", "JSON", 0, 0, 0, 1, 0, 0, 0, 1
"c:\Users\chris\source\repos\Cell\Cell\obj\Debug\net8.0-windows\Cell_0y00xytx_wpftmp.AssemblyInfo.cs", "C#", 11, 0, 0, 0, 0, 10, 5, 26
"c:\Users\chris\source\repos\Cell\Cell\obj\Debug\net8.0-windows\Cell_0y00xytx_wpftmp.GeneratedMSBuildEditorConfig.editorconfig", "Properties", 0, 0, 0, 0, 13, 0, 1, 14
"c:\Users\chris\source\repos\Cell\Cell\obj\Debug\net8.0-windows\Cell_0y00xytx_wpftmp.GlobalUsings.g.cs", "C#", 5, 0, 0, 0, 0, 1, 1, 7
"c:\Users\chris\source\repos\Cell\Cell\obj\Debug\net8.0-windows\Cell_0yg1eo5j_wpftmp.AssemblyInfo.cs", "C#", 11, 0, 0, 0, 0, 10, 5, 26
"c:\Users\chris\source\repos\Cell\Cell\obj\Debug\net8.0-windows\Cell_0yg1eo5j_wpftmp.GeneratedMSBuildEditorConfig.editorconfig", "Properties", 0, 0, 0, 0, 13, 0, 1, 14
"c:\Users\chris\source\repos\Cell\Cell\obj\Debug\net8.0-windows\Cell_0yg1eo5j_wpftmp.GlobalUsings.g.cs", "C#", 5, 0, 0, 0, 0, 1, 1, 7
"c:\Users\chris\source\repos\Cell\Cell\obj\Debug\net8.0-windows\Cell_0ygzjtbr_wpftmp.AssemblyInfo.cs", "C#", 11, 0, 0, 0, 0, 10, 5, 26
"c:\Users\chris\source\repos\Cell\Cell\obj\Debug\net8.0-windows\Cell_0ygzjtbr_wpftmp.GeneratedMSBuildEditorConfig.editorconfig", "Properties", 0, 0, 0, 0, 21, 0, 1, 22
"c:\Users\chris\source\repos\Cell\Cell\obj\Debug\net8.0-windows\Cell_0ygzjtbr_wpftmp.GlobalUsings.g.cs", "C#", 5, 0, 0, 0, 0, 1, 1, 7
"c:\Users\chris\source\repos\Cell\Cell\obj\Debug\net8.0-windows\Cell_0ygzjtbr_wpftmp.sourcelink.json", "JSON", 0, 0, 0, 1, 0, 0, 0, 1
"c:\Users\chris\source\repos\Cell\Cell\obj\Debug\net8.0-windows\Cell_0zcmuiq0_wpftmp.AssemblyInfo.cs", "C#", 11, 0, 0, 0, 0, 10, 5, 26
"c:\Users\chris\source\repos\Cell\Cell\obj\Debug\net8.0-windows\Cell_0zcmuiq0_wpftmp.GeneratedMSBuildEditorConfig.editorconfig", "Properties", 0, 0, 0, 0, 21, 0, 1, 22
"c:\Users\chris\source\repos\Cell\Cell\obj\Debug\net8.0-windows\Cell_0zcmuiq0_wpftmp.GlobalUsings.g.cs", "C#", 5, 0, 0, 0, 0, 1, 1, 7
"c:\Users\chris\source\repos\Cell\Cell\obj\Debug\net8.0-windows\Cell_0zcmuiq0_wpftmp.sourcelink.json", "JSON", 0, 0, 0, 1, 0, 0, 0, 1
"c:\Users\chris\source\repos\Cell\Cell\obj\Debug\net8.0-windows\Cell_0zzl5xrk_wpftmp.AssemblyInfo.cs", "C#", 11, 0, 0, 0, 0, 10, 5, 26
"c:\Users\chris\source\repos\Cell\Cell\obj\Debug\net8.0-windows\Cell_0zzl5xrk_wpftmp.GeneratedMSBuildEditorConfig.editorconfig", "Properties", 0, 0, 0, 0, 21, 0, 1, 22
"c:\Users\chris\source\repos\Cell\Cell\obj\Debug\net8.0-windows\Cell_0zzl5xrk_wpftmp.GlobalUsings.g.cs", "C#", 5, 0, 0, 0, 0, 1, 1, 7
"c:\Users\chris\source\repos\Cell\Cell\obj\Debug\net8.0-windows\Cell_0zzl5xrk_wpftmp.sourcelink.json", "JSON", 0, 0, 0, 1, 0, 0, 0, 1
"c:\Users\chris\source\repos\Cell\Cell\obj\Debug\net8.0-windows\Cell_10kpgu5c_wpftmp.AssemblyInfo.cs", "C#", 11, 0, 0, 0, 0, 10, 5, 26
"c:\Users\chris\source\repos\Cell\Cell\obj\Debug\net8.0-windows\Cell_10kpgu5c_wpftmp.GeneratedMSBuildEditorConfig.editorconfig", "Properties", 0, 0, 0, 0, 21, 0, 1, 22
"c:\Users\chris\source\repos\Cell\Cell\obj\Debug\net8.0-windows\Cell_10kpgu5c_wpftmp.GlobalUsings.g.cs", "C#", 5, 0, 0, 0, 0, 1, 1, 7
"c:\Users\chris\source\repos\Cell\Cell\obj\Debug\net8.0-windows\Cell_10kpgu5c_wpftmp.sourcelink.json", "JSON", 0, 0, 0, 1, 0, 0, 0, 1
"c:\Users\chris\source\repos\Cell\Cell\obj\Debug\net8.0-windows\Cell_11adn3mb_wpftmp.AssemblyInfo.cs", "C#", 11, 0, 0, 0, 0, 10, 5, 26
"c:\Users\chris\source\repos\Cell\Cell\obj\Debug\net8.0-windows\Cell_11adn3mb_wpftmp.GeneratedMSBuildEditorConfig.editorconfig", "Properties", 0, 0, 0, 0, 21, 0, 1, 22
"c:\Users\chris\source\repos\Cell\Cell\obj\Debug\net8.0-windows\Cell_11adn3mb_wpftmp.GlobalUsings.g.cs", "C#", 5, 0, 0, 0, 0, 1, 1, 7
"c:\Users\chris\source\repos\Cell\Cell\obj\Debug\net8.0-windows\Cell_11adn3mb_wpftmp.sourcelink.json", "JSON", 0, 0, 0, 1, 0, 0, 0, 1
"c:\Users\chris\source\repos\Cell\Cell\obj\Debug\net8.0-windows\Cell_12ozbbsc_wpftmp.AssemblyInfo.cs", "C#", 11, 0, 0, 0, 0, 10, 5, 26
"c:\Users\chris\source\repos\Cell\Cell\obj\Debug\net8.0-windows\Cell_12ozbbsc_wpftmp.GeneratedMSBuildEditorConfig.editorconfig", "Properties", 0, 0, 0, 0, 13, 0, 1, 14
"c:\Users\chris\source\repos\Cell\Cell\obj\Debug\net8.0-windows\Cell_12ozbbsc_wpftmp.GlobalUsings.g.cs", "C#", 5, 0, 0, 0, 0, 1, 1, 7
"c:\Users\chris\source\repos\Cell\Cell\obj\Debug\net8.0-windows\Cell_13e0igum_wpftmp.AssemblyInfo.cs", "C#", 11, 0, 0, 0, 0, 10, 5, 26
"c:\Users\chris\source\repos\Cell\Cell\obj\Debug\net8.0-windows\Cell_13e0igum_wpftmp.GeneratedMSBuildEditorConfig.editorconfig", "Properties", 0, 0, 0, 0, 21, 0, 1, 22
"c:\Users\chris\source\repos\Cell\Cell\obj\Debug\net8.0-windows\Cell_13e0igum_wpftmp.GlobalUsings.g.cs", "C#", 5, 0, 0, 0, 0, 1, 1, 7
"c:\Users\chris\source\repos\Cell\Cell\obj\Debug\net8.0-windows\Cell_13e0igum_wpftmp.sourcelink.json", "JSON", 0, 0, 0, 1, 0, 0, 0, 1
"c:\Users\chris\source\repos\Cell\Cell\obj\Debug\net8.0-windows\Cell_145ipizu_wpftmp.AssemblyInfo.cs", "C#", 11, 0, 0, 0, 0, 10, 5, 26
"c:\Users\chris\source\repos\Cell\Cell\obj\Debug\net8.0-windows\Cell_145ipizu_wpftmp.GeneratedMSBuildEditorConfig.editorconfig", "Properties", 0, 0, 0, 0, 21, 0, 1, 22
"c:\Users\chris\source\repos\Cell\Cell\obj\Debug\net8.0-windows\Cell_145ipizu_wpftmp.GlobalUsings.g.cs", "C#", 5, 0, 0, 0, 0, 1, 1, 7
"c:\Users\chris\source\repos\Cell\Cell\obj\Debug\net8.0-windows\Cell_145ipizu_wpftmp.sourcelink.json", "JSON", 0, 0, 0, 1, 0, 0, 0, 1
"c:\Users\chris\source\repos\Cell\Cell\obj\Debug\net8.0-windows\Cell_1ajxiagr_wpftmp.AssemblyInfo.cs", "C#", 11, 0, 0, 0, 0, 10, 5, 26
"c:\Users\chris\source\repos\Cell\Cell\obj\Debug\net8.0-windows\Cell_1ajxiagr_wpftmp.GeneratedMSBuildEditorConfig.editorconfig", "Properties", 0, 0, 0, 0, 13, 0, 1, 14
"c:\Users\chris\source\repos\Cell\Cell\obj\Debug\net8.0-windows\Cell_1ajxiagr_wpftmp.GlobalUsings.g.cs", "C#", 5, 0, 0, 0, 0, 1, 1, 7
"c:\Users\chris\source\repos\Cell\Cell\obj\Debug\net8.0-windows\Cell_1bj05i12_wpftmp.AssemblyInfo.cs", "C#", 11, 0, 0, 0, 0, 10, 5, 26
"c:\Users\chris\source\repos\Cell\Cell\obj\Debug\net8.0-windows\Cell_1bj05i12_wpftmp.GeneratedMSBuildEditorConfig.editorconfig", "Properties", 0, 0, 0, 0, 13, 0, 1, 14
"c:\Users\chris\source\repos\Cell\Cell\obj\Debug\net8.0-windows\Cell_1bj05i12_wpftmp.GlobalUsings.g.cs", "C#", 5, 0, 0, 0, 0, 1, 1, 7
"c:\Users\chris\source\repos\Cell\Cell\obj\Debug\net8.0-windows\Cell_1bqednu1_wpftmp.AssemblyInfo.cs", "C#", 11, 0, 0, 0, 0, 10, 5, 26
"c:\Users\chris\source\repos\Cell\Cell\obj\Debug\net8.0-windows\Cell_1bqednu1_wpftmp.GeneratedMSBuildEditorConfig.editorconfig", "Properties", 0, 0, 0, 0, 21, 0, 1, 22
"c:\Users\chris\source\repos\Cell\Cell\obj\Debug\net8.0-windows\Cell_1bqednu1_wpftmp.GlobalUsings.g.cs", "C#", 5, 0, 0, 0, 0, 1, 1, 7
"c:\Users\chris\source\repos\Cell\Cell\obj\Debug\net8.0-windows\Cell_1bqednu1_wpftmp.sourcelink.json", "JSON", 0, 0, 0, 1, 0, 0, 0, 1
"c:\Users\chris\source\repos\Cell\Cell\obj\Debug\net8.0-windows\Cell_1clipswx_wpftmp.AssemblyInfo.cs", "C#", 11, 0, 0, 0, 0, 10, 5, 26
"c:\Users\chris\source\repos\Cell\Cell\obj\Debug\net8.0-windows\Cell_1clipswx_wpftmp.GeneratedMSBuildEditorConfig.editorconfig", "Properties", 0, 0, 0, 0, 21, 0, 1, 22
"c:\Users\chris\source\repos\Cell\Cell\obj\Debug\net8.0-windows\Cell_1clipswx_wpftmp.GlobalUsings.g.cs", "C#", 5, 0, 0, 0, 0, 1, 1, 7
"c:\Users\chris\source\repos\Cell\Cell\obj\Debug\net8.0-windows\Cell_1cpc4wow_wpftmp.AssemblyInfo.cs", "C#", 11, 0, 0, 0, 0, 10, 5, 26
"c:\Users\chris\source\repos\Cell\Cell\obj\Debug\net8.0-windows\Cell_1cpc4wow_wpftmp.GeneratedMSBuildEditorConfig.editorconfig", "Properties", 0, 0, 0, 0, 21, 0, 1, 22
"c:\Users\chris\source\repos\Cell\Cell\obj\Debug\net8.0-windows\Cell_1cpc4wow_wpftmp.GlobalUsings.g.cs", "C#", 5, 0, 0, 0, 0, 1, 1, 7
"c:\Users\chris\source\repos\Cell\Cell\obj\Debug\net8.0-windows\Cell_1cpc4wow_wpftmp.sourcelink.json", "JSON", 0, 0, 0, 1, 0, 0, 0, 1
"c:\Users\chris\source\repos\Cell\Cell\obj\Debug\net8.0-windows\Cell_1dyrzjf5_wpftmp.AssemblyInfo.cs", "C#", 11, 0, 0, 0, 0, 10, 5, 26
"c:\Users\chris\source\repos\Cell\Cell\obj\Debug\net8.0-windows\Cell_1dyrzjf5_wpftmp.GeneratedMSBuildEditorConfig.editorconfig", "Properties", 0, 0, 0, 0, 21, 0, 1, 22
"c:\Users\chris\source\repos\Cell\Cell\obj\Debug\net8.0-windows\Cell_1dyrzjf5_wpftmp.GlobalUsings.g.cs", "C#", 5, 0, 0, 0, 0, 1, 1, 7
"c:\Users\chris\source\repos\Cell\Cell\obj\Debug\net8.0-windows\Cell_1dyrzjf5_wpftmp.sourcelink.json", "JSON", 0, 0, 0, 1, 0, 0, 0, 1
"c:\Users\chris\source\repos\Cell\Cell\obj\Debug\net8.0-windows\Cell_1dzswsre_wpftmp.AssemblyInfo.cs", "C#", 11, 0, 0, 0, 0, 10, 5, 26
"c:\Users\chris\source\repos\Cell\Cell\obj\Debug\net8.0-windows\Cell_1dzswsre_wpftmp.GeneratedMSBuildEditorConfig.editorconfig", "Properties", 0, 0, 0, 0, 21, 0, 1, 22
"c:\Users\chris\source\repos\Cell\Cell\obj\Debug\net8.0-windows\Cell_1dzswsre_wpftmp.GlobalUsings.g.cs", "C#", 5, 0, 0, 0, 0, 1, 1, 7
"c:\Users\chris\source\repos\Cell\Cell\obj\Debug\net8.0-windows\Cell_1dzswsre_wpftmp.sourcelink.json", "JSON", 0, 0, 0, 1, 0, 0, 0, 1
"c:\Users\chris\source\repos\Cell\Cell\obj\Debug\net8.0-windows\Cell_1ibtvqvh_wpftmp.AssemblyInfo.cs", "C#", 11, 0, 0, 0, 0, 10, 5, 26
"c:\Users\chris\source\repos\Cell\Cell\obj\Debug\net8.0-windows\Cell_1ibtvqvh_wpftmp.GeneratedMSBuildEditorConfig.editorconfig", "Properties", 0, 0, 0, 0, 13, 0, 1, 14
"c:\Users\chris\source\repos\Cell\Cell\obj\Debug\net8.0-windows\Cell_1ibtvqvh_wpftmp.GlobalUsings.g.cs", "C#", 5, 0, 0, 0, 0, 1, 1, 7
"c:\Users\chris\source\repos\Cell\Cell\obj\Debug\net8.0-windows\Cell_1iwx2kp3_wpftmp.AssemblyInfo.cs", "C#", 11, 0, 0, 0, 0, 10, 5, 26
"c:\Users\chris\source\repos\Cell\Cell\obj\Debug\net8.0-windows\Cell_1iwx2kp3_wpftmp.GeneratedMSBuildEditorConfig.editorconfig", "Properties", 0, 0, 0, 0, 21, 0, 1, 22
"c:\Users\chris\source\repos\Cell\Cell\obj\Debug\net8.0-windows\Cell_1iwx2kp3_wpftmp.GlobalUsings.g.cs", "C#", 5, 0, 0, 0, 0, 1, 1, 7
"c:\Users\chris\source\repos\Cell\Cell\obj\Debug\net8.0-windows\Cell_1iwx2kp3_wpftmp.sourcelink.json", "JSON", 0, 0, 0, 1, 0, 0, 0, 1
"c:\Users\chris\source\repos\Cell\Cell\obj\Debug\net8.0-windows\Cell_1j4eh2hp_wpftmp.AssemblyInfo.cs", "C#", 11, 0, 0, 0, 0, 10, 5, 26
"c:\Users\chris\source\repos\Cell\Cell\obj\Debug\net8.0-windows\Cell_1j4eh2hp_wpftmp.GeneratedMSBuildEditorConfig.editorconfig", "Properties", 0, 0, 0, 0, 21, 0, 1, 22
"c:\Users\chris\source\repos\Cell\Cell\obj\Debug\net8.0-windows\Cell_1j4eh2hp_wpftmp.GlobalUsings.g.cs", "C#", 5, 0, 0, 0, 0, 1, 1, 7
"c:\Users\chris\source\repos\Cell\Cell\obj\Debug\net8.0-windows\Cell_1j4eh2hp_wpftmp.sourcelink.json", "JSON", 0, 0, 0, 1, 0, 0, 0, 1
"c:\Users\chris\source\repos\Cell\Cell\obj\Debug\net8.0-windows\Cell_1jqwjbjz_wpftmp.AssemblyInfo.cs", "C#", 11, 0, 0, 0, 0, 10, 5, 26
"c:\Users\chris\source\repos\Cell\Cell\obj\Debug\net8.0-windows\Cell_1jqwjbjz_wpftmp.GeneratedMSBuildEditorConfig.editorconfig", "Properties", 0, 0, 0, 0, 21, 0, 1, 22
"c:\Users\chris\source\repos\Cell\Cell\obj\Debug\net8.0-windows\Cell_1jqwjbjz_wpftmp.GlobalUsings.g.cs", "C#", 5, 0, 0, 0, 0, 1, 1, 7
"c:\Users\chris\source\repos\Cell\Cell\obj\Debug\net8.0-windows\Cell_1jqwjbjz_wpftmp.sourcelink.json", "JSON", 0, 0, 0, 1, 0, 0, 0, 1
"c:\Users\chris\source\repos\Cell\Cell\obj\Debug\net8.0-windows\Cell_1kkokcrh_wpftmp.AssemblyInfo.cs", "C#", 11, 0, 0, 0, 0, 10, 5, 26
"c:\Users\chris\source\repos\Cell\Cell\obj\Debug\net8.0-windows\Cell_1kkokcrh_wpftmp.GeneratedMSBuildEditorConfig.editorconfig", "Properties", 0, 0, 0, 0, 13, 0, 1, 14
"c:\Users\chris\source\repos\Cell\Cell\obj\Debug\net8.0-windows\Cell_1kkokcrh_wpftmp.GlobalUsings.g.cs", "C#", 5, 0, 0, 0, 0, 1, 1, 7
"c:\Users\chris\source\repos\Cell\Cell\obj\Debug\net8.0-windows\Cell_1lzuykwx_wpftmp.AssemblyInfo.cs", "C#", 11, 0, 0, 0, 0, 10, 5, 26
"c:\Users\chris\source\repos\Cell\Cell\obj\Debug\net8.0-windows\Cell_1lzuykwx_wpftmp.GeneratedMSBuildEditorConfig.editorconfig", "Properties", 0, 0, 0, 0, 21, 0, 1, 22
"c:\Users\chris\source\repos\Cell\Cell\obj\Debug\net8.0-windows\Cell_1lzuykwx_wpftmp.GlobalUsings.g.cs", "C#", 5, 0, 0, 0, 0, 1, 1, 7
"c:\Users\chris\source\repos\Cell\Cell\obj\Debug\net8.0-windows\Cell_1lzuykwx_wpftmp.sourcelink.json", "JSON", 0, 0, 0, 1, 0, 0, 0, 1
"c:\Users\chris\source\repos\Cell\Cell\obj\Debug\net8.0-windows\Cell_1mhrplhv_wpftmp.AssemblyInfo.cs", "C#", 11, 0, 0, 0, 0, 10, 5, 26
"c:\Users\chris\source\repos\Cell\Cell\obj\Debug\net8.0-windows\Cell_1mhrplhv_wpftmp.GeneratedMSBuildEditorConfig.editorconfig", "Properties", 0, 0, 0, 0, 21, 0, 1, 22
"c:\Users\chris\source\repos\Cell\Cell\obj\Debug\net8.0-windows\Cell_1mhrplhv_wpftmp.GlobalUsings.g.cs", "C#", 5, 0, 0, 0, 0, 1, 1, 7
"c:\Users\chris\source\repos\Cell\Cell\obj\Debug\net8.0-windows\Cell_1mhrplhv_wpftmp.sourcelink.json", "JSON", 0, 0, 0, 1, 0, 0, 0, 1
"c:\Users\chris\source\repos\Cell\Cell\obj\Debug\net8.0-windows\Cell_1my21lcy_wpftmp.AssemblyInfo.cs", "C#", 11, 0, 0, 0, 0, 10, 5, 26
"c:\Users\chris\source\repos\Cell\Cell\obj\Debug\net8.0-windows\Cell_1my21lcy_wpftmp.GeneratedMSBuildEditorConfig.editorconfig", "Properties", 0, 0, 0, 0, 21, 0, 1, 22
"c:\Users\chris\source\repos\Cell\Cell\obj\Debug\net8.0-windows\Cell_1my21lcy_wpftmp.GlobalUsings.g.cs", "C#", 5, 0, 0, 0, 0, 1, 1, 7
"c:\Users\chris\source\repos\Cell\Cell\obj\Debug\net8.0-windows\Cell_1my21lcy_wpftmp.sourcelink.json", "JSON", 0, 0, 0, 1, 0, 0, 0, 1
"c:\Users\chris\source\repos\Cell\Cell\obj\Debug\net8.0-windows\Cell_1n5wvyw3_wpftmp.AssemblyInfo.cs", "C#", 11, 0, 0, 0, 0, 10, 5, 26
"c:\Users\chris\source\repos\Cell\Cell\obj\Debug\net8.0-windows\Cell_1n5wvyw3_wpftmp.GeneratedMSBuildEditorConfig.editorconfig", "Properties", 0, 0, 0, 0, 21, 0, 1, 22
"c:\Users\chris\source\repos\Cell\Cell\obj\Debug\net8.0-windows\Cell_1n5wvyw3_wpftmp.GlobalUsings.g.cs", "C#", 5, 0, 0, 0, 0, 1, 1, 7
"c:\Users\chris\source\repos\Cell\Cell\obj\Debug\net8.0-windows\Cell_1n5wvyw3_wpftmp.sourcelink.json", "JSON", 0, 0, 0, 1, 0, 0, 0, 1
"c:\Users\chris\source\repos\Cell\Cell\obj\Debug\net8.0-windows\Cell_1ncpolyu_wpftmp.AssemblyInfo.cs", "C#", 11, 0, 0, 0, 0, 10, 5, 26
"c:\Users\chris\source\repos\Cell\Cell\obj\Debug\net8.0-windows\Cell_1ncpolyu_wpftmp.GeneratedMSBuildEditorConfig.editorconfig", "Properties", 0, 0, 0, 0, 21, 0, 1, 22
"c:\Users\chris\source\repos\Cell\Cell\obj\Debug\net8.0-windows\Cell_1ncpolyu_wpftmp.GlobalUsings.g.cs", "C#", 5, 0, 0, 0, 0, 1, 1, 7
"c:\Users\chris\source\repos\Cell\Cell\obj\Debug\net8.0-windows\Cell_1ncpolyu_wpftmp.sourcelink.json", "JSON", 0, 0, 0, 1, 0, 0, 0, 1
"c:\Users\chris\source\repos\Cell\Cell\obj\Debug\net8.0-windows\Cell_1obrqhb1_wpftmp.AssemblyInfo.cs", "C#", 11, 0, 0, 0, 0, 10, 5, 26
"c:\Users\chris\source\repos\Cell\Cell\obj\Debug\net8.0-windows\Cell_1obrqhb1_wpftmp.GeneratedMSBuildEditorConfig.editorconfig", "Properties", 0, 0, 0, 0, 21, 0, 1, 22
"c:\Users\chris\source\repos\Cell\Cell\obj\Debug\net8.0-windows\Cell_1obrqhb1_wpftmp.GlobalUsings.g.cs", "C#", 5, 0, 0, 0, 0, 1, 1, 7
"c:\Users\chris\source\repos\Cell\Cell\obj\Debug\net8.0-windows\Cell_1obrqhb1_wpftmp.sourcelink.json", "JSON", 0, 0, 0, 1, 0, 0, 0, 1
"c:\Users\chris\source\repos\Cell\Cell\obj\Debug\net8.0-windows\Cell_1onrnxpm_wpftmp.AssemblyInfo.cs", "C#", 11, 0, 0, 0, 0, 10, 5, 26
"c:\Users\chris\source\repos\Cell\Cell\obj\Debug\net8.0-windows\Cell_1onrnxpm_wpftmp.GeneratedMSBuildEditorConfig.editorconfig", "Properties", 0, 0, 0, 0, 13, 0, 1, 14
"c:\Users\chris\source\repos\Cell\Cell\obj\Debug\net8.0-windows\Cell_1onrnxpm_wpftmp.GlobalUsings.g.cs", "C#", 5, 0, 0, 0, 0, 1, 1, 7
"c:\Users\chris\source\repos\Cell\Cell\obj\Debug\net8.0-windows\Cell_1p50ovjk_wpftmp.AssemblyInfo.cs", "C#", 11, 0, 0, 0, 0, 10, 5, 26
"c:\Users\chris\source\repos\Cell\Cell\obj\Debug\net8.0-windows\Cell_1p50ovjk_wpftmp.GeneratedMSBuildEditorConfig.editorconfig", "Properties", 0, 0, 0, 0, 21, 0, 1, 22
"c:\Users\chris\source\repos\Cell\Cell\obj\Debug\net8.0-windows\Cell_1p50ovjk_wpftmp.GlobalUsings.g.cs", "C#", 5, 0, 0, 0, 0, 1, 1, 7
"c:\Users\chris\source\repos\Cell\Cell\obj\Debug\net8.0-windows\Cell_1p50ovjk_wpftmp.sourcelink.json", "JSON", 0, 0, 0, 1, 0, 0, 0, 1
"c:\Users\chris\source\repos\Cell\Cell\obj\Debug\net8.0-windows\Cell_1pugnkch_wpftmp.AssemblyInfo.cs", "C#", 11, 0, 0, 0, 0, 10, 5, 26
"c:\Users\chris\source\repos\Cell\Cell\obj\Debug\net8.0-windows\Cell_1pugnkch_wpftmp.GeneratedMSBuildEditorConfig.editorconfig", "Properties", 0, 0, 0, 0, 21, 0, 1, 22
"c:\Users\chris\source\repos\Cell\Cell\obj\Debug\net8.0-windows\Cell_1pugnkch_wpftmp.GlobalUsings.g.cs", "C#", 5, 0, 0, 0, 0, 1, 1, 7
"c:\Users\chris\source\repos\Cell\Cell\obj\Debug\net8.0-windows\Cell_1pugnkch_wpftmp.sourcelink.json", "JSON", 0, 0, 0, 1, 0, 0, 0, 1
"c:\Users\chris\source\repos\Cell\Cell\obj\Debug\net8.0-windows\Cell_1q3eg4wx_wpftmp.AssemblyInfo.cs", "C#", 11, 0, 0, 0, 0, 10, 5, 26
"c:\Users\chris\source\repos\Cell\Cell\obj\Debug\net8.0-windows\Cell_1q3eg4wx_wpftmp.GeneratedMSBuildEditorConfig.editorconfig", "Properties", 0, 0, 0, 0, 21, 0, 1, 22
"c:\Users\chris\source\repos\Cell\Cell\obj\Debug\net8.0-windows\Cell_1q3eg4wx_wpftmp.GlobalUsings.g.cs", "C#", 5, 0, 0, 0, 0, 1, 1, 7
"c:\Users\chris\source\repos\Cell\Cell\obj\Debug\net8.0-windows\Cell_1q3eg4wx_wpftmp.sourcelink.json", "JSON", 0, 0, 0, 1, 0, 0, 0, 1
"c:\Users\chris\source\repos\Cell\Cell\obj\Debug\net8.0-windows\Cell_1qwwyeiu_wpftmp.AssemblyInfo.cs", "C#", 11, 0, 0, 0, 0, 10, 5, 26
"c:\Users\chris\source\repos\Cell\Cell\obj\Debug\net8.0-windows\Cell_1qwwyeiu_wpftmp.GeneratedMSBuildEditorConfig.editorconfig", "Properties", 0, 0, 0, 0, 21, 0, 1, 22
"c:\Users\chris\source\repos\Cell\Cell\obj\Debug\net8.0-windows\Cell_1qwwyeiu_wpftmp.GlobalUsings.g.cs", "C#", 5, 0, 0, 0, 0, 1, 1, 7
"c:\Users\chris\source\repos\Cell\Cell\obj\Debug\net8.0-windows\Cell_1qwwyeiu_wpftmp.sourcelink.json", "JSON", 0, 0, 0, 1, 0, 0, 0, 1
"c:\Users\chris\source\repos\Cell\Cell\obj\Debug\net8.0-windows\Cell_1r5m1bym_wpftmp.AssemblyInfo.cs", "C#", 11, 0, 0, 0, 0, 10, 5, 26
"c:\Users\chris\source\repos\Cell\Cell\obj\Debug\net8.0-windows\Cell_1r5m1bym_wpftmp.GeneratedMSBuildEditorConfig.editorconfig", "Properties", 0, 0, 0, 0, 21, 0, 1, 22
"c:\Users\chris\source\repos\Cell\Cell\obj\Debug\net8.0-windows\Cell_1r5m1bym_wpftmp.GlobalUsings.g.cs", "C#", 5, 0, 0, 0, 0, 1, 1, 7
"c:\Users\chris\source\repos\Cell\Cell\obj\Debug\net8.0-windows\Cell_1r5m1bym_wpftmp.sourcelink.json", "JSON", 0, 0, 0, 1, 0, 0, 0, 1
"c:\Users\chris\source\repos\Cell\Cell\obj\Debug\net8.0-windows\Cell_1rdlhuzq_wpftmp.AssemblyInfo.cs", "C#", 11, 0, 0, 0, 0, 10, 5, 26
"c:\Users\chris\source\repos\Cell\Cell\obj\Debug\net8.0-windows\Cell_1rdlhuzq_wpftmp.GeneratedMSBuildEditorConfig.editorconfig", "Properties", 0, 0, 0, 0, 21, 0, 1, 22
"c:\Users\chris\source\repos\Cell\Cell\obj\Debug\net8.0-windows\Cell_1rdlhuzq_wpftmp.GlobalUsings.g.cs", "C#", 5, 0, 0, 0, 0, 1, 1, 7
"c:\Users\chris\source\repos\Cell\Cell\obj\Debug\net8.0-windows\Cell_1rdlhuzq_wpftmp.sourcelink.json", "JSON", 0, 0, 0, 1, 0, 0, 0, 1
"c:\Users\chris\source\repos\Cell\Cell\obj\Debug\net8.0-windows\Cell_1rlat2eb_wpftmp.AssemblyInfo.cs", "C#", 11, 0, 0, 0, 0, 10, 5, 26
"c:\Users\chris\source\repos\Cell\Cell\obj\Debug\net8.0-windows\Cell_1rlat2eb_wpftmp.GeneratedMSBuildEditorConfig.editorconfig", "Properties", 0, 0, 0, 0, 21, 0, 1, 22
"c:\Users\chris\source\repos\Cell\Cell\obj\Debug\net8.0-windows\Cell_1rlat2eb_wpftmp.GlobalUsings.g.cs", "C#", 5, 0, 0, 0, 0, 1, 1, 7
"c:\Users\chris\source\repos\Cell\Cell\obj\Debug\net8.0-windows\Cell_1rlat2eb_wpftmp.sourcelink.json", "JSON", 0, 0, 0, 1, 0, 0, 0, 1
"c:\Users\chris\source\repos\Cell\Cell\obj\Debug\net8.0-windows\Cell_1s22f55u_wpftmp.AssemblyInfo.cs", "C#", 11, 0, 0, 0, 0, 10, 5, 26
"c:\Users\chris\source\repos\Cell\Cell\obj\Debug\net8.0-windows\Cell_1s22f55u_wpftmp.GeneratedMSBuildEditorConfig.editorconfig", "Properties", 0, 0, 0, 0, 21, 0, 1, 22
"c:\Users\chris\source\repos\Cell\Cell\obj\Debug\net8.0-windows\Cell_1s22f55u_wpftmp.GlobalUsings.g.cs", "C#", 5, 0, 0, 0, 0, 1, 1, 7
"c:\Users\chris\source\repos\Cell\Cell\obj\Debug\net8.0-windows\Cell_1s22f55u_wpftmp.sourcelink.json", "JSON", 0, 0, 0, 1, 0, 0, 0, 1
"c:\Users\chris\source\repos\Cell\Cell\obj\Debug\net8.0-windows\Cell_1ty1jkpt_wpftmp.AssemblyInfo.cs", "C#", 11, 0, 0, 0, 0, 10, 5, 26
"c:\Users\chris\source\repos\Cell\Cell\obj\Debug\net8.0-windows\Cell_1ty1jkpt_wpftmp.GeneratedMSBuildEditorConfig.editorconfig", "Properties", 0, 0, 0, 0, 21, 0, 1, 22
"c:\Users\chris\source\repos\Cell\Cell\obj\Debug\net8.0-windows\Cell_1ty1jkpt_wpftmp.GlobalUsings.g.cs", "C#", 5, 0, 0, 0, 0, 1, 1, 7
"c:\Users\chris\source\repos\Cell\Cell\obj\Debug\net8.0-windows\Cell_1ty1jkpt_wpftmp.sourcelink.json", "JSON", 0, 0, 0, 1, 0, 0, 0, 1
"c:\Users\chris\source\repos\Cell\Cell\obj\Debug\net8.0-windows\Cell_1tyc2u2l_wpftmp.AssemblyInfo.cs", "C#", 11, 0, 0, 0, 0, 10, 5, 26
"c:\Users\chris\source\repos\Cell\Cell\obj\Debug\net8.0-windows\Cell_1tyc2u2l_wpftmp.GeneratedMSBuildEditorConfig.editorconfig", "Properties", 0, 0, 0, 0, 13, 0, 1, 14
"c:\Users\chris\source\repos\Cell\Cell\obj\Debug\net8.0-windows\Cell_1tyc2u2l_wpftmp.GlobalUsings.g.cs", "C#", 5, 0, 0, 0, 0, 1, 1, 7
"c:\Users\chris\source\repos\Cell\Cell\obj\Debug\net8.0-windows\Cell_1vby3dwk_wpftmp.AssemblyInfo.cs", "C#", 11, 0, 0, 0, 0, 10, 5, 26
"c:\Users\chris\source\repos\Cell\Cell\obj\Debug\net8.0-windows\Cell_1vby3dwk_wpftmp.GeneratedMSBuildEditorConfig.editorconfig", "Properties", 0, 0, 0, 0, 21, 0, 1, 22
"c:\Users\chris\source\repos\Cell\Cell\obj\Debug\net8.0-windows\Cell_1vby3dwk_wpftmp.GlobalUsings.g.cs", "C#", 5, 0, 0, 0, 0, 1, 1, 7
"c:\Users\chris\source\repos\Cell\Cell\obj\Debug\net8.0-windows\Cell_1vby3dwk_wpftmp.sourcelink.json", "JSON", 0, 0, 0, 1, 0, 0, 0, 1
"c:\Users\chris\source\repos\Cell\Cell\obj\Debug\net8.0-windows\Cell_1vdlvnop_wpftmp.AssemblyInfo.cs", "C#", 11, 0, 0, 0, 0, 10, 5, 26
"c:\Users\chris\source\repos\Cell\Cell\obj\Debug\net8.0-windows\Cell_1vdlvnop_wpftmp.GeneratedMSBuildEditorConfig.editorconfig", "Properties", 0, 0, 0, 0, 21, 0, 1, 22
"c:\Users\chris\source\repos\Cell\Cell\obj\Debug\net8.0-windows\Cell_1vdlvnop_wpftmp.GlobalUsings.g.cs", "C#", 5, 0, 0, 0, 0, 1, 1, 7
"c:\Users\chris\source\repos\Cell\Cell\obj\Debug\net8.0-windows\Cell_1vdlvnop_wpftmp.sourcelink.json", "JSON", 0, 0, 0, 1, 0, 0, 0, 1
"c:\Users\chris\source\repos\Cell\Cell\obj\Debug\net8.0-windows\Cell_1vrwp3vs_wpftmp.AssemblyInfo.cs", "C#", 11, 0, 0, 0, 0, 10, 5, 26
"c:\Users\chris\source\repos\Cell\Cell\obj\Debug\net8.0-windows\Cell_1vrwp3vs_wpftmp.GeneratedMSBuildEditorConfig.editorconfig", "Properties", 0, 0, 0, 0, 21, 0, 1, 22
"c:\Users\chris\source\repos\Cell\Cell\obj\Debug\net8.0-windows\Cell_1vrwp3vs_wpftmp.GlobalUsings.g.cs", "C#", 5, 0, 0, 0, 0, 1, 1, 7
"c:\Users\chris\source\repos\Cell\Cell\obj\Debug\net8.0-windows\Cell_1vrwp3vs_wpftmp.sourcelink.json", "JSON", 0, 0, 0, 1, 0, 0, 0, 1
"c:\Users\chris\source\repos\Cell\Cell\obj\Debug\net8.0-windows\Cell_1xfhga0a_wpftmp.AssemblyInfo.cs", "C#", 11, 0, 0, 0, 0, 10, 5, 26
"c:\Users\chris\source\repos\Cell\Cell\obj\Debug\net8.0-windows\Cell_1xfhga0a_wpftmp.GeneratedMSBuildEditorConfig.editorconfig", "Properties", 0, 0, 0, 0, 13, 0, 1, 14
"c:\Users\chris\source\repos\Cell\Cell\obj\Debug\net8.0-windows\Cell_1xfhga0a_wpftmp.GlobalUsings.g.cs", "C#", 5, 0, 0, 0, 0, 1, 1, 7
"c:\Users\chris\source\repos\Cell\Cell\obj\Debug\net8.0-windows\Cell_1xkzxdra_wpftmp.AssemblyInfo.cs", "C#", 11, 0, 0, 0, 0, 10, 5, 26
"c:\Users\chris\source\repos\Cell\Cell\obj\Debug\net8.0-windows\Cell_1xkzxdra_wpftmp.GeneratedMSBuildEditorConfig.editorconfig", "Properties", 0, 0, 0, 0, 13, 0, 1, 14
"c:\Users\chris\source\repos\Cell\Cell\obj\Debug\net8.0-windows\Cell_1xkzxdra_wpftmp.GlobalUsings.g.cs", "C#", 5, 0, 0, 0, 0, 1, 1, 7
"c:\Users\chris\source\repos\Cell\Cell\obj\Debug\net8.0-windows\Cell_1xwtjvbr_wpftmp.AssemblyInfo.cs", "C#", 11, 0, 0, 0, 0, 10, 5, 26
"c:\Users\chris\source\repos\Cell\Cell\obj\Debug\net8.0-windows\Cell_1xwtjvbr_wpftmp.GeneratedMSBuildEditorConfig.editorconfig", "Properties", 0, 0, 0, 0, 21, 0, 1, 22
"c:\Users\chris\source\repos\Cell\Cell\obj\Debug\net8.0-windows\Cell_1xwtjvbr_wpftmp.GlobalUsings.g.cs", "C#", 5, 0, 0, 0, 0, 1, 1, 7
"c:\Users\chris\source\repos\Cell\Cell\obj\Debug\net8.0-windows\Cell_1ylue5ru_wpftmp.AssemblyInfo.cs", "C#", 11, 0, 0, 0, 0, 10, 5, 26
"c:\Users\chris\source\repos\Cell\Cell\obj\Debug\net8.0-windows\Cell_1ylue5ru_wpftmp.GeneratedMSBuildEditorConfig.editorconfig", "Properties", 0, 0, 0, 0, 21, 0, 1, 22
"c:\Users\chris\source\repos\Cell\Cell\obj\Debug\net8.0-windows\Cell_1ylue5ru_wpftmp.GlobalUsings.g.cs", "C#", 5, 0, 0, 0, 0, 1, 1, 7
"c:\Users\chris\source\repos\Cell\Cell\obj\Debug\net8.0-windows\Cell_1ylue5ru_wpftmp.sourcelink.json", "JSON", 0, 0, 0, 1, 0, 0, 0, 1
"c:\Users\chris\source\repos\Cell\Cell\obj\Debug\net8.0-windows\Cell_1ypwh0oi_wpftmp.AssemblyInfo.cs", "C#", 11, 0, 0, 0, 0, 10, 5, 26
"c:\Users\chris\source\repos\Cell\Cell\obj\Debug\net8.0-windows\Cell_1ypwh0oi_wpftmp.GeneratedMSBuildEditorConfig.editorconfig", "Properties", 0, 0, 0, 0, 21, 0, 1, 22
"c:\Users\chris\source\repos\Cell\Cell\obj\Debug\net8.0-windows\Cell_1ypwh0oi_wpftmp.GlobalUsings.g.cs", "C#", 5, 0, 0, 0, 0, 1, 1, 7
"c:\Users\chris\source\repos\Cell\Cell\obj\Debug\net8.0-windows\Cell_1ypwh0oi_wpftmp.sourcelink.json", "JSON", 0, 0, 0, 1, 0, 0, 0, 1
"c:\Users\chris\source\repos\Cell\Cell\obj\Debug\net8.0-windows\Cell_1zsbmj1g_wpftmp.AssemblyInfo.cs", "C#", 11, 0, 0, 0, 0, 10, 5, 26
"c:\Users\chris\source\repos\Cell\Cell\obj\Debug\net8.0-windows\Cell_1zsbmj1g_wpftmp.GeneratedMSBuildEditorConfig.editorconfig", "Properties", 0, 0, 0, 0, 21, 0, 1, 22
"c:\Users\chris\source\repos\Cell\Cell\obj\Debug\net8.0-windows\Cell_1zsbmj1g_wpftmp.GlobalUsings.g.cs", "C#", 5, 0, 0, 0, 0, 1, 1, 7
"c:\Users\chris\source\repos\Cell\Cell\obj\Debug\net8.0-windows\Cell_1zsbmj1g_wpftmp.sourcelink.json", "JSON", 0, 0, 0, 1, 0, 0, 0, 1
"c:\Users\chris\source\repos\Cell\Cell\obj\Debug\net8.0-windows\Cell_21kbmysw_wpftmp.AssemblyInfo.cs", "C#", 11, 0, 0, 0, 0, 10, 5, 26
"c:\Users\chris\source\repos\Cell\Cell\obj\Debug\net8.0-windows\Cell_21kbmysw_wpftmp.GeneratedMSBuildEditorConfig.editorconfig", "Properties", 0, 0, 0, 0, 21, 0, 1, 22
"c:\Users\chris\source\repos\Cell\Cell\obj\Debug\net8.0-windows\Cell_21kbmysw_wpftmp.GlobalUsings.g.cs", "C#", 5, 0, 0, 0, 0, 1, 1, 7
"c:\Users\chris\source\repos\Cell\Cell\obj\Debug\net8.0-windows\Cell_21kbmysw_wpftmp.sourcelink.json", "JSON", 0, 0, 0, 1, 0, 0, 0, 1
"c:\Users\chris\source\repos\Cell\Cell\obj\Debug\net8.0-windows\Cell_22duo01n_wpftmp.AssemblyInfo.cs", "C#", 11, 0, 0, 0, 0, 10, 5, 26
"c:\Users\chris\source\repos\Cell\Cell\obj\Debug\net8.0-windows\Cell_22duo01n_wpftmp.GeneratedMSBuildEditorConfig.editorconfig", "Properties", 0, 0, 0, 0, 21, 0, 1, 22
"c:\Users\chris\source\repos\Cell\Cell\obj\Debug\net8.0-windows\Cell_22duo01n_wpftmp.GlobalUsings.g.cs", "C#", 5, 0, 0, 0, 0, 1, 1, 7
"c:\Users\chris\source\repos\Cell\Cell\obj\Debug\net8.0-windows\Cell_22duo01n_wpftmp.sourcelink.json", "JSON", 0, 0, 0, 1, 0, 0, 0, 1
"c:\Users\chris\source\repos\Cell\Cell\obj\Debug\net8.0-windows\Cell_22fxqs3j_wpftmp.AssemblyInfo.cs", "C#", 11, 0, 0, 0, 0, 10, 5, 26
"c:\Users\chris\source\repos\Cell\Cell\obj\Debug\net8.0-windows\Cell_22fxqs3j_wpftmp.GeneratedMSBuildEditorConfig.editorconfig", "Properties", 0, 0, 0, 0, 21, 0, 1, 22
"c:\Users\chris\source\repos\Cell\Cell\obj\Debug\net8.0-windows\Cell_22fxqs3j_wpftmp.GlobalUsings.g.cs", "C#", 5, 0, 0, 0, 0, 1, 1, 7
"c:\Users\chris\source\repos\Cell\Cell\obj\Debug\net8.0-windows\Cell_22fxqs3j_wpftmp.sourcelink.json", "JSON", 0, 0, 0, 1, 0, 0, 0, 1
"c:\Users\chris\source\repos\Cell\Cell\obj\Debug\net8.0-windows\Cell_232spmgl_wpftmp.AssemblyInfo.cs", "C#", 11, 0, 0, 0, 0, 10, 5, 26
"c:\Users\chris\source\repos\Cell\Cell\obj\Debug\net8.0-windows\Cell_232spmgl_wpftmp.GeneratedMSBuildEditorConfig.editorconfig", "Properties", 0, 0, 0, 0, 21, 0, 1, 22
"c:\Users\chris\source\repos\Cell\Cell\obj\Debug\net8.0-windows\Cell_232spmgl_wpftmp.GlobalUsings.g.cs", "C#", 5, 0, 0, 0, 0, 1, 1, 7
"c:\Users\chris\source\repos\Cell\Cell\obj\Debug\net8.0-windows\Cell_232spmgl_wpftmp.sourcelink.json", "JSON", 0, 0, 0, 1, 0, 0, 0, 1
"c:\Users\chris\source\repos\Cell\Cell\obj\Debug\net8.0-windows\Cell_23oijcuh_wpftmp.AssemblyInfo.cs", "C#", 11, 0, 0, 0, 0, 10, 5, 26
"c:\Users\chris\source\repos\Cell\Cell\obj\Debug\net8.0-windows\Cell_23oijcuh_wpftmp.GeneratedMSBuildEditorConfig.editorconfig", "Properties", 0, 0, 0, 0, 21, 0, 1, 22
"c:\Users\chris\source\repos\Cell\Cell\obj\Debug\net8.0-windows\Cell_23oijcuh_wpftmp.GlobalUsings.g.cs", "C#", 5, 0, 0, 0, 0, 1, 1, 7
"c:\Users\chris\source\repos\Cell\Cell\obj\Debug\net8.0-windows\Cell_23oijcuh_wpftmp.sourcelink.json", "JSON", 0, 0, 0, 1, 0, 0, 0, 1
"c:\Users\chris\source\repos\Cell\Cell\obj\Debug\net8.0-windows\Cell_25fbijeh_wpftmp.AssemblyInfo.cs", "C#", 11, 0, 0, 0, 0, 10, 5, 26
"c:\Users\chris\source\repos\Cell\Cell\obj\Debug\net8.0-windows\Cell_25fbijeh_wpftmp.GeneratedMSBuildEditorConfig.editorconfig", "Properties", 0, 0, 0, 0, 21, 0, 1, 22
"c:\Users\chris\source\repos\Cell\Cell\obj\Debug\net8.0-windows\Cell_25fbijeh_wpftmp.GlobalUsings.g.cs", "C#", 5, 0, 0, 0, 0, 1, 1, 7
"c:\Users\chris\source\repos\Cell\Cell\obj\Debug\net8.0-windows\Cell_25fbijeh_wpftmp.sourcelink.json", "JSON", 0, 0, 0, 1, 0, 0, 0, 1
"c:\Users\chris\source\repos\Cell\Cell\obj\Debug\net8.0-windows\Cell_2agvzzlx_wpftmp.AssemblyInfo.cs", "C#", 11, 0, 0, 0, 0, 10, 5, 26
"c:\Users\chris\source\repos\Cell\Cell\obj\Debug\net8.0-windows\Cell_2agvzzlx_wpftmp.GeneratedMSBuildEditorConfig.editorconfig", "Properties", 0, 0, 0, 0, 13, 0, 1, 14
"c:\Users\chris\source\repos\Cell\Cell\obj\Debug\net8.0-windows\Cell_2agvzzlx_wpftmp.GlobalUsings.g.cs", "C#", 5, 0, 0, 0, 0, 1, 1, 7
"c:\Users\chris\source\repos\Cell\Cell\obj\Debug\net8.0-windows\Cell_2apgvnhi_wpftmp.AssemblyInfo.cs", "C#", 11, 0, 0, 0, 0, 10, 5, 26
"c:\Users\chris\source\repos\Cell\Cell\obj\Debug\net8.0-windows\Cell_2apgvnhi_wpftmp.GeneratedMSBuildEditorConfig.editorconfig", "Properties", 0, 0, 0, 0, 21, 0, 1, 22
"c:\Users\chris\source\repos\Cell\Cell\obj\Debug\net8.0-windows\Cell_2apgvnhi_wpftmp.GlobalUsings.g.cs", "C#", 5, 0, 0, 0, 0, 1, 1, 7
"c:\Users\chris\source\repos\Cell\Cell\obj\Debug\net8.0-windows\Cell_2apgvnhi_wpftmp.sourcelink.json", "JSON", 0, 0, 0, 1, 0, 0, 0, 1
"c:\Users\chris\source\repos\Cell\Cell\obj\Debug\net8.0-windows\Cell_2ayqjzsy_wpftmp.AssemblyInfo.cs", "C#", 11, 0, 0, 0, 0, 10, 5, 26
"c:\Users\chris\source\repos\Cell\Cell\obj\Debug\net8.0-windows\Cell_2ayqjzsy_wpftmp.GeneratedMSBuildEditorConfig.editorconfig", "Properties", 0, 0, 0, 0, 21, 0, 1, 22
"c:\Users\chris\source\repos\Cell\Cell\obj\Debug\net8.0-windows\Cell_2ayqjzsy_wpftmp.GlobalUsings.g.cs", "C#", 5, 0, 0, 0, 0, 1, 1, 7
"c:\Users\chris\source\repos\Cell\Cell\obj\Debug\net8.0-windows\Cell_2ayqjzsy_wpftmp.sourcelink.json", "JSON", 0, 0, 0, 1, 0, 0, 0, 1
"c:\Users\chris\source\repos\Cell\Cell\obj\Debug\net8.0-windows\Cell_2b1fvgde_wpftmp.AssemblyInfo.cs", "C#", 11, 0, 0, 0, 0, 10, 5, 26
"c:\Users\chris\source\repos\Cell\Cell\obj\Debug\net8.0-windows\Cell_2b1fvgde_wpftmp.GeneratedMSBuildEditorConfig.editorconfig", "Properties", 0, 0, 0, 0, 21, 0, 1, 22
"c:\Users\chris\source\repos\Cell\Cell\obj\Debug\net8.0-windows\Cell_2b1fvgde_wpftmp.GlobalUsings.g.cs", "C#", 5, 0, 0, 0, 0, 1, 1, 7
"c:\Users\chris\source\repos\Cell\Cell\obj\Debug\net8.0-windows\Cell_2b1fvgde_wpftmp.sourcelink.json", "JSON", 0, 0, 0, 1, 0, 0, 0, 1
"c:\Users\chris\source\repos\Cell\Cell\obj\Debug\net8.0-windows\Cell_2cg0fnxk_wpftmp.AssemblyInfo.cs", "C#", 11, 0, 0, 0, 0, 10, 5, 26
"c:\Users\chris\source\repos\Cell\Cell\obj\Debug\net8.0-windows\Cell_2cg0fnxk_wpftmp.GeneratedMSBuildEditorConfig.editorconfig", "Properties", 0, 0, 0, 0, 13, 0, 1, 14
"c:\Users\chris\source\repos\Cell\Cell\obj\Debug\net8.0-windows\Cell_2cg0fnxk_wpftmp.GlobalUsings.g.cs", "C#", 5, 0, 0, 0, 0, 1, 1, 7
"c:\Users\chris\source\repos\Cell\Cell\obj\Debug\net8.0-windows\Cell_2chh2pub_wpftmp.AssemblyInfo.cs", "C#", 11, 0, 0, 0, 0, 10, 5, 26
"c:\Users\chris\source\repos\Cell\Cell\obj\Debug\net8.0-windows\Cell_2chh2pub_wpftmp.GeneratedMSBuildEditorConfig.editorconfig", "Properties", 0, 0, 0, 0, 21, 0, 1, 22
"c:\Users\chris\source\repos\Cell\Cell\obj\Debug\net8.0-windows\Cell_2chh2pub_wpftmp.GlobalUsings.g.cs", "C#", 5, 0, 0, 0, 0, 1, 1, 7
"c:\Users\chris\source\repos\Cell\Cell\obj\Debug\net8.0-windows\Cell_2chh2pub_wpftmp.sourcelink.json", "JSON", 0, 0, 0, 1, 0, 0, 0, 1
"c:\Users\chris\source\repos\Cell\Cell\obj\Debug\net8.0-windows\Cell_2ejjsntx_wpftmp.AssemblyInfo.cs", "C#", 11, 0, 0, 0, 0, 10, 5, 26
"c:\Users\chris\source\repos\Cell\Cell\obj\Debug\net8.0-windows\Cell_2ejjsntx_wpftmp.GeneratedMSBuildEditorConfig.editorconfig", "Properties", 0, 0, 0, 0, 21, 0, 1, 22
"c:\Users\chris\source\repos\Cell\Cell\obj\Debug\net8.0-windows\Cell_2ejjsntx_wpftmp.GlobalUsings.g.cs", "C#", 5, 0, 0, 0, 0, 1, 1, 7
"c:\Users\chris\source\repos\Cell\Cell\obj\Debug\net8.0-windows\Cell_2ejjsntx_wpftmp.sourcelink.json", "JSON", 0, 0, 0, 1, 0, 0, 0, 1
"c:\Users\chris\source\repos\Cell\Cell\obj\Debug\net8.0-windows\Cell_2faa10v4_wpftmp.AssemblyInfo.cs", "C#", 11, 0, 0, 0, 0, 10, 5, 26
"c:\Users\chris\source\repos\Cell\Cell\obj\Debug\net8.0-windows\Cell_2faa10v4_wpftmp.GeneratedMSBuildEditorConfig.editorconfig", "Properties", 0, 0, 0, 0, 21, 0, 1, 22
"c:\Users\chris\source\repos\Cell\Cell\obj\Debug\net8.0-windows\Cell_2faa10v4_wpftmp.GlobalUsings.g.cs", "C#", 5, 0, 0, 0, 0, 1, 1, 7
"c:\Users\chris\source\repos\Cell\Cell\obj\Debug\net8.0-windows\Cell_2faa10v4_wpftmp.sourcelink.json", "JSON", 0, 0, 0, 1, 0, 0, 0, 1
"c:\Users\chris\source\repos\Cell\Cell\obj\Debug\net8.0-windows\Cell_2fm05trk_wpftmp.AssemblyInfo.cs", "C#", 11, 0, 0, 0, 0, 10, 5, 26
"c:\Users\chris\source\repos\Cell\Cell\obj\Debug\net8.0-windows\Cell_2fm05trk_wpftmp.GeneratedMSBuildEditorConfig.editorconfig", "Properties", 0, 0, 0, 0, 21, 0, 1, 22
"c:\Users\chris\source\repos\Cell\Cell\obj\Debug\net8.0-windows\Cell_2fm05trk_wpftmp.GlobalUsings.g.cs", "C#", 5, 0, 0, 0, 0, 1, 1, 7
"c:\Users\chris\source\repos\Cell\Cell\obj\Debug\net8.0-windows\Cell_2fm05trk_wpftmp.sourcelink.json", "JSON", 0, 0, 0, 1, 0, 0, 0, 1
"c:\Users\chris\source\repos\Cell\Cell\obj\Debug\net8.0-windows\Cell_2g1imaoa_wpftmp.AssemblyInfo.cs", "C#", 11, 0, 0, 0, 0, 10, 5, 26
"c:\Users\chris\source\repos\Cell\Cell\obj\Debug\net8.0-windows\Cell_2g1imaoa_wpftmp.GeneratedMSBuildEditorConfig.editorconfig", "Properties", 0, 0, 0, 0, 21, 0, 1, 22
"c:\Users\chris\source\repos\Cell\Cell\obj\Debug\net8.0-windows\Cell_2g1imaoa_wpftmp.GlobalUsings.g.cs", "C#", 5, 0, 0, 0, 0, 1, 1, 7
"c:\Users\chris\source\repos\Cell\Cell\obj\Debug\net8.0-windows\Cell_2g1imaoa_wpftmp.sourcelink.json", "JSON", 0, 0, 0, 1, 0, 0, 0, 1
"c:\Users\chris\source\repos\Cell\Cell\obj\Debug\net8.0-windows\Cell_2gaspjmb_wpftmp.AssemblyInfo.cs", "C#", 11, 0, 0, 0, 0, 10, 5, 26
"c:\Users\chris\source\repos\Cell\Cell\obj\Debug\net8.0-windows\Cell_2gaspjmb_wpftmp.GeneratedMSBuildEditorConfig.editorconfig", "Properties", 0, 0, 0, 0, 13, 0, 1, 14
"c:\Users\chris\source\repos\Cell\Cell\obj\Debug\net8.0-windows\Cell_2gaspjmb_wpftmp.GlobalUsings.g.cs", "C#", 5, 0, 0, 0, 0, 1, 1, 7
"c:\Users\chris\source\repos\Cell\Cell\obj\Debug\net8.0-windows\Cell_2hos4ytq_wpftmp.AssemblyInfo.cs", "C#", 11, 0, 0, 0, 0, 10, 5, 26
"c:\Users\chris\source\repos\Cell\Cell\obj\Debug\net8.0-windows\Cell_2hos4ytq_wpftmp.GeneratedMSBuildEditorConfig.editorconfig", "Properties", 0, 0, 0, 0, 21, 0, 1, 22
"c:\Users\chris\source\repos\Cell\Cell\obj\Debug\net8.0-windows\Cell_2hos4ytq_wpftmp.GlobalUsings.g.cs", "C#", 5, 0, 0, 0, 0, 1, 1, 7
"c:\Users\chris\source\repos\Cell\Cell\obj\Debug\net8.0-windows\Cell_2hos4ytq_wpftmp.sourcelink.json", "JSON", 0, 0, 0, 1, 0, 0, 0, 1
"c:\Users\chris\source\repos\Cell\Cell\obj\Debug\net8.0-windows\Cell_2hynsyok_wpftmp.AssemblyInfo.cs", "C#", 11, 0, 0, 0, 0, 10, 5, 26
"c:\Users\chris\source\repos\Cell\Cell\obj\Debug\net8.0-windows\Cell_2hynsyok_wpftmp.GeneratedMSBuildEditorConfig.editorconfig", "Properties", 0, 0, 0, 0, 21, 0, 1, 22
"c:\Users\chris\source\repos\Cell\Cell\obj\Debug\net8.0-windows\Cell_2hynsyok_wpftmp.GlobalUsings.g.cs", "C#", 5, 0, 0, 0, 0, 1, 1, 7
"c:\Users\chris\source\repos\Cell\Cell\obj\Debug\net8.0-windows\Cell_2ialrskk_wpftmp.AssemblyInfo.cs", "C#", 11, 0, 0, 0, 0, 10, 5, 26
"c:\Users\chris\source\repos\Cell\Cell\obj\Debug\net8.0-windows\Cell_2ialrskk_wpftmp.GeneratedMSBuildEditorConfig.editorconfig", "Properties", 0, 0, 0, 0, 21, 0, 1, 22
"c:\Users\chris\source\repos\Cell\Cell\obj\Debug\net8.0-windows\Cell_2ialrskk_wpftmp.GlobalUsings.g.cs", "C#", 5, 0, 0, 0, 0, 1, 1, 7
"c:\Users\chris\source\repos\Cell\Cell\obj\Debug\net8.0-windows\Cell_2ialrskk_wpftmp.sourcelink.json", "JSON", 0, 0, 0, 1, 0, 0, 0, 1
"c:\Users\chris\source\repos\Cell\Cell\obj\Debug\net8.0-windows\Cell_2irlogvf_wpftmp.AssemblyInfo.cs", "C#", 11, 0, 0, 0, 0, 10, 5, 26
"c:\Users\chris\source\repos\Cell\Cell\obj\Debug\net8.0-windows\Cell_2irlogvf_wpftmp.GeneratedMSBuildEditorConfig.editorconfig", "Properties", 0, 0, 0, 0, 21, 0, 1, 22
"c:\Users\chris\source\repos\Cell\Cell\obj\Debug\net8.0-windows\Cell_2irlogvf_wpftmp.GlobalUsings.g.cs", "C#", 5, 0, 0, 0, 0, 1, 1, 7
"c:\Users\chris\source\repos\Cell\Cell\obj\Debug\net8.0-windows\Cell_2jegenpa_wpftmp.AssemblyInfo.cs", "C#", 11, 0, 0, 0, 0, 10, 5, 26
"c:\Users\chris\source\repos\Cell\Cell\obj\Debug\net8.0-windows\Cell_2jegenpa_wpftmp.GeneratedMSBuildEditorConfig.editorconfig", "Properties", 0, 0, 0, 0, 21, 0, 1, 22
"c:\Users\chris\source\repos\Cell\Cell\obj\Debug\net8.0-windows\Cell_2jegenpa_wpftmp.GlobalUsings.g.cs", "C#", 5, 0, 0, 0, 0, 1, 1, 7
"c:\Users\chris\source\repos\Cell\Cell\obj\Debug\net8.0-windows\Cell_2jegenpa_wpftmp.sourcelink.json", "JSON", 0, 0, 0, 1, 0, 0, 0, 1
"c:\Users\chris\source\repos\Cell\Cell\obj\Debug\net8.0-windows\Cell_2l4trqkp_wpftmp.AssemblyInfo.cs", "C#", 11, 0, 0, 0, 0, 10, 5, 26
"c:\Users\chris\source\repos\Cell\Cell\obj\Debug\net8.0-windows\Cell_2l4trqkp_wpftmp.GeneratedMSBuildEditorConfig.editorconfig", "Properties", 0, 0, 0, 0, 21, 0, 1, 22
"c:\Users\chris\source\repos\Cell\Cell\obj\Debug\net8.0-windows\Cell_2l4trqkp_wpftmp.GlobalUsings.g.cs", "C#", 5, 0, 0, 0, 0, 1, 1, 7
"c:\Users\chris\source\repos\Cell\Cell\obj\Debug\net8.0-windows\Cell_2l4trqkp_wpftmp.sourcelink.json", "JSON", 0, 0, 0, 1, 0, 0, 0, 1
"c:\Users\chris\source\repos\Cell\Cell\obj\Debug\net8.0-windows\Cell_2lxfcgap_wpftmp.AssemblyInfo.cs", "C#", 11, 0, 0, 0, 0, 10, 5, 26
"c:\Users\chris\source\repos\Cell\Cell\obj\Debug\net8.0-windows\Cell_2lxfcgap_wpftmp.GeneratedMSBuildEditorConfig.editorconfig", "Properties", 0, 0, 0, 0, 21, 0, 1, 22
"c:\Users\chris\source\repos\Cell\Cell\obj\Debug\net8.0-windows\Cell_2lxfcgap_wpftmp.GlobalUsings.g.cs", "C#", 5, 0, 0, 0, 0, 1, 1, 7
"c:\Users\chris\source\repos\Cell\Cell\obj\Debug\net8.0-windows\Cell_2lxfcgap_wpftmp.sourcelink.json", "JSON", 0, 0, 0, 1, 0, 0, 0, 1
"c:\Users\chris\source\repos\Cell\Cell\obj\Debug\net8.0-windows\Cell_2m11povb_wpftmp.AssemblyInfo.cs", "C#", 11, 0, 0, 0, 0, 10, 5, 26
"c:\Users\chris\source\repos\Cell\Cell\obj\Debug\net8.0-windows\Cell_2m11povb_wpftmp.GeneratedMSBuildEditorConfig.editorconfig", "Properties", 0, 0, 0, 0, 21, 0, 1, 22
"c:\Users\chris\source\repos\Cell\Cell\obj\Debug\net8.0-windows\Cell_2m11povb_wpftmp.GlobalUsings.g.cs", "C#", 5, 0, 0, 0, 0, 1, 1, 7
"c:\Users\chris\source\repos\Cell\Cell\obj\Debug\net8.0-windows\Cell_2m11povb_wpftmp.sourcelink.json", "JSON", 0, 0, 0, 1, 0, 0, 0, 1
"c:\Users\chris\source\repos\Cell\Cell\obj\Debug\net8.0-windows\Cell_2mlsqc0k_wpftmp.AssemblyInfo.cs", "C#", 11, 0, 0, 0, 0, 10, 5, 26
"c:\Users\chris\source\repos\Cell\Cell\obj\Debug\net8.0-windows\Cell_2mlsqc0k_wpftmp.GeneratedMSBuildEditorConfig.editorconfig", "Properties", 0, 0, 0, 0, 21, 0, 1, 22
"c:\Users\chris\source\repos\Cell\Cell\obj\Debug\net8.0-windows\Cell_2mlsqc0k_wpftmp.GlobalUsings.g.cs", "C#", 5, 0, 0, 0, 0, 1, 1, 7
"c:\Users\chris\source\repos\Cell\Cell\obj\Debug\net8.0-windows\Cell_2mlsqc0k_wpftmp.sourcelink.json", "JSON", 0, 0, 0, 1, 0, 0, 0, 1
"c:\Users\chris\source\repos\Cell\Cell\obj\Debug\net8.0-windows\Cell_2mx23alv_wpftmp.AssemblyInfo.cs", "C#", 11, 0, 0, 0, 0, 10, 5, 26
"c:\Users\chris\source\repos\Cell\Cell\obj\Debug\net8.0-windows\Cell_2mx23alv_wpftmp.GeneratedMSBuildEditorConfig.editorconfig", "Properties", 0, 0, 0, 0, 13, 0, 1, 14
"c:\Users\chris\source\repos\Cell\Cell\obj\Debug\net8.0-windows\Cell_2mx23alv_wpftmp.GlobalUsings.g.cs", "C#", 5, 0, 0, 0, 0, 1, 1, 7
"c:\Users\chris\source\repos\Cell\Cell\obj\Debug\net8.0-windows\Cell_2ncnqwn2_wpftmp.AssemblyInfo.cs", "C#", 11, 0, 0, 0, 0, 10, 5, 26
"c:\Users\chris\source\repos\Cell\Cell\obj\Debug\net8.0-windows\Cell_2ncnqwn2_wpftmp.GeneratedMSBuildEditorConfig.editorconfig", "Properties", 0, 0, 0, 0, 21, 0, 1, 22
"c:\Users\chris\source\repos\Cell\Cell\obj\Debug\net8.0-windows\Cell_2ncnqwn2_wpftmp.GlobalUsings.g.cs", "C#", 5, 0, 0, 0, 0, 1, 1, 7
"c:\Users\chris\source\repos\Cell\Cell\obj\Debug\net8.0-windows\Cell_2ncnqwn2_wpftmp.sourcelink.json", "JSON", 0, 0, 0, 1, 0, 0, 0, 1
"c:\Users\chris\source\repos\Cell\Cell\obj\Debug\net8.0-windows\Cell_2nolry3j_wpftmp.AssemblyInfo.cs", "C#", 11, 0, 0, 0, 0, 10, 5, 26
"c:\Users\chris\source\repos\Cell\Cell\obj\Debug\net8.0-windows\Cell_2nolry3j_wpftmp.GeneratedMSBuildEditorConfig.editorconfig", "Properties", 0, 0, 0, 0, 21, 0, 1, 22
"c:\Users\chris\source\repos\Cell\Cell\obj\Debug\net8.0-windows\Cell_2nolry3j_wpftmp.GlobalUsings.g.cs", "C#", 5, 0, 0, 0, 0, 1, 1, 7
"c:\Users\chris\source\repos\Cell\Cell\obj\Debug\net8.0-windows\Cell_2nolry3j_wpftmp.sourcelink.json", "JSON", 0, 0, 0, 1, 0, 0, 0, 1
"c:\Users\chris\source\repos\Cell\Cell\obj\Debug\net8.0-windows\Cell_2on3b3b1_wpftmp.AssemblyInfo.cs", "C#", 11, 0, 0, 0, 0, 10, 5, 26
"c:\Users\chris\source\repos\Cell\Cell\obj\Debug\net8.0-windows\Cell_2on3b3b1_wpftmp.GeneratedMSBuildEditorConfig.editorconfig", "Properties", 0, 0, 0, 0, 21, 0, 1, 22
"c:\Users\chris\source\repos\Cell\Cell\obj\Debug\net8.0-windows\Cell_2on3b3b1_wpftmp.GlobalUsings.g.cs", "C#", 5, 0, 0, 0, 0, 1, 1, 7
"c:\Users\chris\source\repos\Cell\Cell\obj\Debug\net8.0-windows\Cell_2on3b3b1_wpftmp.sourcelink.json", "JSON", 0, 0, 0, 1, 0, 0, 0, 1
"c:\Users\chris\source\repos\Cell\Cell\obj\Debug\net8.0-windows\Cell_2outgekp_wpftmp.AssemblyInfo.cs", "C#", 11, 0, 0, 0, 0, 10, 5, 26
"c:\Users\chris\source\repos\Cell\Cell\obj\Debug\net8.0-windows\Cell_2outgekp_wpftmp.GeneratedMSBuildEditorConfig.editorconfig", "Properties", 0, 0, 0, 0, 21, 0, 1, 22
"c:\Users\chris\source\repos\Cell\Cell\obj\Debug\net8.0-windows\Cell_2outgekp_wpftmp.GlobalUsings.g.cs", "C#", 5, 0, 0, 0, 0, 1, 1, 7
"c:\Users\chris\source\repos\Cell\Cell\obj\Debug\net8.0-windows\Cell_2outgekp_wpftmp.sourcelink.json", "JSON", 0, 0, 0, 1, 0, 0, 0, 1
"c:\Users\chris\source\repos\Cell\Cell\obj\Debug\net8.0-windows\Cell_2pgyevlu_wpftmp.AssemblyInfo.cs", "C#", 11, 0, 0, 0, 0, 10, 5, 26
"c:\Users\chris\source\repos\Cell\Cell\obj\Debug\net8.0-windows\Cell_2pgyevlu_wpftmp.GeneratedMSBuildEditorConfig.editorconfig", "Properties", 0, 0, 0, 0, 21, 0, 1, 22
"c:\Users\chris\source\repos\Cell\Cell\obj\Debug\net8.0-windows\Cell_2pgyevlu_wpftmp.GlobalUsings.g.cs", "C#", 5, 0, 0, 0, 0, 1, 1, 7
"c:\Users\chris\source\repos\Cell\Cell\obj\Debug\net8.0-windows\Cell_2pgyevlu_wpftmp.sourcelink.json", "JSON", 0, 0, 0, 1, 0, 0, 0, 1
"c:\Users\chris\source\repos\Cell\Cell\obj\Debug\net8.0-windows\Cell_2phmvj4y_wpftmp.AssemblyInfo.cs", "C#", 11, 0, 0, 0, 0, 10, 5, 26
"c:\Users\chris\source\repos\Cell\Cell\obj\Debug\net8.0-windows\Cell_2phmvj4y_wpftmp.GeneratedMSBuildEditorConfig.editorconfig", "Properties", 0, 0, 0, 0, 21, 0, 1, 22
"c:\Users\chris\source\repos\Cell\Cell\obj\Debug\net8.0-windows\Cell_2phmvj4y_wpftmp.GlobalUsings.g.cs", "C#", 5, 0, 0, 0, 0, 1, 1, 7
"c:\Users\chris\source\repos\Cell\Cell\obj\Debug\net8.0-windows\Cell_2phmvj4y_wpftmp.sourcelink.json", "JSON", 0, 0, 0, 1, 0, 0, 0, 1
"c:\Users\chris\source\repos\Cell\Cell\obj\Debug\net8.0-windows\Cell_2q1z54na_wpftmp.AssemblyInfo.cs", "C#", 11, 0, 0, 0, 0, 10, 5, 26
"c:\Users\chris\source\repos\Cell\Cell\obj\Debug\net8.0-windows\Cell_2q1z54na_wpftmp.GeneratedMSBuildEditorConfig.editorconfig", "Properties", 0, 0, 0, 0, 21, 0, 1, 22
"c:\Users\chris\source\repos\Cell\Cell\obj\Debug\net8.0-windows\Cell_2q1z54na_wpftmp.GlobalUsings.g.cs", "C#", 5, 0, 0, 0, 0, 1, 1, 7
"c:\Users\chris\source\repos\Cell\Cell\obj\Debug\net8.0-windows\Cell_2q1z54na_wpftmp.sourcelink.json", "JSON", 0, 0, 0, 1, 0, 0, 0, 1
"c:\Users\chris\source\repos\Cell\Cell\obj\Debug\net8.0-windows\Cell_2qyxlnnl_wpftmp.AssemblyInfo.cs", "C#", 11, 0, 0, 0, 0, 10, 5, 26
"c:\Users\chris\source\repos\Cell\Cell\obj\Debug\net8.0-windows\Cell_2qyxlnnl_wpftmp.GeneratedMSBuildEditorConfig.editorconfig", "Properties", 0, 0, 0, 0, 21, 0, 1, 22
"c:\Users\chris\source\repos\Cell\Cell\obj\Debug\net8.0-windows\Cell_2qyxlnnl_wpftmp.GlobalUsings.g.cs", "C#", 5, 0, 0, 0, 0, 1, 1, 7
"c:\Users\chris\source\repos\Cell\Cell\obj\Debug\net8.0-windows\Cell_2qyxlnnl_wpftmp.sourcelink.json", "JSON", 0, 0, 0, 1, 0, 0, 0, 1
"c:\Users\chris\source\repos\Cell\Cell\obj\Debug\net8.0-windows\Cell_2rykv4ow_wpftmp.AssemblyInfo.cs", "C#", 11, 0, 0, 0, 0, 10, 5, 26
"c:\Users\chris\source\repos\Cell\Cell\obj\Debug\net8.0-windows\Cell_2rykv4ow_wpftmp.GeneratedMSBuildEditorConfig.editorconfig", "Properties", 0, 0, 0, 0, 13, 0, 1, 14
"c:\Users\chris\source\repos\Cell\Cell\obj\Debug\net8.0-windows\Cell_2rykv4ow_wpftmp.GlobalUsings.g.cs", "C#", 5, 0, 0, 0, 0, 1, 1, 7
"c:\Users\chris\source\repos\Cell\Cell\obj\Debug\net8.0-windows\Cell_2si3ps15_wpftmp.AssemblyInfo.cs", "C#", 11, 0, 0, 0, 0, 10, 5, 26
"c:\Users\chris\source\repos\Cell\Cell\obj\Debug\net8.0-windows\Cell_2si3ps15_wpftmp.GeneratedMSBuildEditorConfig.editorconfig", "Properties", 0, 0, 0, 0, 21, 0, 1, 22
"c:\Users\chris\source\repos\Cell\Cell\obj\Debug\net8.0-windows\Cell_2si3ps15_wpftmp.GlobalUsings.g.cs", "C#", 5, 0, 0, 0, 0, 1, 1, 7
"c:\Users\chris\source\repos\Cell\Cell\obj\Debug\net8.0-windows\Cell_2si3ps15_wpftmp.sourcelink.json", "JSON", 0, 0, 0, 1, 0, 0, 0, 1
"c:\Users\chris\source\repos\Cell\Cell\obj\Debug\net8.0-windows\Cell_2t0ds1sd_wpftmp.AssemblyInfo.cs", "C#", 11, 0, 0, 0, 0, 10, 5, 26
"c:\Users\chris\source\repos\Cell\Cell\obj\Debug\net8.0-windows\Cell_2t0ds1sd_wpftmp.GeneratedMSBuildEditorConfig.editorconfig", "Properties", 0, 0, 0, 0, 21, 0, 1, 22
"c:\Users\chris\source\repos\Cell\Cell\obj\Debug\net8.0-windows\Cell_2t0ds1sd_wpftmp.GlobalUsings.g.cs", "C#", 5, 0, 0, 0, 0, 1, 1, 7
"c:\Users\chris\source\repos\Cell\Cell\obj\Debug\net8.0-windows\Cell_2t0ds1sd_wpftmp.sourcelink.json", "JSON", 0, 0, 0, 1, 0, 0, 0, 1
"c:\Users\chris\source\repos\Cell\Cell\obj\Debug\net8.0-windows\Cell_2txgl5nz_wpftmp.AssemblyInfo.cs", "C#", 11, 0, 0, 0, 0, 10, 5, 26
"c:\Users\chris\source\repos\Cell\Cell\obj\Debug\net8.0-windows\Cell_2txgl5nz_wpftmp.GeneratedMSBuildEditorConfig.editorconfig", "Properties", 0, 0, 0, 0, 21, 0, 1, 22
"c:\Users\chris\source\repos\Cell\Cell\obj\Debug\net8.0-windows\Cell_2txgl5nz_wpftmp.GlobalUsings.g.cs", "C#", 5, 0, 0, 0, 0, 1, 1, 7
"c:\Users\chris\source\repos\Cell\Cell\obj\Debug\net8.0-windows\Cell_2txgl5nz_wpftmp.sourcelink.json", "JSON", 0, 0, 0, 1, 0, 0, 0, 1
"c:\Users\chris\source\repos\Cell\Cell\obj\Debug\net8.0-windows\Cell_2uaiqxuk_wpftmp.AssemblyInfo.cs", "C#", 11, 0, 0, 0, 0, 10, 5, 26
"c:\Users\chris\source\repos\Cell\Cell\obj\Debug\net8.0-windows\Cell_2uaiqxuk_wpftmp.GeneratedMSBuildEditorConfig.editorconfig", "Properties", 0, 0, 0, 0, 21, 0, 1, 22
"c:\Users\chris\source\repos\Cell\Cell\obj\Debug\net8.0-windows\Cell_2uaiqxuk_wpftmp.GlobalUsings.g.cs", "C#", 5, 0, 0, 0, 0, 1, 1, 7
"c:\Users\chris\source\repos\Cell\Cell\obj\Debug\net8.0-windows\Cell_2uaiqxuk_wpftmp.sourcelink.json", "JSON", 0, 0, 0, 1, 0, 0, 0, 1
"c:\Users\chris\source\repos\Cell\Cell\obj\Debug\net8.0-windows\Cell_2ujw3wfh_wpftmp.AssemblyInfo.cs", "C#", 11, 0, 0, 0, 0, 10, 5, 26
"c:\Users\chris\source\repos\Cell\Cell\obj\Debug\net8.0-windows\Cell_2ujw3wfh_wpftmp.GeneratedMSBuildEditorConfig.editorconfig", "Properties", 0, 0, 0, 0, 13, 0, 1, 14
"c:\Users\chris\source\repos\Cell\Cell\obj\Debug\net8.0-windows\Cell_2ujw3wfh_wpftmp.GlobalUsings.g.cs", "C#", 5, 0, 0, 0, 0, 1, 1, 7
"c:\Users\chris\source\repos\Cell\Cell\obj\Debug\net8.0-windows\Cell_2umu0kkn_wpftmp.AssemblyInfo.cs", "C#", 11, 0, 0, 0, 0, 10, 5, 26
"c:\Users\chris\source\repos\Cell\Cell\obj\Debug\net8.0-windows\Cell_2umu0kkn_wpftmp.GeneratedMSBuildEditorConfig.editorconfig", "Properties", 0, 0, 0, 0, 21, 0, 1, 22
"c:\Users\chris\source\repos\Cell\Cell\obj\Debug\net8.0-windows\Cell_2umu0kkn_wpftmp.GlobalUsings.g.cs", "C#", 5, 0, 0, 0, 0, 1, 1, 7
"c:\Users\chris\source\repos\Cell\Cell\obj\Debug\net8.0-windows\Cell_2umu0kkn_wpftmp.sourcelink.json", "JSON", 0, 0, 0, 1, 0, 0, 0, 1
"c:\Users\chris\source\repos\Cell\Cell\obj\Debug\net8.0-windows\Cell_2vbwsgjg_wpftmp.AssemblyInfo.cs", "C#", 11, 0, 0, 0, 0, 10, 5, 26
"c:\Users\chris\source\repos\Cell\Cell\obj\Debug\net8.0-windows\Cell_2vbwsgjg_wpftmp.GeneratedMSBuildEditorConfig.editorconfig", "Properties", 0, 0, 0, 0, 21, 0, 1, 22
"c:\Users\chris\source\repos\Cell\Cell\obj\Debug\net8.0-windows\Cell_2vbwsgjg_wpftmp.GlobalUsings.g.cs", "C#", 5, 0, 0, 0, 0, 1, 1, 7
"c:\Users\chris\source\repos\Cell\Cell\obj\Debug\net8.0-windows\Cell_2vbwsgjg_wpftmp.sourcelink.json", "JSON", 0, 0, 0, 1, 0, 0, 0, 1
"c:\Users\chris\source\repos\Cell\Cell\obj\Debug\net8.0-windows\Cell_2wkzvkym_wpftmp.AssemblyInfo.cs", "C#", 11, 0, 0, 0, 0, 10, 5, 26
"c:\Users\chris\source\repos\Cell\Cell\obj\Debug\net8.0-windows\Cell_2wkzvkym_wpftmp.GeneratedMSBuildEditorConfig.editorconfig", "Properties", 0, 0, 0, 0, 21, 0, 1, 22
"c:\Users\chris\source\repos\Cell\Cell\obj\Debug\net8.0-windows\Cell_2wkzvkym_wpftmp.GlobalUsings.g.cs", "C#", 5, 0, 0, 0, 0, 1, 1, 7
"c:\Users\chris\source\repos\Cell\Cell\obj\Debug\net8.0-windows\Cell_2wkzvkym_wpftmp.sourcelink.json", "JSON", 0, 0, 0, 1, 0, 0, 0, 1
"c:\Users\chris\source\repos\Cell\Cell\obj\Debug\net8.0-windows\Cell_2woaco5f_wpftmp.AssemblyInfo.cs", "C#", 11, 0, 0, 0, 0, 10, 5, 26
"c:\Users\chris\source\repos\Cell\Cell\obj\Debug\net8.0-windows\Cell_2woaco5f_wpftmp.GeneratedMSBuildEditorConfig.editorconfig", "Properties", 0, 0, 0, 0, 21, 0, 1, 22
"c:\Users\chris\source\repos\Cell\Cell\obj\Debug\net8.0-windows\Cell_2woaco5f_wpftmp.GlobalUsings.g.cs", "C#", 5, 0, 0, 0, 0, 1, 1, 7
"c:\Users\chris\source\repos\Cell\Cell\obj\Debug\net8.0-windows\Cell_2woaco5f_wpftmp.sourcelink.json", "JSON", 0, 0, 0, 1, 0, 0, 0, 1
"c:\Users\chris\source\repos\Cell\Cell\obj\Debug\net8.0-windows\Cell_2wrhjhwo_wpftmp.AssemblyInfo.cs", "C#", 11, 0, 0, 0, 0, 10, 5, 26
"c:\Users\chris\source\repos\Cell\Cell\obj\Debug\net8.0-windows\Cell_2wrhjhwo_wpftmp.GeneratedMSBuildEditorConfig.editorconfig", "Properties", 0, 0, 0, 0, 21, 0, 1, 22
"c:\Users\chris\source\repos\Cell\Cell\obj\Debug\net8.0-windows\Cell_2wrhjhwo_wpftmp.GlobalUsings.g.cs", "C#", 5, 0, 0, 0, 0, 1, 1, 7
"c:\Users\chris\source\repos\Cell\Cell\obj\Debug\net8.0-windows\Cell_2wrhjhwo_wpftmp.sourcelink.json", "JSON", 0, 0, 0, 1, 0, 0, 0, 1
"c:\Users\chris\source\repos\Cell\Cell\obj\Debug\net8.0-windows\Cell_2wwavuj1_wpftmp.AssemblyInfo.cs", "C#", 11, 0, 0, 0, 0, 10, 5, 26
"c:\Users\chris\source\repos\Cell\Cell\obj\Debug\net8.0-windows\Cell_2wwavuj1_wpftmp.GeneratedMSBuildEditorConfig.editorconfig", "Properties", 0, 0, 0, 0, 21, 0, 1, 22
"c:\Users\chris\source\repos\Cell\Cell\obj\Debug\net8.0-windows\Cell_2wwavuj1_wpftmp.GlobalUsings.g.cs", "C#", 5, 0, 0, 0, 0, 1, 1, 7
"c:\Users\chris\source\repos\Cell\Cell\obj\Debug\net8.0-windows\Cell_2wwavuj1_wpftmp.sourcelink.json", "JSON", 0, 0, 0, 1, 0, 0, 0, 1
"c:\Users\chris\source\repos\Cell\Cell\obj\Debug\net8.0-windows\Cell_2ymv4gap_wpftmp.AssemblyInfo.cs", "C#", 11, 0, 0, 0, 0, 10, 5, 26
"c:\Users\chris\source\repos\Cell\Cell\obj\Debug\net8.0-windows\Cell_2ymv4gap_wpftmp.GeneratedMSBuildEditorConfig.editorconfig", "Properties", 0, 0, 0, 0, 21, 0, 1, 22
"c:\Users\chris\source\repos\Cell\Cell\obj\Debug\net8.0-windows\Cell_2ymv4gap_wpftmp.GlobalUsings.g.cs", "C#", 5, 0, 0, 0, 0, 1, 1, 7
"c:\Users\chris\source\repos\Cell\Cell\obj\Debug\net8.0-windows\Cell_2ymv4gap_wpftmp.sourcelink.json", "JSON", 0, 0, 0, 1, 0, 0, 0, 1
"c:\Users\chris\source\repos\Cell\Cell\obj\Debug\net8.0-windows\Cell_2yqmj2g4_wpftmp.AssemblyInfo.cs", "C#", 11, 0, 0, 0, 0, 10, 5, 26
"c:\Users\chris\source\repos\Cell\Cell\obj\Debug\net8.0-windows\Cell_2yqmj2g4_wpftmp.GeneratedMSBuildEditorConfig.editorconfig", "Properties", 0, 0, 0, 0, 21, 0, 1, 22
"c:\Users\chris\source\repos\Cell\Cell\obj\Debug\net8.0-windows\Cell_2yqmj2g4_wpftmp.GlobalUsings.g.cs", "C#", 5, 0, 0, 0, 0, 1, 1, 7
"c:\Users\chris\source\repos\Cell\Cell\obj\Debug\net8.0-windows\Cell_2yqmj2g4_wpftmp.sourcelink.json", "JSON", 0, 0, 0, 1, 0, 0, 0, 1
"c:\Users\chris\source\repos\Cell\Cell\obj\Debug\net8.0-windows\Cell_30g3ayqj_wpftmp.AssemblyInfo.cs", "C#", 11, 0, 0, 0, 0, 10, 5, 26
"c:\Users\chris\source\repos\Cell\Cell\obj\Debug\net8.0-windows\Cell_30g3ayqj_wpftmp.GeneratedMSBuildEditorConfig.editorconfig", "Properties", 0, 0, 0, 0, 21, 0, 1, 22
"c:\Users\chris\source\repos\Cell\Cell\obj\Debug\net8.0-windows\Cell_30g3ayqj_wpftmp.GlobalUsings.g.cs", "C#", 5, 0, 0, 0, 0, 1, 1, 7
"c:\Users\chris\source\repos\Cell\Cell\obj\Debug\net8.0-windows\Cell_30g3ayqj_wpftmp.sourcelink.json", "JSON", 0, 0, 0, 1, 0, 0, 0, 1
"c:\Users\chris\source\repos\Cell\Cell\obj\Debug\net8.0-windows\Cell_30lcaexh_wpftmp.AssemblyInfo.cs", "C#", 11, 0, 0, 0, 0, 10, 5, 26
"c:\Users\chris\source\repos\Cell\Cell\obj\Debug\net8.0-windows\Cell_30lcaexh_wpftmp.GeneratedMSBuildEditorConfig.editorconfig", "Properties", 0, 0, 0, 0, 21, 0, 1, 22
"c:\Users\chris\source\repos\Cell\Cell\obj\Debug\net8.0-windows\Cell_30lcaexh_wpftmp.GlobalUsings.g.cs", "C#", 5, 0, 0, 0, 0, 1, 1, 7
"c:\Users\chris\source\repos\Cell\Cell\obj\Debug\net8.0-windows\Cell_30lcaexh_wpftmp.sourcelink.json", "JSON", 0, 0, 0, 1, 0, 0, 0, 1
"c:\Users\chris\source\repos\Cell\Cell\obj\Debug\net8.0-windows\Cell_30vzbuux_wpftmp.AssemblyInfo.cs", "C#", 11, 0, 0, 0, 0, 10, 5, 26
"c:\Users\chris\source\repos\Cell\Cell\obj\Debug\net8.0-windows\Cell_30vzbuux_wpftmp.GeneratedMSBuildEditorConfig.editorconfig", "Properties", 0, 0, 0, 0, 21, 0, 1, 22
"c:\Users\chris\source\repos\Cell\Cell\obj\Debug\net8.0-windows\Cell_30vzbuux_wpftmp.GlobalUsings.g.cs", "C#", 5, 0, 0, 0, 0, 1, 1, 7
"c:\Users\chris\source\repos\Cell\Cell\obj\Debug\net8.0-windows\Cell_30vzbuux_wpftmp.sourcelink.json", "JSON", 0, 0, 0, 1, 0, 0, 0, 1
"c:\Users\chris\source\repos\Cell\Cell\obj\Debug\net8.0-windows\Cell_321hydov_wpftmp.AssemblyInfo.cs", "C#", 11, 0, 0, 0, 0, 10, 5, 26
"c:\Users\chris\source\repos\Cell\Cell\obj\Debug\net8.0-windows\Cell_321hydov_wpftmp.GeneratedMSBuildEditorConfig.editorconfig", "Properties", 0, 0, 0, 0, 13, 0, 1, 14
"c:\Users\chris\source\repos\Cell\Cell\obj\Debug\net8.0-windows\Cell_321hydov_wpftmp.GlobalUsings.g.cs", "C#", 5, 0, 0, 0, 0, 1, 1, 7
"c:\Users\chris\source\repos\Cell\Cell\obj\Debug\net8.0-windows\Cell_333lm312_wpftmp.AssemblyInfo.cs", "C#", 11, 0, 0, 0, 0, 10, 5, 26
"c:\Users\chris\source\repos\Cell\Cell\obj\Debug\net8.0-windows\Cell_333lm312_wpftmp.GeneratedMSBuildEditorConfig.editorconfig", "Properties", 0, 0, 0, 0, 21, 0, 1, 22
"c:\Users\chris\source\repos\Cell\Cell\obj\Debug\net8.0-windows\Cell_333lm312_wpftmp.GlobalUsings.g.cs", "C#", 5, 0, 0, 0, 0, 1, 1, 7
"c:\Users\chris\source\repos\Cell\Cell\obj\Debug\net8.0-windows\Cell_333lm312_wpftmp.sourcelink.json", "JSON", 0, 0, 0, 1, 0, 0, 0, 1
"c:\Users\chris\source\repos\Cell\Cell\obj\Debug\net8.0-windows\Cell_33gpireu_wpftmp.AssemblyInfo.cs", "C#", 11, 0, 0, 0, 0, 10, 5, 26
"c:\Users\chris\source\repos\Cell\Cell\obj\Debug\net8.0-windows\Cell_33gpireu_wpftmp.GeneratedMSBuildEditorConfig.editorconfig", "Properties", 0, 0, 0, 0, 21, 0, 1, 22
"c:\Users\chris\source\repos\Cell\Cell\obj\Debug\net8.0-windows\Cell_33gpireu_wpftmp.GlobalUsings.g.cs", "C#", 5, 0, 0, 0, 0, 1, 1, 7
"c:\Users\chris\source\repos\Cell\Cell\obj\Debug\net8.0-windows\Cell_33gpireu_wpftmp.sourcelink.json", "JSON", 0, 0, 0, 1, 0, 0, 0, 1
"c:\Users\chris\source\repos\Cell\Cell\obj\Debug\net8.0-windows\Cell_351hxxzf_wpftmp.AssemblyInfo.cs", "C#", 11, 0, 0, 0, 0, 10, 5, 26
"c:\Users\chris\source\repos\Cell\Cell\obj\Debug\net8.0-windows\Cell_351hxxzf_wpftmp.GeneratedMSBuildEditorConfig.editorconfig", "Properties", 0, 0, 0, 0, 13, 0, 1, 14
"c:\Users\chris\source\repos\Cell\Cell\obj\Debug\net8.0-windows\Cell_351hxxzf_wpftmp.GlobalUsings.g.cs", "C#", 5, 0, 0, 0, 0, 1, 1, 7
"c:\Users\chris\source\repos\Cell\Cell\obj\Debug\net8.0-windows\Cell_3diksbio_wpftmp.AssemblyInfo.cs", "C#", 11, 0, 0, 0, 0, 10, 5, 26
"c:\Users\chris\source\repos\Cell\Cell\obj\Debug\net8.0-windows\Cell_3diksbio_wpftmp.GeneratedMSBuildEditorConfig.editorconfig", "Properties", 0, 0, 0, 0, 21, 0, 1, 22
"c:\Users\chris\source\repos\Cell\Cell\obj\Debug\net8.0-windows\Cell_3diksbio_wpftmp.GlobalUsings.g.cs", "C#", 5, 0, 0, 0, 0, 1, 1, 7
"c:\Users\chris\source\repos\Cell\Cell\obj\Debug\net8.0-windows\Cell_3diksbio_wpftmp.sourcelink.json", "JSON", 0, 0, 0, 1, 0, 0, 0, 1
"c:\Users\chris\source\repos\Cell\Cell\obj\Debug\net8.0-windows\Cell_3dwsolo4_wpftmp.AssemblyInfo.cs", "C#", 11, 0, 0, 0, 0, 10, 5, 26
"c:\Users\chris\source\repos\Cell\Cell\obj\Debug\net8.0-windows\Cell_3dwsolo4_wpftmp.GeneratedMSBuildEditorConfig.editorconfig", "Properties", 0, 0, 0, 0, 21, 0, 1, 22
"c:\Users\chris\source\repos\Cell\Cell\obj\Debug\net8.0-windows\Cell_3dwsolo4_wpftmp.GlobalUsings.g.cs", "C#", 5, 0, 0, 0, 0, 1, 1, 7
"c:\Users\chris\source\repos\Cell\Cell\obj\Debug\net8.0-windows\Cell_3dwsolo4_wpftmp.sourcelink.json", "JSON", 0, 0, 0, 1, 0, 0, 0, 1
"c:\Users\chris\source\repos\Cell\Cell\obj\Debug\net8.0-windows\Cell_3f4lh1fr_wpftmp.AssemblyInfo.cs", "C#", 11, 0, 0, 0, 0, 10, 5, 26
"c:\Users\chris\source\repos\Cell\Cell\obj\Debug\net8.0-windows\Cell_3f4lh1fr_wpftmp.GeneratedMSBuildEditorConfig.editorconfig", "Properties", 0, 0, 0, 0, 21, 0, 1, 22
"c:\Users\chris\source\repos\Cell\Cell\obj\Debug\net8.0-windows\Cell_3f4lh1fr_wpftmp.GlobalUsings.g.cs", "C#", 5, 0, 0, 0, 0, 1, 1, 7
"c:\Users\chris\source\repos\Cell\Cell\obj\Debug\net8.0-windows\Cell_3f4lh1fr_wpftmp.sourcelink.json", "JSON", 0, 0, 0, 1, 0, 0, 0, 1
"c:\Users\chris\source\repos\Cell\Cell\obj\Debug\net8.0-windows\Cell_3fgg0rfa_wpftmp.AssemblyInfo.cs", "C#", 11, 0, 0, 0, 0, 10, 5, 26
"c:\Users\chris\source\repos\Cell\Cell\obj\Debug\net8.0-windows\Cell_3fgg0rfa_wpftmp.GeneratedMSBuildEditorConfig.editorconfig", "Properties", 0, 0, 0, 0, 21, 0, 1, 22
"c:\Users\chris\source\repos\Cell\Cell\obj\Debug\net8.0-windows\Cell_3fgg0rfa_wpftmp.GlobalUsings.g.cs", "C#", 5, 0, 0, 0, 0, 1, 1, 7
"c:\Users\chris\source\repos\Cell\Cell\obj\Debug\net8.0-windows\Cell_3fgg0rfa_wpftmp.sourcelink.json", "JSON", 0, 0, 0, 1, 0, 0, 0, 1
"c:\Users\chris\source\repos\Cell\Cell\obj\Debug\net8.0-windows\Cell_3fpyczfk_wpftmp.AssemblyInfo.cs", "C#", 11, 0, 0, 0, 0, 10, 5, 26
"c:\Users\chris\source\repos\Cell\Cell\obj\Debug\net8.0-windows\Cell_3fpyczfk_wpftmp.GeneratedMSBuildEditorConfig.editorconfig", "Properties", 0, 0, 0, 0, 21, 0, 1, 22
"c:\Users\chris\source\repos\Cell\Cell\obj\Debug\net8.0-windows\Cell_3fpyczfk_wpftmp.GlobalUsings.g.cs", "C#", 5, 0, 0, 0, 0, 1, 1, 7
"c:\Users\chris\source\repos\Cell\Cell\obj\Debug\net8.0-windows\Cell_3fpyczfk_wpftmp.sourcelink.json", "JSON", 0, 0, 0, 1, 0, 0, 0, 1
"c:\Users\chris\source\repos\Cell\Cell\obj\Debug\net8.0-windows\Cell_3fwouula_wpftmp.AssemblyInfo.cs", "C#", 11, 0, 0, 0, 0, 10, 5, 26
"c:\Users\chris\source\repos\Cell\Cell\obj\Debug\net8.0-windows\Cell_3fwouula_wpftmp.GeneratedMSBuildEditorConfig.editorconfig", "Properties", 0, 0, 0, 0, 21, 0, 1, 22
"c:\Users\chris\source\repos\Cell\Cell\obj\Debug\net8.0-windows\Cell_3fwouula_wpftmp.GlobalUsings.g.cs", "C#", 5, 0, 0, 0, 0, 1, 1, 7
"c:\Users\chris\source\repos\Cell\Cell\obj\Debug\net8.0-windows\Cell_3fwouula_wpftmp.sourcelink.json", "JSON", 0, 0, 0, 1, 0, 0, 0, 1
"c:\Users\chris\source\repos\Cell\Cell\obj\Debug\net8.0-windows\Cell_3h430tey_wpftmp.AssemblyInfo.cs", "C#", 11, 0, 0, 0, 0, 10, 5, 26
"c:\Users\chris\source\repos\Cell\Cell\obj\Debug\net8.0-windows\Cell_3h430tey_wpftmp.GeneratedMSBuildEditorConfig.editorconfig", "Properties", 0, 0, 0, 0, 21, 0, 1, 22
"c:\Users\chris\source\repos\Cell\Cell\obj\Debug\net8.0-windows\Cell_3h430tey_wpftmp.GlobalUsings.g.cs", "C#", 5, 0, 0, 0, 0, 1, 1, 7
"c:\Users\chris\source\repos\Cell\Cell\obj\Debug\net8.0-windows\Cell_3h430tey_wpftmp.sourcelink.json", "JSON", 0, 0, 0, 1, 0, 0, 0, 1
"c:\Users\chris\source\repos\Cell\Cell\obj\Debug\net8.0-windows\Cell_3ha5vu2r_wpftmp.AssemblyInfo.cs", "C#", 11, 0, 0, 0, 0, 10, 5, 26
"c:\Users\chris\source\repos\Cell\Cell\obj\Debug\net8.0-windows\Cell_3ha5vu2r_wpftmp.GeneratedMSBuildEditorConfig.editorconfig", "Properties", 0, 0, 0, 0, 21, 0, 1, 22
"c:\Users\chris\source\repos\Cell\Cell\obj\Debug\net8.0-windows\Cell_3ha5vu2r_wpftmp.GlobalUsings.g.cs", "C#", 5, 0, 0, 0, 0, 1, 1, 7
"c:\Users\chris\source\repos\Cell\Cell\obj\Debug\net8.0-windows\Cell_3ha5vu2r_wpftmp.sourcelink.json", "JSON", 0, 0, 0, 1, 0, 0, 0, 1
"c:\Users\chris\source\repos\Cell\Cell\obj\Debug\net8.0-windows\Cell_3hbkwroj_wpftmp.AssemblyInfo.cs", "C#", 11, 0, 0, 0, 0, 10, 5, 26
"c:\Users\chris\source\repos\Cell\Cell\obj\Debug\net8.0-windows\Cell_3hbkwroj_wpftmp.GeneratedMSBuildEditorConfig.editorconfig", "Properties", 0, 0, 0, 0, 21, 0, 1, 22
"c:\Users\chris\source\repos\Cell\Cell\obj\Debug\net8.0-windows\Cell_3hbkwroj_wpftmp.GlobalUsings.g.cs", "C#", 5, 0, 0, 0, 0, 1, 1, 7
"c:\Users\chris\source\repos\Cell\Cell\obj\Debug\net8.0-windows\Cell_3hbkwroj_wpftmp.sourcelink.json", "JSON", 0, 0, 0, 1, 0, 0, 0, 1
"c:\Users\chris\source\repos\Cell\Cell\obj\Debug\net8.0-windows\Cell_3hngjbla_wpftmp.AssemblyInfo.cs", "C#", 11, 0, 0, 0, 0, 10, 5, 26
"c:\Users\chris\source\repos\Cell\Cell\obj\Debug\net8.0-windows\Cell_3hngjbla_wpftmp.GeneratedMSBuildEditorConfig.editorconfig", "Properties", 0, 0, 0, 0, 21, 0, 1, 22
"c:\Users\chris\source\repos\Cell\Cell\obj\Debug\net8.0-windows\Cell_3hngjbla_wpftmp.GlobalUsings.g.cs", "C#", 5, 0, 0, 0, 0, 1, 1, 7
"c:\Users\chris\source\repos\Cell\Cell\obj\Debug\net8.0-windows\Cell_3hngjbla_wpftmp.sourcelink.json", "JSON", 0, 0, 0, 1, 0, 0, 0, 1
"c:\Users\chris\source\repos\Cell\Cell\obj\Debug\net8.0-windows\Cell_3i11ld3d_wpftmp.AssemblyInfo.cs", "C#", 11, 0, 0, 0, 0, 10, 5, 26
"c:\Users\chris\source\repos\Cell\Cell\obj\Debug\net8.0-windows\Cell_3i11ld3d_wpftmp.GeneratedMSBuildEditorConfig.editorconfig", "Properties", 0, 0, 0, 0, 21, 0, 1, 22
"c:\Users\chris\source\repos\Cell\Cell\obj\Debug\net8.0-windows\Cell_3i11ld3d_wpftmp.GlobalUsings.g.cs", "C#", 5, 0, 0, 0, 0, 1, 1, 7
"c:\Users\chris\source\repos\Cell\Cell\obj\Debug\net8.0-windows\Cell_3i11ld3d_wpftmp.sourcelink.json", "JSON", 0, 0, 0, 1, 0, 0, 0, 1
"c:\Users\chris\source\repos\Cell\Cell\obj\Debug\net8.0-windows\Cell_3l0aoo2t_wpftmp.AssemblyInfo.cs", "C#", 11, 0, 0, 0, 0, 10, 5, 26
"c:\Users\chris\source\repos\Cell\Cell\obj\Debug\net8.0-windows\Cell_3l0aoo2t_wpftmp.GeneratedMSBuildEditorConfig.editorconfig", "Properties", 0, 0, 0, 0, 21, 0, 1, 22
"c:\Users\chris\source\repos\Cell\Cell\obj\Debug\net8.0-windows\Cell_3l0aoo2t_wpftmp.GlobalUsings.g.cs", "C#", 5, 0, 0, 0, 0, 1, 1, 7
"c:\Users\chris\source\repos\Cell\Cell\obj\Debug\net8.0-windows\Cell_3l0aoo2t_wpftmp.sourcelink.json", "JSON", 0, 0, 0, 1, 0, 0, 0, 1
"c:\Users\chris\source\repos\Cell\Cell\obj\Debug\net8.0-windows\Cell_3lj0wbnx_wpftmp.AssemblyInfo.cs", "C#", 11, 0, 0, 0, 0, 10, 5, 26
"c:\Users\chris\source\repos\Cell\Cell\obj\Debug\net8.0-windows\Cell_3lj0wbnx_wpftmp.GeneratedMSBuildEditorConfig.editorconfig", "Properties", 0, 0, 0, 0, 13, 0, 1, 14
"c:\Users\chris\source\repos\Cell\Cell\obj\Debug\net8.0-windows\Cell_3lj0wbnx_wpftmp.GlobalUsings.g.cs", "C#", 5, 0, 0, 0, 0, 1, 1, 7
"c:\Users\chris\source\repos\Cell\Cell\obj\Debug\net8.0-windows\Cell_3mybwzu2_wpftmp.AssemblyInfo.cs", "C#", 11, 0, 0, 0, 0, 10, 5, 26
"c:\Users\chris\source\repos\Cell\Cell\obj\Debug\net8.0-windows\Cell_3mybwzu2_wpftmp.GeneratedMSBuildEditorConfig.editorconfig", "Properties", 0, 0, 0, 0, 21, 0, 1, 22
"c:\Users\chris\source\repos\Cell\Cell\obj\Debug\net8.0-windows\Cell_3mybwzu2_wpftmp.GlobalUsings.g.cs", "C#", 5, 0, 0, 0, 0, 1, 1, 7
"c:\Users\chris\source\repos\Cell\Cell\obj\Debug\net8.0-windows\Cell_3mybwzu2_wpftmp.sourcelink.json", "JSON", 0, 0, 0, 1, 0, 0, 0, 1
"c:\Users\chris\source\repos\Cell\Cell\obj\Debug\net8.0-windows\Cell_3n1525qw_wpftmp.AssemblyInfo.cs", "C#", 11, 0, 0, 0, 0, 10, 5, 26
"c:\Users\chris\source\repos\Cell\Cell\obj\Debug\net8.0-windows\Cell_3n1525qw_wpftmp.GeneratedMSBuildEditorConfig.editorconfig", "Properties", 0, 0, 0, 0, 13, 0, 1, 14
"c:\Users\chris\source\repos\Cell\Cell\obj\Debug\net8.0-windows\Cell_3n1525qw_wpftmp.GlobalUsings.g.cs", "C#", 5, 0, 0, 0, 0, 1, 1, 7
"c:\Users\chris\source\repos\Cell\Cell\obj\Debug\net8.0-windows\Cell_3n5mh30g_wpftmp.AssemblyInfo.cs", "C#", 11, 0, 0, 0, 0, 10, 5, 26
"c:\Users\chris\source\repos\Cell\Cell\obj\Debug\net8.0-windows\Cell_3n5mh30g_wpftmp.GeneratedMSBuildEditorConfig.editorconfig", "Properties", 0, 0, 0, 0, 13, 0, 1, 14
"c:\Users\chris\source\repos\Cell\Cell\obj\Debug\net8.0-windows\Cell_3n5mh30g_wpftmp.GlobalUsings.g.cs", "C#", 5, 0, 0, 0, 0, 1, 1, 7
"c:\Users\chris\source\repos\Cell\Cell\obj\Debug\net8.0-windows\Cell_3nd1i5xe_wpftmp.AssemblyInfo.cs", "C#", 11, 0, 0, 0, 0, 10, 5, 26
"c:\Users\chris\source\repos\Cell\Cell\obj\Debug\net8.0-windows\Cell_3nd1i5xe_wpftmp.GeneratedMSBuildEditorConfig.editorconfig", "Properties", 0, 0, 0, 0, 21, 0, 1, 22
"c:\Users\chris\source\repos\Cell\Cell\obj\Debug\net8.0-windows\Cell_3nd1i5xe_wpftmp.GlobalUsings.g.cs", "C#", 5, 0, 0, 0, 0, 1, 1, 7
"c:\Users\chris\source\repos\Cell\Cell\obj\Debug\net8.0-windows\Cell_3nd1i5xe_wpftmp.sourcelink.json", "JSON", 0, 0, 0, 1, 0, 0, 0, 1
"c:\Users\chris\source\repos\Cell\Cell\obj\Debug\net8.0-windows\Cell_3qiopowo_wpftmp.AssemblyInfo.cs", "C#", 11, 0, 0, 0, 0, 10, 5, 26
"c:\Users\chris\source\repos\Cell\Cell\obj\Debug\net8.0-windows\Cell_3qiopowo_wpftmp.GeneratedMSBuildEditorConfig.editorconfig", "Properties", 0, 0, 0, 0, 21, 0, 1, 22
"c:\Users\chris\source\repos\Cell\Cell\obj\Debug\net8.0-windows\Cell_3qiopowo_wpftmp.GlobalUsings.g.cs", "C#", 5, 0, 0, 0, 0, 1, 1, 7
"c:\Users\chris\source\repos\Cell\Cell\obj\Debug\net8.0-windows\Cell_3qiopowo_wpftmp.sourcelink.json", "JSON", 0, 0, 0, 1, 0, 0, 0, 1
"c:\Users\chris\source\repos\Cell\Cell\obj\Debug\net8.0-windows\Cell_3qst4lme_wpftmp.AssemblyInfo.cs", "C#", 11, 0, 0, 0, 0, 10, 5, 26
"c:\Users\chris\source\repos\Cell\Cell\obj\Debug\net8.0-windows\Cell_3qst4lme_wpftmp.GeneratedMSBuildEditorConfig.editorconfig", "Properties", 0, 0, 0, 0, 21, 0, 1, 22
"c:\Users\chris\source\repos\Cell\Cell\obj\Debug\net8.0-windows\Cell_3qst4lme_wpftmp.GlobalUsings.g.cs", "C#", 5, 0, 0, 0, 0, 1, 1, 7
"c:\Users\chris\source\repos\Cell\Cell\obj\Debug\net8.0-windows\Cell_3qst4lme_wpftmp.sourcelink.json", "JSON", 0, 0, 0, 1, 0, 0, 0, 1
"c:\Users\chris\source\repos\Cell\Cell\obj\Debug\net8.0-windows\Cell_3qupz4vh_wpftmp.AssemblyInfo.cs", "C#", 11, 0, 0, 0, 0, 10, 5, 26
"c:\Users\chris\source\repos\Cell\Cell\obj\Debug\net8.0-windows\Cell_3qupz4vh_wpftmp.GeneratedMSBuildEditorConfig.editorconfig", "Properties", 0, 0, 0, 0, 21, 0, 1, 22
"c:\Users\chris\source\repos\Cell\Cell\obj\Debug\net8.0-windows\Cell_3qupz4vh_wpftmp.GlobalUsings.g.cs", "C#", 5, 0, 0, 0, 0, 1, 1, 7
"c:\Users\chris\source\repos\Cell\Cell\obj\Debug\net8.0-windows\Cell_3qupz4vh_wpftmp.sourcelink.json", "JSON", 0, 0, 0, 1, 0, 0, 0, 1
"c:\Users\chris\source\repos\Cell\Cell\obj\Debug\net8.0-windows\Cell_3qxbeww5_wpftmp.AssemblyInfo.cs", "C#", 11, 0, 0, 0, 0, 10, 5, 26
"c:\Users\chris\source\repos\Cell\Cell\obj\Debug\net8.0-windows\Cell_3qxbeww5_wpftmp.GeneratedMSBuildEditorConfig.editorconfig", "Properties", 0, 0, 0, 0, 21, 0, 1, 22
"c:\Users\chris\source\repos\Cell\Cell\obj\Debug\net8.0-windows\Cell_3qxbeww5_wpftmp.GlobalUsings.g.cs", "C#", 5, 0, 0, 0, 0, 1, 1, 7
"c:\Users\chris\source\repos\Cell\Cell\obj\Debug\net8.0-windows\Cell_3qxbeww5_wpftmp.sourcelink.json", "JSON", 0, 0, 0, 1, 0, 0, 0, 1
"c:\Users\chris\source\repos\Cell\Cell\obj\Debug\net8.0-windows\Cell_3qxkr00t_wpftmp.AssemblyInfo.cs", "C#", 11, 0, 0, 0, 0, 10, 5, 26
"c:\Users\chris\source\repos\Cell\Cell\obj\Debug\net8.0-windows\Cell_3qxkr00t_wpftmp.GeneratedMSBuildEditorConfig.editorconfig", "Properties", 0, 0, 0, 0, 21, 0, 1, 22
"c:\Users\chris\source\repos\Cell\Cell\obj\Debug\net8.0-windows\Cell_3qxkr00t_wpftmp.GlobalUsings.g.cs", "C#", 5, 0, 0, 0, 0, 1, 1, 7
"c:\Users\chris\source\repos\Cell\Cell\obj\Debug\net8.0-windows\Cell_3qxkr00t_wpftmp.sourcelink.json", "JSON", 0, 0, 0, 1, 0, 0, 0, 1
"c:\Users\chris\source\repos\Cell\Cell\obj\Debug\net8.0-windows\Cell_3r5ju0rr_wpftmp.AssemblyInfo.cs", "C#", 11, 0, 0, 0, 0, 10, 5, 26
"c:\Users\chris\source\repos\Cell\Cell\obj\Debug\net8.0-windows\Cell_3r5ju0rr_wpftmp.GeneratedMSBuildEditorConfig.editorconfig", "Properties", 0, 0, 0, 0, 13, 0, 1, 14
"c:\Users\chris\source\repos\Cell\Cell\obj\Debug\net8.0-windows\Cell_3r5ju0rr_wpftmp.GlobalUsings.g.cs", "C#", 5, 0, 0, 0, 0, 1, 1, 7
"c:\Users\chris\source\repos\Cell\Cell\obj\Debug\net8.0-windows\Cell_3rzed3z2_wpftmp.AssemblyInfo.cs", "C#", 11, 0, 0, 0, 0, 10, 5, 26
"c:\Users\chris\source\repos\Cell\Cell\obj\Debug\net8.0-windows\Cell_3rzed3z2_wpftmp.GeneratedMSBuildEditorConfig.editorconfig", "Properties", 0, 0, 0, 0, 21, 0, 1, 22
"c:\Users\chris\source\repos\Cell\Cell\obj\Debug\net8.0-windows\Cell_3rzed3z2_wpftmp.GlobalUsings.g.cs", "C#", 5, 0, 0, 0, 0, 1, 1, 7
"c:\Users\chris\source\repos\Cell\Cell\obj\Debug\net8.0-windows\Cell_3rzed3z2_wpftmp.sourcelink.json", "JSON", 0, 0, 0, 1, 0, 0, 0, 1
"c:\Users\chris\source\repos\Cell\Cell\obj\Debug\net8.0-windows\Cell_3s1o2odr_wpftmp.AssemblyInfo.cs", "C#", 11, 0, 0, 0, 0, 10, 5, 26
"c:\Users\chris\source\repos\Cell\Cell\obj\Debug\net8.0-windows\Cell_3s1o2odr_wpftmp.GeneratedMSBuildEditorConfig.editorconfig", "Properties", 0, 0, 0, 0, 21, 0, 1, 22
"c:\Users\chris\source\repos\Cell\Cell\obj\Debug\net8.0-windows\Cell_3s1o2odr_wpftmp.GlobalUsings.g.cs", "C#", 5, 0, 0, 0, 0, 1, 1, 7
"c:\Users\chris\source\repos\Cell\Cell\obj\Debug\net8.0-windows\Cell_3s1o2odr_wpftmp.sourcelink.json", "JSON", 0, 0, 0, 1, 0, 0, 0, 1
"c:\Users\chris\source\repos\Cell\Cell\obj\Debug\net8.0-windows\Cell_3s4akmuf_wpftmp.AssemblyInfo.cs", "C#", 11, 0, 0, 0, 0, 10, 5, 26
"c:\Users\chris\source\repos\Cell\Cell\obj\Debug\net8.0-windows\Cell_3s4akmuf_wpftmp.GeneratedMSBuildEditorConfig.editorconfig", "Properties", 0, 0, 0, 0, 13, 0, 1, 14
"c:\Users\chris\source\repos\Cell\Cell\obj\Debug\net8.0-windows\Cell_3s4akmuf_wpftmp.GlobalUsings.g.cs", "C#", 5, 0, 0, 0, 0, 1, 1, 7
"c:\Users\chris\source\repos\Cell\Cell\obj\Debug\net8.0-windows\Cell_3slbex30_wpftmp.AssemblyInfo.cs", "C#", 11, 0, 0, 0, 0, 10, 5, 26
"c:\Users\chris\source\repos\Cell\Cell\obj\Debug\net8.0-windows\Cell_3slbex30_wpftmp.GeneratedMSBuildEditorConfig.editorconfig", "Properties", 0, 0, 0, 0, 21, 0, 1, 22
"c:\Users\chris\source\repos\Cell\Cell\obj\Debug\net8.0-windows\Cell_3slbex30_wpftmp.GlobalUsings.g.cs", "C#", 5, 0, 0, 0, 0, 1, 1, 7
"c:\Users\chris\source\repos\Cell\Cell\obj\Debug\net8.0-windows\Cell_3slbex30_wpftmp.sourcelink.json", "JSON", 0, 0, 0, 1, 0, 0, 0, 1
"c:\Users\chris\source\repos\Cell\Cell\obj\Debug\net8.0-windows\Cell_3tomlxao_wpftmp.AssemblyInfo.cs", "C#", 11, 0, 0, 0, 0, 10, 5, 26
"c:\Users\chris\source\repos\Cell\Cell\obj\Debug\net8.0-windows\Cell_3tomlxao_wpftmp.GeneratedMSBuildEditorConfig.editorconfig", "Properties", 0, 0, 0, 0, 21, 0, 1, 22
"c:\Users\chris\source\repos\Cell\Cell\obj\Debug\net8.0-windows\Cell_3tomlxao_wpftmp.GlobalUsings.g.cs", "C#", 5, 0, 0, 0, 0, 1, 1, 7
"c:\Users\chris\source\repos\Cell\Cell\obj\Debug\net8.0-windows\Cell_3tomlxao_wpftmp.sourcelink.json", "JSON", 0, 0, 0, 1, 0, 0, 0, 1
"c:\Users\chris\source\repos\Cell\Cell\obj\Debug\net8.0-windows\Cell_3vi1ynzw_wpftmp.AssemblyInfo.cs", "C#", 11, 0, 0, 0, 0, 10, 5, 26
"c:\Users\chris\source\repos\Cell\Cell\obj\Debug\net8.0-windows\Cell_3vi1ynzw_wpftmp.GeneratedMSBuildEditorConfig.editorconfig", "Properties", 0, 0, 0, 0, 21, 0, 1, 22
"c:\Users\chris\source\repos\Cell\Cell\obj\Debug\net8.0-windows\Cell_3vi1ynzw_wpftmp.GlobalUsings.g.cs", "C#", 5, 0, 0, 0, 0, 1, 1, 7
"c:\Users\chris\source\repos\Cell\Cell\obj\Debug\net8.0-windows\Cell_3vi1ynzw_wpftmp.sourcelink.json", "JSON", 0, 0, 0, 1, 0, 0, 0, 1
"c:\Users\chris\source\repos\Cell\Cell\obj\Debug\net8.0-windows\Cell_3wr0nl1g_wpftmp.AssemblyInfo.cs", "C#", 11, 0, 0, 0, 0, 10, 5, 26
"c:\Users\chris\source\repos\Cell\Cell\obj\Debug\net8.0-windows\Cell_3wr0nl1g_wpftmp.GeneratedMSBuildEditorConfig.editorconfig", "Properties", 0, 0, 0, 0, 21, 0, 1, 22
"c:\Users\chris\source\repos\Cell\Cell\obj\Debug\net8.0-windows\Cell_3wr0nl1g_wpftmp.GlobalUsings.g.cs", "C#", 5, 0, 0, 0, 0, 1, 1, 7
"c:\Users\chris\source\repos\Cell\Cell\obj\Debug\net8.0-windows\Cell_3wr0nl1g_wpftmp.sourcelink.json", "JSON", 0, 0, 0, 1, 0, 0, 0, 1
"c:\Users\chris\source\repos\Cell\Cell\obj\Debug\net8.0-windows\Cell_3xmrj5s2_wpftmp.AssemblyInfo.cs", "C#", 11, 0, 0, 0, 0, 10, 5, 26
"c:\Users\chris\source\repos\Cell\Cell\obj\Debug\net8.0-windows\Cell_3xmrj5s2_wpftmp.GeneratedMSBuildEditorConfig.editorconfig", "Properties", 0, 0, 0, 0, 21, 0, 1, 22
"c:\Users\chris\source\repos\Cell\Cell\obj\Debug\net8.0-windows\Cell_3xmrj5s2_wpftmp.GlobalUsings.g.cs", "C#", 5, 0, 0, 0, 0, 1, 1, 7
"c:\Users\chris\source\repos\Cell\Cell\obj\Debug\net8.0-windows\Cell_3xmrj5s2_wpftmp.sourcelink.json", "JSON", 0, 0, 0, 1, 0, 0, 0, 1
"c:\Users\chris\source\repos\Cell\Cell\obj\Debug\net8.0-windows\Cell_3ygp0mfu_wpftmp.AssemblyInfo.cs", "C#", 11, 0, 0, 0, 0, 10, 5, 26
"c:\Users\chris\source\repos\Cell\Cell\obj\Debug\net8.0-windows\Cell_3ygp0mfu_wpftmp.GeneratedMSBuildEditorConfig.editorconfig", "Properties", 0, 0, 0, 0, 21, 0, 1, 22
"c:\Users\chris\source\repos\Cell\Cell\obj\Debug\net8.0-windows\Cell_3ygp0mfu_wpftmp.GlobalUsings.g.cs", "C#", 5, 0, 0, 0, 0, 1, 1, 7
"c:\Users\chris\source\repos\Cell\Cell\obj\Debug\net8.0-windows\Cell_3ygp0mfu_wpftmp.sourcelink.json", "JSON", 0, 0, 0, 1, 0, 0, 0, 1
"c:\Users\chris\source\repos\Cell\Cell\obj\Debug\net8.0-windows\Cell_3zu40qvu_wpftmp.AssemblyInfo.cs", "C#", 11, 0, 0, 0, 0, 10, 5, 26
"c:\Users\chris\source\repos\Cell\Cell\obj\Debug\net8.0-windows\Cell_3zu40qvu_wpftmp.GeneratedMSBuildEditorConfig.editorconfig", "Properties", 0, 0, 0, 0, 21, 0, 1, 22
"c:\Users\chris\source\repos\Cell\Cell\obj\Debug\net8.0-windows\Cell_3zu40qvu_wpftmp.GlobalUsings.g.cs", "C#", 5, 0, 0, 0, 0, 1, 1, 7
"c:\Users\chris\source\repos\Cell\Cell\obj\Debug\net8.0-windows\Cell_3zu40qvu_wpftmp.sourcelink.json", "JSON", 0, 0, 0, 1, 0, 0, 0, 1
"c:\Users\chris\source\repos\Cell\Cell\obj\Debug\net8.0-windows\Cell_40k3pmxu_wpftmp.AssemblyInfo.cs", "C#", 11, 0, 0, 0, 0, 10, 5, 26
"c:\Users\chris\source\repos\Cell\Cell\obj\Debug\net8.0-windows\Cell_40k3pmxu_wpftmp.GeneratedMSBuildEditorConfig.editorconfig", "Properties", 0, 0, 0, 0, 21, 0, 1, 22
"c:\Users\chris\source\repos\Cell\Cell\obj\Debug\net8.0-windows\Cell_40k3pmxu_wpftmp.GlobalUsings.g.cs", "C#", 5, 0, 0, 0, 0, 1, 1, 7
"c:\Users\chris\source\repos\Cell\Cell\obj\Debug\net8.0-windows\Cell_40k3pmxu_wpftmp.sourcelink.json", "JSON", 0, 0, 0, 1, 0, 0, 0, 1
"c:\Users\chris\source\repos\Cell\Cell\obj\Debug\net8.0-windows\Cell_41fvamum_wpftmp.AssemblyInfo.cs", "C#", 11, 0, 0, 0, 0, 10, 5, 26
"c:\Users\chris\source\repos\Cell\Cell\obj\Debug\net8.0-windows\Cell_41fvamum_wpftmp.GeneratedMSBuildEditorConfig.editorconfig", "Properties", 0, 0, 0, 0, 21, 0, 1, 22
"c:\Users\chris\source\repos\Cell\Cell\obj\Debug\net8.0-windows\Cell_41fvamum_wpftmp.GlobalUsings.g.cs", "C#", 5, 0, 0, 0, 0, 1, 1, 7
"c:\Users\chris\source\repos\Cell\Cell\obj\Debug\net8.0-windows\Cell_41fvamum_wpftmp.sourcelink.json", "JSON", 0, 0, 0, 1, 0, 0, 0, 1
"c:\Users\chris\source\repos\Cell\Cell\obj\Debug\net8.0-windows\Cell_45mtqd5l_wpftmp.AssemblyInfo.cs", "C#", 11, 0, 0, 0, 0, 10, 5, 26
"c:\Users\chris\source\repos\Cell\Cell\obj\Debug\net8.0-windows\Cell_45mtqd5l_wpftmp.GeneratedMSBuildEditorConfig.editorconfig", "Properties", 0, 0, 0, 0, 21, 0, 1, 22
"c:\Users\chris\source\repos\Cell\Cell\obj\Debug\net8.0-windows\Cell_45mtqd5l_wpftmp.GlobalUsings.g.cs", "C#", 5, 0, 0, 0, 0, 1, 1, 7
"c:\Users\chris\source\repos\Cell\Cell\obj\Debug\net8.0-windows\Cell_45mtqd5l_wpftmp.sourcelink.json", "JSON", 0, 0, 0, 1, 0, 0, 0, 1
"c:\Users\chris\source\repos\Cell\Cell\obj\Debug\net8.0-windows\Cell_45zgrfr5_wpftmp.AssemblyInfo.cs", "C#", 11, 0, 0, 0, 0, 10, 5, 26
"c:\Users\chris\source\repos\Cell\Cell\obj\Debug\net8.0-windows\Cell_45zgrfr5_wpftmp.GeneratedMSBuildEditorConfig.editorconfig", "Properties", 0, 0, 0, 0, 21, 0, 1, 22
"c:\Users\chris\source\repos\Cell\Cell\obj\Debug\net8.0-windows\Cell_45zgrfr5_wpftmp.GlobalUsings.g.cs", "C#", 5, 0, 0, 0, 0, 1, 1, 7
"c:\Users\chris\source\repos\Cell\Cell\obj\Debug\net8.0-windows\Cell_45zgrfr5_wpftmp.sourcelink.json", "JSON", 0, 0, 0, 1, 0, 0, 0, 1
"c:\Users\chris\source\repos\Cell\Cell\obj\Debug\net8.0-windows\Cell_4ablshen_wpftmp.AssemblyInfo.cs", "C#", 11, 0, 0, 0, 0, 10, 5, 26
"c:\Users\chris\source\repos\Cell\Cell\obj\Debug\net8.0-windows\Cell_4ablshen_wpftmp.GeneratedMSBuildEditorConfig.editorconfig", "Properties", 0, 0, 0, 0, 13, 0, 1, 14
"c:\Users\chris\source\repos\Cell\Cell\obj\Debug\net8.0-windows\Cell_4ablshen_wpftmp.GlobalUsings.g.cs", "C#", 5, 0, 0, 0, 0, 1, 1, 7
"c:\Users\chris\source\repos\Cell\Cell\obj\Debug\net8.0-windows\Cell_4b02hmbv_wpftmp.AssemblyInfo.cs", "C#", 11, 0, 0, 0, 0, 10, 5, 26
"c:\Users\chris\source\repos\Cell\Cell\obj\Debug\net8.0-windows\Cell_4b02hmbv_wpftmp.GeneratedMSBuildEditorConfig.editorconfig", "Properties", 0, 0, 0, 0, 13, 0, 1, 14
"c:\Users\chris\source\repos\Cell\Cell\obj\Debug\net8.0-windows\Cell_4b02hmbv_wpftmp.GlobalUsings.g.cs", "C#", 5, 0, 0, 0, 0, 1, 1, 7
"c:\Users\chris\source\repos\Cell\Cell\obj\Debug\net8.0-windows\Cell_4c5rbofw_wpftmp.AssemblyInfo.cs", "C#", 11, 0, 0, 0, 0, 10, 5, 26
"c:\Users\chris\source\repos\Cell\Cell\obj\Debug\net8.0-windows\Cell_4c5rbofw_wpftmp.GeneratedMSBuildEditorConfig.editorconfig", "Properties", 0, 0, 0, 0, 21, 0, 1, 22
"c:\Users\chris\source\repos\Cell\Cell\obj\Debug\net8.0-windows\Cell_4c5rbofw_wpftmp.GlobalUsings.g.cs", "C#", 5, 0, 0, 0, 0, 1, 1, 7
"c:\Users\chris\source\repos\Cell\Cell\obj\Debug\net8.0-windows\Cell_4c5rbofw_wpftmp.sourcelink.json", "JSON", 0, 0, 0, 1, 0, 0, 0, 1
"c:\Users\chris\source\repos\Cell\Cell\obj\Debug\net8.0-windows\Cell_4cegaeyq_wpftmp.AssemblyInfo.cs", "C#", 11, 0, 0, 0, 0, 10, 5, 26
"c:\Users\chris\source\repos\Cell\Cell\obj\Debug\net8.0-windows\Cell_4cegaeyq_wpftmp.GeneratedMSBuildEditorConfig.editorconfig", "Properties", 0, 0, 0, 0, 21, 0, 1, 22
"c:\Users\chris\source\repos\Cell\Cell\obj\Debug\net8.0-windows\Cell_4cegaeyq_wpftmp.GlobalUsings.g.cs", "C#", 5, 0, 0, 0, 0, 1, 1, 7
"c:\Users\chris\source\repos\Cell\Cell\obj\Debug\net8.0-windows\Cell_4cegaeyq_wpftmp.sourcelink.json", "JSON", 0, 0, 0, 1, 0, 0, 0, 1
"c:\Users\chris\source\repos\Cell\Cell\obj\Debug\net8.0-windows\Cell_4chxiubz_wpftmp.AssemblyInfo.cs", "C#", 11, 0, 0, 0, 0, 10, 5, 26
"c:\Users\chris\source\repos\Cell\Cell\obj\Debug\net8.0-windows\Cell_4chxiubz_wpftmp.GeneratedMSBuildEditorConfig.editorconfig", "Properties", 0, 0, 0, 0, 21, 0, 1, 22
"c:\Users\chris\source\repos\Cell\Cell\obj\Debug\net8.0-windows\Cell_4chxiubz_wpftmp.GlobalUsings.g.cs", "C#", 5, 0, 0, 0, 0, 1, 1, 7
"c:\Users\chris\source\repos\Cell\Cell\obj\Debug\net8.0-windows\Cell_4chxiubz_wpftmp.sourcelink.json", "JSON", 0, 0, 0, 1, 0, 0, 0, 1
"c:\Users\chris\source\repos\Cell\Cell\obj\Debug\net8.0-windows\Cell_4d2e4u02_wpftmp.AssemblyInfo.cs", "C#", 11, 0, 0, 0, 0, 10, 5, 26
"c:\Users\chris\source\repos\Cell\Cell\obj\Debug\net8.0-windows\Cell_4d2e4u02_wpftmp.GeneratedMSBuildEditorConfig.editorconfig", "Properties", 0, 0, 0, 0, 21, 0, 1, 22
"c:\Users\chris\source\repos\Cell\Cell\obj\Debug\net8.0-windows\Cell_4d2e4u02_wpftmp.GlobalUsings.g.cs", "C#", 5, 0, 0, 0, 0, 1, 1, 7
"c:\Users\chris\source\repos\Cell\Cell\obj\Debug\net8.0-windows\Cell_4d2e4u02_wpftmp.sourcelink.json", "JSON", 0, 0, 0, 1, 0, 0, 0, 1
"c:\Users\chris\source\repos\Cell\Cell\obj\Debug\net8.0-windows\Cell_4d5l5w1a_wpftmp.AssemblyInfo.cs", "C#", 11, 0, 0, 0, 0, 10, 5, 26
"c:\Users\chris\source\repos\Cell\Cell\obj\Debug\net8.0-windows\Cell_4d5l5w1a_wpftmp.GeneratedMSBuildEditorConfig.editorconfig", "Properties", 0, 0, 0, 0, 21, 0, 1, 22
"c:\Users\chris\source\repos\Cell\Cell\obj\Debug\net8.0-windows\Cell_4d5l5w1a_wpftmp.GlobalUsings.g.cs", "C#", 5, 0, 0, 0, 0, 1, 1, 7
"c:\Users\chris\source\repos\Cell\Cell\obj\Debug\net8.0-windows\Cell_4d5l5w1a_wpftmp.sourcelink.json", "JSON", 0, 0, 0, 1, 0, 0, 0, 1
"c:\Users\chris\source\repos\Cell\Cell\obj\Debug\net8.0-windows\Cell_4dnafru4_wpftmp.AssemblyInfo.cs", "C#", 11, 0, 0, 0, 0, 10, 5, 26
"c:\Users\chris\source\repos\Cell\Cell\obj\Debug\net8.0-windows\Cell_4dnafru4_wpftmp.GeneratedMSBuildEditorConfig.editorconfig", "Properties", 0, 0, 0, 0, 21, 0, 1, 22
"c:\Users\chris\source\repos\Cell\Cell\obj\Debug\net8.0-windows\Cell_4dnafru4_wpftmp.GlobalUsings.g.cs", "C#", 5, 0, 0, 0, 0, 1, 1, 7
"c:\Users\chris\source\repos\Cell\Cell\obj\Debug\net8.0-windows\Cell_4dnafru4_wpftmp.sourcelink.json", "JSON", 0, 0, 0, 1, 0, 0, 0, 1
"c:\Users\chris\source\repos\Cell\Cell\obj\Debug\net8.0-windows\Cell_4e5fbvdn_wpftmp.AssemblyInfo.cs", "C#", 11, 0, 0, 0, 0, 10, 5, 26
"c:\Users\chris\source\repos\Cell\Cell\obj\Debug\net8.0-windows\Cell_4e5fbvdn_wpftmp.GeneratedMSBuildEditorConfig.editorconfig", "Properties", 0, 0, 0, 0, 21, 0, 1, 22
"c:\Users\chris\source\repos\Cell\Cell\obj\Debug\net8.0-windows\Cell_4e5fbvdn_wpftmp.GlobalUsings.g.cs", "C#", 5, 0, 0, 0, 0, 1, 1, 7
"c:\Users\chris\source\repos\Cell\Cell\obj\Debug\net8.0-windows\Cell_4e5fbvdn_wpftmp.sourcelink.json", "JSON", 0, 0, 0, 1, 0, 0, 0, 1
"c:\Users\chris\source\repos\Cell\Cell\obj\Debug\net8.0-windows\Cell_4elctdkx_wpftmp.AssemblyInfo.cs", "C#", 11, 0, 0, 0, 0, 10, 5, 26
"c:\Users\chris\source\repos\Cell\Cell\obj\Debug\net8.0-windows\Cell_4elctdkx_wpftmp.GeneratedMSBuildEditorConfig.editorconfig", "Properties", 0, 0, 0, 0, 21, 0, 1, 22
"c:\Users\chris\source\repos\Cell\Cell\obj\Debug\net8.0-windows\Cell_4elctdkx_wpftmp.GlobalUsings.g.cs", "C#", 5, 0, 0, 0, 0, 1, 1, 7
"c:\Users\chris\source\repos\Cell\Cell\obj\Debug\net8.0-windows\Cell_4elctdkx_wpftmp.sourcelink.json", "JSON", 0, 0, 0, 1, 0, 0, 0, 1
"c:\Users\chris\source\repos\Cell\Cell\obj\Debug\net8.0-windows\Cell_4eqnhbmy_wpftmp.AssemblyInfo.cs", "C#", 11, 0, 0, 0, 0, 10, 5, 26
"c:\Users\chris\source\repos\Cell\Cell\obj\Debug\net8.0-windows\Cell_4eqnhbmy_wpftmp.GeneratedMSBuildEditorConfig.editorconfig", "Properties", 0, 0, 0, 0, 21, 0, 1, 22
"c:\Users\chris\source\repos\Cell\Cell\obj\Debug\net8.0-windows\Cell_4eqnhbmy_wpftmp.GlobalUsings.g.cs", "C#", 5, 0, 0, 0, 0, 1, 1, 7
"c:\Users\chris\source\repos\Cell\Cell\obj\Debug\net8.0-windows\Cell_4eqnhbmy_wpftmp.sourcelink.json", "JSON", 0, 0, 0, 1, 0, 0, 0, 1
"c:\Users\chris\source\repos\Cell\Cell\obj\Debug\net8.0-windows\Cell_4f3kqyf2_wpftmp.AssemblyInfo.cs", "C#", 11, 0, 0, 0, 0, 10, 5, 26
"c:\Users\chris\source\repos\Cell\Cell\obj\Debug\net8.0-windows\Cell_4f3kqyf2_wpftmp.GeneratedMSBuildEditorConfig.editorconfig", "Properties", 0, 0, 0, 0, 21, 0, 1, 22
"c:\Users\chris\source\repos\Cell\Cell\obj\Debug\net8.0-windows\Cell_4f3kqyf2_wpftmp.GlobalUsings.g.cs", "C#", 5, 0, 0, 0, 0, 1, 1, 7
"c:\Users\chris\source\repos\Cell\Cell\obj\Debug\net8.0-windows\Cell_4f3kqyf2_wpftmp.sourcelink.json", "JSON", 0, 0, 0, 1, 0, 0, 0, 1
"c:\Users\chris\source\repos\Cell\Cell\obj\Debug\net8.0-windows\Cell_4ftuexlq_wpftmp.AssemblyInfo.cs", "C#", 11, 0, 0, 0, 0, 10, 5, 26
"c:\Users\chris\source\repos\Cell\Cell\obj\Debug\net8.0-windows\Cell_4ftuexlq_wpftmp.GeneratedMSBuildEditorConfig.editorconfig", "Properties", 0, 0, 0, 0, 21, 0, 1, 22
"c:\Users\chris\source\repos\Cell\Cell\obj\Debug\net8.0-windows\Cell_4ftuexlq_wpftmp.GlobalUsings.g.cs", "C#", 5, 0, 0, 0, 0, 1, 1, 7
"c:\Users\chris\source\repos\Cell\Cell\obj\Debug\net8.0-windows\Cell_4ftuexlq_wpftmp.sourcelink.json", "JSON", 0, 0, 0, 1, 0, 0, 0, 1
"c:\Users\chris\source\repos\Cell\Cell\obj\Debug\net8.0-windows\Cell_4he22lln_wpftmp.AssemblyInfo.cs", "C#", 11, 0, 0, 0, 0, 10, 5, 26
"c:\Users\chris\source\repos\Cell\Cell\obj\Debug\net8.0-windows\Cell_4he22lln_wpftmp.GeneratedMSBuildEditorConfig.editorconfig", "Properties", 0, 0, 0, 0, 13, 0, 1, 14
"c:\Users\chris\source\repos\Cell\Cell\obj\Debug\net8.0-windows\Cell_4he22lln_wpftmp.GlobalUsings.g.cs", "C#", 5, 0, 0, 0, 0, 1, 1, 7
"c:\Users\chris\source\repos\Cell\Cell\obj\Debug\net8.0-windows\Cell_4hx3sfjy_wpftmp.AssemblyInfo.cs", "C#", 11, 0, 0, 0, 0, 10, 5, 26
"c:\Users\chris\source\repos\Cell\Cell\obj\Debug\net8.0-windows\Cell_4hx3sfjy_wpftmp.GeneratedMSBuildEditorConfig.editorconfig", "Properties", 0, 0, 0, 0, 21, 0, 1, 22
"c:\Users\chris\source\repos\Cell\Cell\obj\Debug\net8.0-windows\Cell_4hx3sfjy_wpftmp.GlobalUsings.g.cs", "C#", 5, 0, 0, 0, 0, 1, 1, 7
"c:\Users\chris\source\repos\Cell\Cell\obj\Debug\net8.0-windows\Cell_4hx3sfjy_wpftmp.sourcelink.json", "JSON", 0, 0, 0, 1, 0, 0, 0, 1
"c:\Users\chris\source\repos\Cell\Cell\obj\Debug\net8.0-windows\Cell_4ifmvpqm_wpftmp.AssemblyInfo.cs", "C#", 11, 0, 0, 0, 0, 10, 5, 26
"c:\Users\chris\source\repos\Cell\Cell\obj\Debug\net8.0-windows\Cell_4ifmvpqm_wpftmp.GeneratedMSBuildEditorConfig.editorconfig", "Properties", 0, 0, 0, 0, 21, 0, 1, 22
"c:\Users\chris\source\repos\Cell\Cell\obj\Debug\net8.0-windows\Cell_4ifmvpqm_wpftmp.GlobalUsings.g.cs", "C#", 5, 0, 0, 0, 0, 1, 1, 7
"c:\Users\chris\source\repos\Cell\Cell\obj\Debug\net8.0-windows\Cell_4ifmvpqm_wpftmp.sourcelink.json", "JSON", 0, 0, 0, 1, 0, 0, 0, 1
"c:\Users\chris\source\repos\Cell\Cell\obj\Debug\net8.0-windows\Cell_4itutbc2_wpftmp.AssemblyInfo.cs", "C#", 11, 0, 0, 0, 0, 10, 5, 26
"c:\Users\chris\source\repos\Cell\Cell\obj\Debug\net8.0-windows\Cell_4itutbc2_wpftmp.GeneratedMSBuildEditorConfig.editorconfig", "Properties", 0, 0, 0, 0, 21, 0, 1, 22
"c:\Users\chris\source\repos\Cell\Cell\obj\Debug\net8.0-windows\Cell_4itutbc2_wpftmp.GlobalUsings.g.cs", "C#", 5, 0, 0, 0, 0, 1, 1, 7
"c:\Users\chris\source\repos\Cell\Cell\obj\Debug\net8.0-windows\Cell_4itutbc2_wpftmp.sourcelink.json", "JSON", 0, 0, 0, 1, 0, 0, 0, 1
"c:\Users\chris\source\repos\Cell\Cell\obj\Debug\net8.0-windows\Cell_4lb033eg_wpftmp.AssemblyInfo.cs", "C#", 11, 0, 0, 0, 0, 10, 5, 26
"c:\Users\chris\source\repos\Cell\Cell\obj\Debug\net8.0-windows\Cell_4lb033eg_wpftmp.GeneratedMSBuildEditorConfig.editorconfig", "Properties", 0, 0, 0, 0, 21, 0, 1, 22
"c:\Users\chris\source\repos\Cell\Cell\obj\Debug\net8.0-windows\Cell_4lb033eg_wpftmp.GlobalUsings.g.cs", "C#", 5, 0, 0, 0, 0, 1, 1, 7
"c:\Users\chris\source\repos\Cell\Cell\obj\Debug\net8.0-windows\Cell_4lb033eg_wpftmp.sourcelink.json", "JSON", 0, 0, 0, 1, 0, 0, 0, 1
"c:\Users\chris\source\repos\Cell\Cell\obj\Debug\net8.0-windows\Cell_4mtrt42g_wpftmp.AssemblyInfo.cs", "C#", 11, 0, 0, 0, 0, 10, 5, 26
"c:\Users\chris\source\repos\Cell\Cell\obj\Debug\net8.0-windows\Cell_4mtrt42g_wpftmp.GeneratedMSBuildEditorConfig.editorconfig", "Properties", 0, 0, 0, 0, 21, 0, 1, 22
"c:\Users\chris\source\repos\Cell\Cell\obj\Debug\net8.0-windows\Cell_4mtrt42g_wpftmp.GlobalUsings.g.cs", "C#", 5, 0, 0, 0, 0, 1, 1, 7
"c:\Users\chris\source\repos\Cell\Cell\obj\Debug\net8.0-windows\Cell_4mtrt42g_wpftmp.sourcelink.json", "JSON", 0, 0, 0, 1, 0, 0, 0, 1
"c:\Users\chris\source\repos\Cell\Cell\obj\Debug\net8.0-windows\Cell_4mycaot5_wpftmp.AssemblyInfo.cs", "C#", 11, 0, 0, 0, 0, 10, 5, 26
"c:\Users\chris\source\repos\Cell\Cell\obj\Debug\net8.0-windows\Cell_4mycaot5_wpftmp.GeneratedMSBuildEditorConfig.editorconfig", "Properties", 0, 0, 0, 0, 21, 0, 1, 22
"c:\Users\chris\source\repos\Cell\Cell\obj\Debug\net8.0-windows\Cell_4mycaot5_wpftmp.GlobalUsings.g.cs", "C#", 5, 0, 0, 0, 0, 1, 1, 7
"c:\Users\chris\source\repos\Cell\Cell\obj\Debug\net8.0-windows\Cell_4mycaot5_wpftmp.sourcelink.json", "JSON", 0, 0, 0, 1, 0, 0, 0, 1
"c:\Users\chris\source\repos\Cell\Cell\obj\Debug\net8.0-windows\Cell_4ofl1nd1_wpftmp.AssemblyInfo.cs", "C#", 11, 0, 0, 0, 0, 10, 5, 26
"c:\Users\chris\source\repos\Cell\Cell\obj\Debug\net8.0-windows\Cell_4ofl1nd1_wpftmp.GeneratedMSBuildEditorConfig.editorconfig", "Properties", 0, 0, 0, 0, 21, 0, 1, 22
"c:\Users\chris\source\repos\Cell\Cell\obj\Debug\net8.0-windows\Cell_4ofl1nd1_wpftmp.GlobalUsings.g.cs", "C#", 5, 0, 0, 0, 0, 1, 1, 7
"c:\Users\chris\source\repos\Cell\Cell\obj\Debug\net8.0-windows\Cell_4ofl1nd1_wpftmp.sourcelink.json", "JSON", 0, 0, 0, 1, 0, 0, 0, 1
"c:\Users\chris\source\repos\Cell\Cell\obj\Debug\net8.0-windows\Cell_4oqbedkb_wpftmp.AssemblyInfo.cs", "C#", 11, 0, 0, 0, 0, 10, 5, 26
"c:\Users\chris\source\repos\Cell\Cell\obj\Debug\net8.0-windows\Cell_4oqbedkb_wpftmp.GeneratedMSBuildEditorConfig.editorconfig", "Properties", 0, 0, 0, 0, 21, 0, 1, 22
"c:\Users\chris\source\repos\Cell\Cell\obj\Debug\net8.0-windows\Cell_4oqbedkb_wpftmp.GlobalUsings.g.cs", "C#", 5, 0, 0, 0, 0, 1, 1, 7
"c:\Users\chris\source\repos\Cell\Cell\obj\Debug\net8.0-windows\Cell_4oqbedkb_wpftmp.sourcelink.json", "JSON", 0, 0, 0, 1, 0, 0, 0, 1
"c:\Users\chris\source\repos\Cell\Cell\obj\Debug\net8.0-windows\Cell_4phmlfz5_wpftmp.AssemblyInfo.cs", "C#", 11, 0, 0, 0, 0, 10, 5, 26
"c:\Users\chris\source\repos\Cell\Cell\obj\Debug\net8.0-windows\Cell_4phmlfz5_wpftmp.GeneratedMSBuildEditorConfig.editorconfig", "Properties", 0, 0, 0, 0, 21, 0, 1, 22
"c:\Users\chris\source\repos\Cell\Cell\obj\Debug\net8.0-windows\Cell_4phmlfz5_wpftmp.GlobalUsings.g.cs", "C#", 5, 0, 0, 0, 0, 1, 1, 7
"c:\Users\chris\source\repos\Cell\Cell\obj\Debug\net8.0-windows\Cell_4phmlfz5_wpftmp.sourcelink.json", "JSON", 0, 0, 0, 1, 0, 0, 0, 1
"c:\Users\chris\source\repos\Cell\Cell\obj\Debug\net8.0-windows\Cell_4podbrbp_wpftmp.AssemblyInfo.cs", "C#", 11, 0, 0, 0, 0, 10, 5, 26
"c:\Users\chris\source\repos\Cell\Cell\obj\Debug\net8.0-windows\Cell_4podbrbp_wpftmp.GeneratedMSBuildEditorConfig.editorconfig", "Properties", 0, 0, 0, 0, 21, 0, 1, 22
"c:\Users\chris\source\repos\Cell\Cell\obj\Debug\net8.0-windows\Cell_4podbrbp_wpftmp.GlobalUsings.g.cs", "C#", 5, 0, 0, 0, 0, 1, 1, 7
"c:\Users\chris\source\repos\Cell\Cell\obj\Debug\net8.0-windows\Cell_4podbrbp_wpftmp.sourcelink.json", "JSON", 0, 0, 0, 1, 0, 0, 0, 1
"c:\Users\chris\source\repos\Cell\Cell\obj\Debug\net8.0-windows\Cell_4qiv5f5d_wpftmp.AssemblyInfo.cs", "C#", 11, 0, 0, 0, 0, 10, 5, 26
"c:\Users\chris\source\repos\Cell\Cell\obj\Debug\net8.0-windows\Cell_4qiv5f5d_wpftmp.GeneratedMSBuildEditorConfig.editorconfig", "Properties", 0, 0, 0, 0, 21, 0, 1, 22
"c:\Users\chris\source\repos\Cell\Cell\obj\Debug\net8.0-windows\Cell_4qiv5f5d_wpftmp.GlobalUsings.g.cs", "C#", 5, 0, 0, 0, 0, 1, 1, 7
"c:\Users\chris\source\repos\Cell\Cell\obj\Debug\net8.0-windows\Cell_4qiv5f5d_wpftmp.sourcelink.json", "JSON", 0, 0, 0, 1, 0, 0, 0, 1
"c:\Users\chris\source\repos\Cell\Cell\obj\Debug\net8.0-windows\Cell_4qolznhw_wpftmp.AssemblyInfo.cs", "C#", 11, 0, 0, 0, 0, 10, 5, 26
"c:\Users\chris\source\repos\Cell\Cell\obj\Debug\net8.0-windows\Cell_4qolznhw_wpftmp.GeneratedMSBuildEditorConfig.editorconfig", "Properties", 0, 0, 0, 0, 13, 0, 1, 14
"c:\Users\chris\source\repos\Cell\Cell\obj\Debug\net8.0-windows\Cell_4qolznhw_wpftmp.GlobalUsings.g.cs", "C#", 5, 0, 0, 0, 0, 1, 1, 7
"c:\Users\chris\source\repos\Cell\Cell\obj\Debug\net8.0-windows\Cell_4r4li3l0_wpftmp.AssemblyInfo.cs", "C#", 11, 0, 0, 0, 0, 10, 5, 26
"c:\Users\chris\source\repos\Cell\Cell\obj\Debug\net8.0-windows\Cell_4r4li3l0_wpftmp.GeneratedMSBuildEditorConfig.editorconfig", "Properties", 0, 0, 0, 0, 21, 0, 1, 22
"c:\Users\chris\source\repos\Cell\Cell\obj\Debug\net8.0-windows\Cell_4r4li3l0_wpftmp.GlobalUsings.g.cs", "C#", 5, 0, 0, 0, 0, 1, 1, 7
"c:\Users\chris\source\repos\Cell\Cell\obj\Debug\net8.0-windows\Cell_4r4li3l0_wpftmp.sourcelink.json", "JSON", 0, 0, 0, 1, 0, 0, 0, 1
"c:\Users\chris\source\repos\Cell\Cell\obj\Debug\net8.0-windows\Cell_4tn432ej_wpftmp.AssemblyInfo.cs", "C#", 11, 0, 0, 0, 0, 10, 5, 26
"c:\Users\chris\source\repos\Cell\Cell\obj\Debug\net8.0-windows\Cell_4tn432ej_wpftmp.GeneratedMSBuildEditorConfig.editorconfig", "Properties", 0, 0, 0, 0, 21, 0, 1, 22
"c:\Users\chris\source\repos\Cell\Cell\obj\Debug\net8.0-windows\Cell_4tn432ej_wpftmp.GlobalUsings.g.cs", "C#", 5, 0, 0, 0, 0, 1, 1, 7
"c:\Users\chris\source\repos\Cell\Cell\obj\Debug\net8.0-windows\Cell_4tn432ej_wpftmp.sourcelink.json", "JSON", 0, 0, 0, 1, 0, 0, 0, 1
"c:\Users\chris\source\repos\Cell\Cell\obj\Debug\net8.0-windows\Cell_4urv415p_wpftmp.AssemblyInfo.cs", "C#", 11, 0, 0, 0, 0, 10, 5, 26
"c:\Users\chris\source\repos\Cell\Cell\obj\Debug\net8.0-windows\Cell_4urv415p_wpftmp.GeneratedMSBuildEditorConfig.editorconfig", "Properties", 0, 0, 0, 0, 13, 0, 1, 14
"c:\Users\chris\source\repos\Cell\Cell\obj\Debug\net8.0-windows\Cell_4urv415p_wpftmp.GlobalUsings.g.cs", "C#", 5, 0, 0, 0, 0, 1, 1, 7
"c:\Users\chris\source\repos\Cell\Cell\obj\Debug\net8.0-windows\Cell_4usfm1fj_wpftmp.AssemblyInfo.cs", "C#", 11, 0, 0, 0, 0, 10, 5, 26
"c:\Users\chris\source\repos\Cell\Cell\obj\Debug\net8.0-windows\Cell_4usfm1fj_wpftmp.GeneratedMSBuildEditorConfig.editorconfig", "Properties", 0, 0, 0, 0, 21, 0, 1, 22
"c:\Users\chris\source\repos\Cell\Cell\obj\Debug\net8.0-windows\Cell_4usfm1fj_wpftmp.GlobalUsings.g.cs", "C#", 5, 0, 0, 0, 0, 1, 1, 7
"c:\Users\chris\source\repos\Cell\Cell\obj\Debug\net8.0-windows\Cell_4usfm1fj_wpftmp.sourcelink.json", "JSON", 0, 0, 0, 1, 0, 0, 0, 1
"c:\Users\chris\source\repos\Cell\Cell\obj\Debug\net8.0-windows\Cell_4wbpa2mz_wpftmp.AssemblyInfo.cs", "C#", 11, 0, 0, 0, 0, 10, 5, 26
"c:\Users\chris\source\repos\Cell\Cell\obj\Debug\net8.0-windows\Cell_4wbpa2mz_wpftmp.GeneratedMSBuildEditorConfig.editorconfig", "Properties", 0, 0, 0, 0, 21, 0, 1, 22
"c:\Users\chris\source\repos\Cell\Cell\obj\Debug\net8.0-windows\Cell_4wbpa2mz_wpftmp.GlobalUsings.g.cs", "C#", 5, 0, 0, 0, 0, 1, 1, 7
"c:\Users\chris\source\repos\Cell\Cell\obj\Debug\net8.0-windows\Cell_4wbpa2mz_wpftmp.sourcelink.json", "JSON", 0, 0, 0, 1, 0, 0, 0, 1
"c:\Users\chris\source\repos\Cell\Cell\obj\Debug\net8.0-windows\Cell_4wqdec3o_wpftmp.AssemblyInfo.cs", "C#", 11, 0, 0, 0, 0, 10, 5, 26
"c:\Users\chris\source\repos\Cell\Cell\obj\Debug\net8.0-windows\Cell_4wqdec3o_wpftmp.GeneratedMSBuildEditorConfig.editorconfig", "Properties", 0, 0, 0, 0, 21, 0, 1, 22
"c:\Users\chris\source\repos\Cell\Cell\obj\Debug\net8.0-windows\Cell_4wqdec3o_wpftmp.GlobalUsings.g.cs", "C#", 5, 0, 0, 0, 0, 1, 1, 7
"c:\Users\chris\source\repos\Cell\Cell\obj\Debug\net8.0-windows\Cell_4wqdec3o_wpftmp.sourcelink.json", "JSON", 0, 0, 0, 1, 0, 0, 0, 1
"c:\Users\chris\source\repos\Cell\Cell\obj\Debug\net8.0-windows\Cell_4xsl3j22_wpftmp.AssemblyInfo.cs", "C#", 11, 0, 0, 0, 0, 10, 5, 26
"c:\Users\chris\source\repos\Cell\Cell\obj\Debug\net8.0-windows\Cell_4xsl3j22_wpftmp.GeneratedMSBuildEditorConfig.editorconfig", "Properties", 0, 0, 0, 0, 21, 0, 1, 22
"c:\Users\chris\source\repos\Cell\Cell\obj\Debug\net8.0-windows\Cell_4xsl3j22_wpftmp.GlobalUsings.g.cs", "C#", 5, 0, 0, 0, 0, 1, 1, 7
"c:\Users\chris\source\repos\Cell\Cell\obj\Debug\net8.0-windows\Cell_4xsl3j22_wpftmp.sourcelink.json", "JSON", 0, 0, 0, 1, 0, 0, 0, 1
"c:\Users\chris\source\repos\Cell\Cell\obj\Debug\net8.0-windows\Cell_4ykfjcti_wpftmp.AssemblyInfo.cs", "C#", 11, 0, 0, 0, 0, 10, 5, 26
"c:\Users\chris\source\repos\Cell\Cell\obj\Debug\net8.0-windows\Cell_4ykfjcti_wpftmp.GeneratedMSBuildEditorConfig.editorconfig", "Properties", 0, 0, 0, 0, 21, 0, 1, 22
"c:\Users\chris\source\repos\Cell\Cell\obj\Debug\net8.0-windows\Cell_4ykfjcti_wpftmp.GlobalUsings.g.cs", "C#", 5, 0, 0, 0, 0, 1, 1, 7
"c:\Users\chris\source\repos\Cell\Cell\obj\Debug\net8.0-windows\Cell_4ykfjcti_wpftmp.sourcelink.json", "JSON", 0, 0, 0, 1, 0, 0, 0, 1
"c:\Users\chris\source\repos\Cell\Cell\obj\Debug\net8.0-windows\Cell_4yp2nv1n_wpftmp.AssemblyInfo.cs", "C#", 11, 0, 0, 0, 0, 10, 5, 26
"c:\Users\chris\source\repos\Cell\Cell\obj\Debug\net8.0-windows\Cell_4yp2nv1n_wpftmp.GeneratedMSBuildEditorConfig.editorconfig", "Properties", 0, 0, 0, 0, 21, 0, 1, 22
"c:\Users\chris\source\repos\Cell\Cell\obj\Debug\net8.0-windows\Cell_4yp2nv1n_wpftmp.GlobalUsings.g.cs", "C#", 5, 0, 0, 0, 0, 1, 1, 7
"c:\Users\chris\source\repos\Cell\Cell\obj\Debug\net8.0-windows\Cell_4yp2nv1n_wpftmp.sourcelink.json", "JSON", 0, 0, 0, 1, 0, 0, 0, 1
"c:\Users\chris\source\repos\Cell\Cell\obj\Debug\net8.0-windows\Cell_4z0k1rze_wpftmp.AssemblyInfo.cs", "C#", 11, 0, 0, 0, 0, 10, 5, 26
"c:\Users\chris\source\repos\Cell\Cell\obj\Debug\net8.0-windows\Cell_4z0k1rze_wpftmp.GeneratedMSBuildEditorConfig.editorconfig", "Properties", 0, 0, 0, 0, 21, 0, 1, 22
"c:\Users\chris\source\repos\Cell\Cell\obj\Debug\net8.0-windows\Cell_4z0k1rze_wpftmp.GlobalUsings.g.cs", "C#", 5, 0, 0, 0, 0, 1, 1, 7
"c:\Users\chris\source\repos\Cell\Cell\obj\Debug\net8.0-windows\Cell_4z0k1rze_wpftmp.sourcelink.json", "JSON", 0, 0, 0, 1, 0, 0, 0, 1
"c:\Users\chris\source\repos\Cell\Cell\obj\Debug\net8.0-windows\Cell_4zffqnqq_wpftmp.AssemblyInfo.cs", "C#", 11, 0, 0, 0, 0, 10, 5, 26
"c:\Users\chris\source\repos\Cell\Cell\obj\Debug\net8.0-windows\Cell_4zffqnqq_wpftmp.GeneratedMSBuildEditorConfig.editorconfig", "Properties", 0, 0, 0, 0, 13, 0, 1, 14
"c:\Users\chris\source\repos\Cell\Cell\obj\Debug\net8.0-windows\Cell_4zffqnqq_wpftmp.GlobalUsings.g.cs", "C#", 5, 0, 0, 0, 0, 1, 1, 7
"c:\Users\chris\source\repos\Cell\Cell\obj\Debug\net8.0-windows\Cell_503trk3x_wpftmp.AssemblyInfo.cs", "C#", 11, 0, 0, 0, 0, 10, 5, 26
"c:\Users\chris\source\repos\Cell\Cell\obj\Debug\net8.0-windows\Cell_503trk3x_wpftmp.GeneratedMSBuildEditorConfig.editorconfig", "Properties", 0, 0, 0, 0, 13, 0, 1, 14
"c:\Users\chris\source\repos\Cell\Cell\obj\Debug\net8.0-windows\Cell_503trk3x_wpftmp.GlobalUsings.g.cs", "C#", 5, 0, 0, 0, 0, 1, 1, 7
"c:\Users\chris\source\repos\Cell\Cell\obj\Debug\net8.0-windows\Cell_50saa4o4_wpftmp.AssemblyInfo.cs", "C#", 11, 0, 0, 0, 0, 10, 5, 26
"c:\Users\chris\source\repos\Cell\Cell\obj\Debug\net8.0-windows\Cell_50saa4o4_wpftmp.GeneratedMSBuildEditorConfig.editorconfig", "Properties", 0, 0, 0, 0, 21, 0, 1, 22
"c:\Users\chris\source\repos\Cell\Cell\obj\Debug\net8.0-windows\Cell_50saa4o4_wpftmp.GlobalUsings.g.cs", "C#", 5, 0, 0, 0, 0, 1, 1, 7
"c:\Users\chris\source\repos\Cell\Cell\obj\Debug\net8.0-windows\Cell_50saa4o4_wpftmp.sourcelink.json", "JSON", 0, 0, 0, 1, 0, 0, 0, 1
"c:\Users\chris\source\repos\Cell\Cell\obj\Debug\net8.0-windows\Cell_51hscz4e_wpftmp.AssemblyInfo.cs", "C#", 11, 0, 0, 0, 0, 10, 5, 26
"c:\Users\chris\source\repos\Cell\Cell\obj\Debug\net8.0-windows\Cell_51hscz4e_wpftmp.GeneratedMSBuildEditorConfig.editorconfig", "Properties", 0, 0, 0, 0, 21, 0, 1, 22
"c:\Users\chris\source\repos\Cell\Cell\obj\Debug\net8.0-windows\Cell_51hscz4e_wpftmp.GlobalUsings.g.cs", "C#", 5, 0, 0, 0, 0, 1, 1, 7
"c:\Users\chris\source\repos\Cell\Cell\obj\Debug\net8.0-windows\Cell_51hscz4e_wpftmp.sourcelink.json", "JSON", 0, 0, 0, 1, 0, 0, 0, 1
"c:\Users\chris\source\repos\Cell\Cell\obj\Debug\net8.0-windows\Cell_51jggfad_wpftmp.AssemblyInfo.cs", "C#", 11, 0, 0, 0, 0, 10, 5, 26
"c:\Users\chris\source\repos\Cell\Cell\obj\Debug\net8.0-windows\Cell_51jggfad_wpftmp.GeneratedMSBuildEditorConfig.editorconfig", "Properties", 0, 0, 0, 0, 21, 0, 1, 22
"c:\Users\chris\source\repos\Cell\Cell\obj\Debug\net8.0-windows\Cell_51jggfad_wpftmp.GlobalUsings.g.cs", "C#", 5, 0, 0, 0, 0, 1, 1, 7
"c:\Users\chris\source\repos\Cell\Cell\obj\Debug\net8.0-windows\Cell_51jggfad_wpftmp.sourcelink.json", "JSON", 0, 0, 0, 1, 0, 0, 0, 1
"c:\Users\chris\source\repos\Cell\Cell\obj\Debug\net8.0-windows\Cell_55qsabzs_wpftmp.AssemblyInfo.cs", "C#", 11, 0, 0, 0, 0, 10, 5, 26
"c:\Users\chris\source\repos\Cell\Cell\obj\Debug\net8.0-windows\Cell_55qsabzs_wpftmp.GeneratedMSBuildEditorConfig.editorconfig", "Properties", 0, 0, 0, 0, 21, 0, 1, 22
"c:\Users\chris\source\repos\Cell\Cell\obj\Debug\net8.0-windows\Cell_55qsabzs_wpftmp.GlobalUsings.g.cs", "C#", 5, 0, 0, 0, 0, 1, 1, 7
"c:\Users\chris\source\repos\Cell\Cell\obj\Debug\net8.0-windows\Cell_55qsabzs_wpftmp.sourcelink.json", "JSON", 0, 0, 0, 1, 0, 0, 0, 1
"c:\Users\chris\source\repos\Cell\Cell\obj\Debug\net8.0-windows\Cell_5apz5wuq_wpftmp.AssemblyInfo.cs", "C#", 11, 0, 0, 0, 0, 10, 5, 26
"c:\Users\chris\source\repos\Cell\Cell\obj\Debug\net8.0-windows\Cell_5apz5wuq_wpftmp.GeneratedMSBuildEditorConfig.editorconfig", "Properties", 0, 0, 0, 0, 13, 0, 1, 14
"c:\Users\chris\source\repos\Cell\Cell\obj\Debug\net8.0-windows\Cell_5apz5wuq_wpftmp.GlobalUsings.g.cs", "C#", 5, 0, 0, 0, 0, 1, 1, 7
"c:\Users\chris\source\repos\Cell\Cell\obj\Debug\net8.0-windows\Cell_5aui3bxg_wpftmp.AssemblyInfo.cs", "C#", 11, 0, 0, 0, 0, 10, 5, 26
"c:\Users\chris\source\repos\Cell\Cell\obj\Debug\net8.0-windows\Cell_5aui3bxg_wpftmp.GeneratedMSBuildEditorConfig.editorconfig", "Properties", 0, 0, 0, 0, 21, 0, 1, 22
"c:\Users\chris\source\repos\Cell\Cell\obj\Debug\net8.0-windows\Cell_5aui3bxg_wpftmp.GlobalUsings.g.cs", "C#", 5, 0, 0, 0, 0, 1, 1, 7
"c:\Users\chris\source\repos\Cell\Cell\obj\Debug\net8.0-windows\Cell_5aui3bxg_wpftmp.sourcelink.json", "JSON", 0, 0, 0, 1, 0, 0, 0, 1
"c:\Users\chris\source\repos\Cell\Cell\obj\Debug\net8.0-windows\Cell_5bnuenmj_wpftmp.AssemblyInfo.cs", "C#", 11, 0, 0, 0, 0, 10, 5, 26
"c:\Users\chris\source\repos\Cell\Cell\obj\Debug\net8.0-windows\Cell_5bnuenmj_wpftmp.GeneratedMSBuildEditorConfig.editorconfig", "Properties", 0, 0, 0, 0, 21, 0, 1, 22
"c:\Users\chris\source\repos\Cell\Cell\obj\Debug\net8.0-windows\Cell_5bnuenmj_wpftmp.GlobalUsings.g.cs", "C#", 5, 0, 0, 0, 0, 1, 1, 7
"c:\Users\chris\source\repos\Cell\Cell\obj\Debug\net8.0-windows\Cell_5bnuenmj_wpftmp.sourcelink.json", "JSON", 0, 0, 0, 1, 0, 0, 0, 1
"c:\Users\chris\source\repos\Cell\Cell\obj\Debug\net8.0-windows\Cell_5cufflq1_wpftmp.AssemblyInfo.cs", "C#", 11, 0, 0, 0, 0, 10, 5, 26
"c:\Users\chris\source\repos\Cell\Cell\obj\Debug\net8.0-windows\Cell_5cufflq1_wpftmp.GeneratedMSBuildEditorConfig.editorconfig", "Properties", 0, 0, 0, 0, 21, 0, 1, 22
"c:\Users\chris\source\repos\Cell\Cell\obj\Debug\net8.0-windows\Cell_5cufflq1_wpftmp.GlobalUsings.g.cs", "C#", 5, 0, 0, 0, 0, 1, 1, 7
"c:\Users\chris\source\repos\Cell\Cell\obj\Debug\net8.0-windows\Cell_5cufflq1_wpftmp.sourcelink.json", "JSON", 0, 0, 0, 1, 0, 0, 0, 1
"c:\Users\chris\source\repos\Cell\Cell\obj\Debug\net8.0-windows\Cell_5e005li5_wpftmp.AssemblyInfo.cs", "C#", 11, 0, 0, 0, 0, 10, 5, 26
"c:\Users\chris\source\repos\Cell\Cell\obj\Debug\net8.0-windows\Cell_5e005li5_wpftmp.GeneratedMSBuildEditorConfig.editorconfig", "Properties", 0, 0, 0, 0, 13, 0, 1, 14
"c:\Users\chris\source\repos\Cell\Cell\obj\Debug\net8.0-windows\Cell_5e005li5_wpftmp.GlobalUsings.g.cs", "C#", 5, 0, 0, 0, 0, 1, 1, 7
"c:\Users\chris\source\repos\Cell\Cell\obj\Debug\net8.0-windows\Cell_5e3adyrk_wpftmp.AssemblyInfo.cs", "C#", 11, 0, 0, 0, 0, 10, 5, 26
"c:\Users\chris\source\repos\Cell\Cell\obj\Debug\net8.0-windows\Cell_5e3adyrk_wpftmp.GeneratedMSBuildEditorConfig.editorconfig", "Properties", 0, 0, 0, 0, 21, 0, 1, 22
"c:\Users\chris\source\repos\Cell\Cell\obj\Debug\net8.0-windows\Cell_5e3adyrk_wpftmp.GlobalUsings.g.cs", "C#", 5, 0, 0, 0, 0, 1, 1, 7
"c:\Users\chris\source\repos\Cell\Cell\obj\Debug\net8.0-windows\Cell_5e3adyrk_wpftmp.sourcelink.json", "JSON", 0, 0, 0, 1, 0, 0, 0, 1
"c:\Users\chris\source\repos\Cell\Cell\obj\Debug\net8.0-windows\Cell_5eacjnef_wpftmp.AssemblyInfo.cs", "C#", 11, 0, 0, 0, 0, 10, 5, 26
"c:\Users\chris\source\repos\Cell\Cell\obj\Debug\net8.0-windows\Cell_5eacjnef_wpftmp.GeneratedMSBuildEditorConfig.editorconfig", "Properties", 0, 0, 0, 0, 21, 0, 1, 22
"c:\Users\chris\source\repos\Cell\Cell\obj\Debug\net8.0-windows\Cell_5eacjnef_wpftmp.GlobalUsings.g.cs", "C#", 5, 0, 0, 0, 0, 1, 1, 7
"c:\Users\chris\source\repos\Cell\Cell\obj\Debug\net8.0-windows\Cell_5eacjnef_wpftmp.sourcelink.json", "JSON", 0, 0, 0, 1, 0, 0, 0, 1
"c:\Users\chris\source\repos\Cell\Cell\obj\Debug\net8.0-windows\Cell_5emt5i51_wpftmp.AssemblyInfo.cs", "C#", 11, 0, 0, 0, 0, 10, 5, 26
"c:\Users\chris\source\repos\Cell\Cell\obj\Debug\net8.0-windows\Cell_5emt5i51_wpftmp.GeneratedMSBuildEditorConfig.editorconfig", "Properties", 0, 0, 0, 0, 21, 0, 1, 22
"c:\Users\chris\source\repos\Cell\Cell\obj\Debug\net8.0-windows\Cell_5emt5i51_wpftmp.GlobalUsings.g.cs", "C#", 5, 0, 0, 0, 0, 1, 1, 7
"c:\Users\chris\source\repos\Cell\Cell\obj\Debug\net8.0-windows\Cell_5emt5i51_wpftmp.sourcelink.json", "JSON", 0, 0, 0, 1, 0, 0, 0, 1
"c:\Users\chris\source\repos\Cell\Cell\obj\Debug\net8.0-windows\Cell_5hozay1v_wpftmp.AssemblyInfo.cs", "C#", 11, 0, 0, 0, 0, 10, 5, 26
"c:\Users\chris\source\repos\Cell\Cell\obj\Debug\net8.0-windows\Cell_5hozay1v_wpftmp.GeneratedMSBuildEditorConfig.editorconfig", "Properties", 0, 0, 0, 0, 21, 0, 1, 22
"c:\Users\chris\source\repos\Cell\Cell\obj\Debug\net8.0-windows\Cell_5hozay1v_wpftmp.GlobalUsings.g.cs", "C#", 5, 0, 0, 0, 0, 1, 1, 7
"c:\Users\chris\source\repos\Cell\Cell\obj\Debug\net8.0-windows\Cell_5hozay1v_wpftmp.sourcelink.json", "JSON", 0, 0, 0, 1, 0, 0, 0, 1
"c:\Users\chris\source\repos\Cell\Cell\obj\Debug\net8.0-windows\Cell_5hutewq1_wpftmp.AssemblyInfo.cs", "C#", 11, 0, 0, 0, 0, 10, 5, 26
"c:\Users\chris\source\repos\Cell\Cell\obj\Debug\net8.0-windows\Cell_5hutewq1_wpftmp.GeneratedMSBuildEditorConfig.editorconfig", "Properties", 0, 0, 0, 0, 13, 0, 1, 14
"c:\Users\chris\source\repos\Cell\Cell\obj\Debug\net8.0-windows\Cell_5hutewq1_wpftmp.GlobalUsings.g.cs", "C#", 5, 0, 0, 0, 0, 1, 1, 7
"c:\Users\chris\source\repos\Cell\Cell\obj\Debug\net8.0-windows\Cell_5hws0mok_wpftmp.AssemblyInfo.cs", "C#", 11, 0, 0, 0, 0, 10, 5, 26
"c:\Users\chris\source\repos\Cell\Cell\obj\Debug\net8.0-windows\Cell_5hws0mok_wpftmp.GeneratedMSBuildEditorConfig.editorconfig", "Properties", 0, 0, 0, 0, 21, 0, 1, 22
"c:\Users\chris\source\repos\Cell\Cell\obj\Debug\net8.0-windows\Cell_5hws0mok_wpftmp.GlobalUsings.g.cs", "C#", 5, 0, 0, 0, 0, 1, 1, 7
"c:\Users\chris\source\repos\Cell\Cell\obj\Debug\net8.0-windows\Cell_5hws0mok_wpftmp.sourcelink.json", "JSON", 0, 0, 0, 1, 0, 0, 0, 1
"c:\Users\chris\source\repos\Cell\Cell\obj\Debug\net8.0-windows\Cell_5isy4e2v_wpftmp.AssemblyInfo.cs", "C#", 11, 0, 0, 0, 0, 10, 5, 26
"c:\Users\chris\source\repos\Cell\Cell\obj\Debug\net8.0-windows\Cell_5isy4e2v_wpftmp.GeneratedMSBuildEditorConfig.editorconfig", "Properties", 0, 0, 0, 0, 21, 0, 1, 22
"c:\Users\chris\source\repos\Cell\Cell\obj\Debug\net8.0-windows\Cell_5isy4e2v_wpftmp.GlobalUsings.g.cs", "C#", 5, 0, 0, 0, 0, 1, 1, 7
"c:\Users\chris\source\repos\Cell\Cell\obj\Debug\net8.0-windows\Cell_5isy4e2v_wpftmp.sourcelink.json", "JSON", 0, 0, 0, 1, 0, 0, 0, 1
"c:\Users\chris\source\repos\Cell\Cell\obj\Debug\net8.0-windows\Cell_5jnxhecw_wpftmp.AssemblyInfo.cs", "C#", 11, 0, 0, 0, 0, 10, 5, 26
"c:\Users\chris\source\repos\Cell\Cell\obj\Debug\net8.0-windows\Cell_5jnxhecw_wpftmp.GeneratedMSBuildEditorConfig.editorconfig", "Properties", 0, 0, 0, 0, 21, 0, 1, 22
"c:\Users\chris\source\repos\Cell\Cell\obj\Debug\net8.0-windows\Cell_5jnxhecw_wpftmp.GlobalUsings.g.cs", "C#", 5, 0, 0, 0, 0, 1, 1, 7
"c:\Users\chris\source\repos\Cell\Cell\obj\Debug\net8.0-windows\Cell_5jnxhecw_wpftmp.sourcelink.json", "JSON", 0, 0, 0, 1, 0, 0, 0, 1
"c:\Users\chris\source\repos\Cell\Cell\obj\Debug\net8.0-windows\Cell_5kezeuud_wpftmp.AssemblyInfo.cs", "C#", 11, 0, 0, 0, 0, 10, 5, 26
"c:\Users\chris\source\repos\Cell\Cell\obj\Debug\net8.0-windows\Cell_5kezeuud_wpftmp.GeneratedMSBuildEditorConfig.editorconfig", "Properties", 0, 0, 0, 0, 13, 0, 1, 14
"c:\Users\chris\source\repos\Cell\Cell\obj\Debug\net8.0-windows\Cell_5kezeuud_wpftmp.GlobalUsings.g.cs", "C#", 5, 0, 0, 0, 0, 1, 1, 7
"c:\Users\chris\source\repos\Cell\Cell\obj\Debug\net8.0-windows\Cell_5ktk3jnk_wpftmp.AssemblyInfo.cs", "C#", 11, 0, 0, 0, 0, 10, 5, 26
"c:\Users\chris\source\repos\Cell\Cell\obj\Debug\net8.0-windows\Cell_5ktk3jnk_wpftmp.GeneratedMSBuildEditorConfig.editorconfig", "Properties", 0, 0, 0, 0, 21, 0, 1, 22
"c:\Users\chris\source\repos\Cell\Cell\obj\Debug\net8.0-windows\Cell_5ktk3jnk_wpftmp.GlobalUsings.g.cs", "C#", 5, 0, 0, 0, 0, 1, 1, 7
"c:\Users\chris\source\repos\Cell\Cell\obj\Debug\net8.0-windows\Cell_5ktk3jnk_wpftmp.sourcelink.json", "JSON", 0, 0, 0, 1, 0, 0, 0, 1
"c:\Users\chris\source\repos\Cell\Cell\obj\Debug\net8.0-windows\Cell_5l04y4ee_wpftmp.AssemblyInfo.cs", "C#", 11, 0, 0, 0, 0, 10, 5, 26
"c:\Users\chris\source\repos\Cell\Cell\obj\Debug\net8.0-windows\Cell_5l04y4ee_wpftmp.GeneratedMSBuildEditorConfig.editorconfig", "Properties", 0, 0, 0, 0, 21, 0, 1, 22
"c:\Users\chris\source\repos\Cell\Cell\obj\Debug\net8.0-windows\Cell_5l04y4ee_wpftmp.GlobalUsings.g.cs", "C#", 5, 0, 0, 0, 0, 1, 1, 7
"c:\Users\chris\source\repos\Cell\Cell\obj\Debug\net8.0-windows\Cell_5l04y4ee_wpftmp.sourcelink.json", "JSON", 0, 0, 0, 1, 0, 0, 0, 1
"c:\Users\chris\source\repos\Cell\Cell\obj\Debug\net8.0-windows\Cell_5mdjzw2a_wpftmp.AssemblyInfo.cs", "C#", 11, 0, 0, 0, 0, 10, 5, 26
"c:\Users\chris\source\repos\Cell\Cell\obj\Debug\net8.0-windows\Cell_5mdjzw2a_wpftmp.GeneratedMSBuildEditorConfig.editorconfig", "Properties", 0, 0, 0, 0, 13, 0, 1, 14
"c:\Users\chris\source\repos\Cell\Cell\obj\Debug\net8.0-windows\Cell_5mdjzw2a_wpftmp.GlobalUsings.g.cs", "C#", 5, 0, 0, 0, 0, 1, 1, 7
"c:\Users\chris\source\repos\Cell\Cell\obj\Debug\net8.0-windows\Cell_5mr3joxj_wpftmp.AssemblyInfo.cs", "C#", 11, 0, 0, 0, 0, 10, 5, 26
"c:\Users\chris\source\repos\Cell\Cell\obj\Debug\net8.0-windows\Cell_5mr3joxj_wpftmp.GeneratedMSBuildEditorConfig.editorconfig", "Properties", 0, 0, 0, 0, 21, 0, 1, 22
"c:\Users\chris\source\repos\Cell\Cell\obj\Debug\net8.0-windows\Cell_5mr3joxj_wpftmp.GlobalUsings.g.cs", "C#", 5, 0, 0, 0, 0, 1, 1, 7
"c:\Users\chris\source\repos\Cell\Cell\obj\Debug\net8.0-windows\Cell_5mr3joxj_wpftmp.sourcelink.json", "JSON", 0, 0, 0, 1, 0, 0, 0, 1
"c:\Users\chris\source\repos\Cell\Cell\obj\Debug\net8.0-windows\Cell_5mzcrker_wpftmp.AssemblyInfo.cs", "C#", 11, 0, 0, 0, 0, 10, 5, 26
"c:\Users\chris\source\repos\Cell\Cell\obj\Debug\net8.0-windows\Cell_5mzcrker_wpftmp.GeneratedMSBuildEditorConfig.editorconfig", "Properties", 0, 0, 0, 0, 21, 0, 1, 22
"c:\Users\chris\source\repos\Cell\Cell\obj\Debug\net8.0-windows\Cell_5mzcrker_wpftmp.GlobalUsings.g.cs", "C#", 5, 0, 0, 0, 0, 1, 1, 7
"c:\Users\chris\source\repos\Cell\Cell\obj\Debug\net8.0-windows\Cell_5mzcrker_wpftmp.sourcelink.json", "JSON", 0, 0, 0, 1, 0, 0, 0, 1
"c:\Users\chris\source\repos\Cell\Cell\obj\Debug\net8.0-windows\Cell_5n1tfktp_wpftmp.AssemblyInfo.cs", "C#", 11, 0, 0, 0, 0, 10, 5, 26
"c:\Users\chris\source\repos\Cell\Cell\obj\Debug\net8.0-windows\Cell_5n1tfktp_wpftmp.GeneratedMSBuildEditorConfig.editorconfig", "Properties", 0, 0, 0, 0, 21, 0, 1, 22
"c:\Users\chris\source\repos\Cell\Cell\obj\Debug\net8.0-windows\Cell_5n1tfktp_wpftmp.GlobalUsings.g.cs", "C#", 5, 0, 0, 0, 0, 1, 1, 7
"c:\Users\chris\source\repos\Cell\Cell\obj\Debug\net8.0-windows\Cell_5n1tfktp_wpftmp.sourcelink.json", "JSON", 0, 0, 0, 1, 0, 0, 0, 1
"c:\Users\chris\source\repos\Cell\Cell\obj\Debug\net8.0-windows\Cell_5ne4hbt2_wpftmp.AssemblyInfo.cs", "C#", 11, 0, 0, 0, 0, 10, 5, 26
"c:\Users\chris\source\repos\Cell\Cell\obj\Debug\net8.0-windows\Cell_5ne4hbt2_wpftmp.GeneratedMSBuildEditorConfig.editorconfig", "Properties", 0, 0, 0, 0, 21, 0, 1, 22
"c:\Users\chris\source\repos\Cell\Cell\obj\Debug\net8.0-windows\Cell_5ne4hbt2_wpftmp.GlobalUsings.g.cs", "C#", 5, 0, 0, 0, 0, 1, 1, 7
"c:\Users\chris\source\repos\Cell\Cell\obj\Debug\net8.0-windows\Cell_5ne4hbt2_wpftmp.sourcelink.json", "JSON", 0, 0, 0, 1, 0, 0, 0, 1
"c:\Users\chris\source\repos\Cell\Cell\obj\Debug\net8.0-windows\Cell_5owtpk2e_wpftmp.AssemblyInfo.cs", "C#", 11, 0, 0, 0, 0, 10, 5, 26
"c:\Users\chris\source\repos\Cell\Cell\obj\Debug\net8.0-windows\Cell_5owtpk2e_wpftmp.GeneratedMSBuildEditorConfig.editorconfig", "Properties", 0, 0, 0, 0, 21, 0, 1, 22
"c:\Users\chris\source\repos\Cell\Cell\obj\Debug\net8.0-windows\Cell_5owtpk2e_wpftmp.GlobalUsings.g.cs", "C#", 5, 0, 0, 0, 0, 1, 1, 7
"c:\Users\chris\source\repos\Cell\Cell\obj\Debug\net8.0-windows\Cell_5owtpk2e_wpftmp.sourcelink.json", "JSON", 0, 0, 0, 1, 0, 0, 0, 1
"c:\Users\chris\source\repos\Cell\Cell\obj\Debug\net8.0-windows\Cell_5ozlscep_wpftmp.AssemblyInfo.cs", "C#", 11, 0, 0, 0, 0, 10, 5, 26
"c:\Users\chris\source\repos\Cell\Cell\obj\Debug\net8.0-windows\Cell_5ozlscep_wpftmp.GeneratedMSBuildEditorConfig.editorconfig", "Properties", 0, 0, 0, 0, 21, 0, 1, 22
"c:\Users\chris\source\repos\Cell\Cell\obj\Debug\net8.0-windows\Cell_5ozlscep_wpftmp.GlobalUsings.g.cs", "C#", 5, 0, 0, 0, 0, 1, 1, 7
"c:\Users\chris\source\repos\Cell\Cell\obj\Debug\net8.0-windows\Cell_5ozlscep_wpftmp.sourcelink.json", "JSON", 0, 0, 0, 1, 0, 0, 0, 1
"c:\Users\chris\source\repos\Cell\Cell\obj\Debug\net8.0-windows\Cell_5pxwzvc2_wpftmp.AssemblyInfo.cs", "C#", 11, 0, 0, 0, 0, 10, 5, 26
"c:\Users\chris\source\repos\Cell\Cell\obj\Debug\net8.0-windows\Cell_5pxwzvc2_wpftmp.GeneratedMSBuildEditorConfig.editorconfig", "Properties", 0, 0, 0, 0, 21, 0, 1, 22
"c:\Users\chris\source\repos\Cell\Cell\obj\Debug\net8.0-windows\Cell_5pxwzvc2_wpftmp.GlobalUsings.g.cs", "C#", 5, 0, 0, 0, 0, 1, 1, 7
"c:\Users\chris\source\repos\Cell\Cell\obj\Debug\net8.0-windows\Cell_5pxwzvc2_wpftmp.sourcelink.json", "JSON", 0, 0, 0, 1, 0, 0, 0, 1
"c:\Users\chris\source\repos\Cell\Cell\obj\Debug\net8.0-windows\Cell_5pyygvu1_wpftmp.AssemblyInfo.cs", "C#", 11, 0, 0, 0, 0, 10, 5, 26
"c:\Users\chris\source\repos\Cell\Cell\obj\Debug\net8.0-windows\Cell_5pyygvu1_wpftmp.GeneratedMSBuildEditorConfig.editorconfig", "Properties", 0, 0, 0, 0, 21, 0, 1, 22
"c:\Users\chris\source\repos\Cell\Cell\obj\Debug\net8.0-windows\Cell_5pyygvu1_wpftmp.GlobalUsings.g.cs", "C#", 5, 0, 0, 0, 0, 1, 1, 7
"c:\Users\chris\source\repos\Cell\Cell\obj\Debug\net8.0-windows\Cell_5pyygvu1_wpftmp.sourcelink.json", "JSON", 0, 0, 0, 1, 0, 0, 0, 1
"c:\Users\chris\source\repos\Cell\Cell\obj\Debug\net8.0-windows\Cell_5qyfuew2_wpftmp.AssemblyInfo.cs", "C#", 11, 0, 0, 0, 0, 10, 5, 26
"c:\Users\chris\source\repos\Cell\Cell\obj\Debug\net8.0-windows\Cell_5qyfuew2_wpftmp.GeneratedMSBuildEditorConfig.editorconfig", "Properties", 0, 0, 0, 0, 21, 0, 1, 22
"c:\Users\chris\source\repos\Cell\Cell\obj\Debug\net8.0-windows\Cell_5qyfuew2_wpftmp.GlobalUsings.g.cs", "C#", 5, 0, 0, 0, 0, 1, 1, 7
"c:\Users\chris\source\repos\Cell\Cell\obj\Debug\net8.0-windows\Cell_5qyfuew2_wpftmp.sourcelink.json", "JSON", 0, 0, 0, 1, 0, 0, 0, 1
"c:\Users\chris\source\repos\Cell\Cell\obj\Debug\net8.0-windows\Cell_5rr4yuly_wpftmp.AssemblyInfo.cs", "C#", 11, 0, 0, 0, 0, 10, 5, 26
"c:\Users\chris\source\repos\Cell\Cell\obj\Debug\net8.0-windows\Cell_5rr4yuly_wpftmp.GeneratedMSBuildEditorConfig.editorconfig", "Properties", 0, 0, 0, 0, 21, 0, 1, 22
"c:\Users\chris\source\repos\Cell\Cell\obj\Debug\net8.0-windows\Cell_5rr4yuly_wpftmp.GlobalUsings.g.cs", "C#", 5, 0, 0, 0, 0, 1, 1, 7
"c:\Users\chris\source\repos\Cell\Cell\obj\Debug\net8.0-windows\Cell_5rr4yuly_wpftmp.sourcelink.json", "JSON", 0, 0, 0, 1, 0, 0, 0, 1
"c:\Users\chris\source\repos\Cell\Cell\obj\Debug\net8.0-windows\Cell_5tefsfrl_wpftmp.AssemblyInfo.cs", "C#", 11, 0, 0, 0, 0, 10, 5, 26
"c:\Users\chris\source\repos\Cell\Cell\obj\Debug\net8.0-windows\Cell_5tefsfrl_wpftmp.GeneratedMSBuildEditorConfig.editorconfig", "Properties", 0, 0, 0, 0, 13, 0, 1, 14
"c:\Users\chris\source\repos\Cell\Cell\obj\Debug\net8.0-windows\Cell_5tefsfrl_wpftmp.GlobalUsings.g.cs", "C#", 5, 0, 0, 0, 0, 1, 1, 7
"c:\Users\chris\source\repos\Cell\Cell\obj\Debug\net8.0-windows\Cell_5tzibbiu_wpftmp.AssemblyInfo.cs", "C#", 11, 0, 0, 0, 0, 10, 5, 26
"c:\Users\chris\source\repos\Cell\Cell\obj\Debug\net8.0-windows\Cell_5tzibbiu_wpftmp.GeneratedMSBuildEditorConfig.editorconfig", "Properties", 0, 0, 0, 0, 21, 0, 1, 22
"c:\Users\chris\source\repos\Cell\Cell\obj\Debug\net8.0-windows\Cell_5tzibbiu_wpftmp.GlobalUsings.g.cs", "C#", 5, 0, 0, 0, 0, 1, 1, 7
"c:\Users\chris\source\repos\Cell\Cell\obj\Debug\net8.0-windows\Cell_5tzibbiu_wpftmp.sourcelink.json", "JSON", 0, 0, 0, 1, 0, 0, 0, 1
"c:\Users\chris\source\repos\Cell\Cell\obj\Debug\net8.0-windows\Cell_5v4d4ydq_wpftmp.AssemblyInfo.cs", "C#", 11, 0, 0, 0, 0, 10, 5, 26
"c:\Users\chris\source\repos\Cell\Cell\obj\Debug\net8.0-windows\Cell_5v4d4ydq_wpftmp.GeneratedMSBuildEditorConfig.editorconfig", "Properties", 0, 0, 0, 0, 21, 0, 1, 22
"c:\Users\chris\source\repos\Cell\Cell\obj\Debug\net8.0-windows\Cell_5v4d4ydq_wpftmp.GlobalUsings.g.cs", "C#", 5, 0, 0, 0, 0, 1, 1, 7
"c:\Users\chris\source\repos\Cell\Cell\obj\Debug\net8.0-windows\Cell_5v4d4ydq_wpftmp.sourcelink.json", "JSON", 0, 0, 0, 1, 0, 0, 0, 1
"c:\Users\chris\source\repos\Cell\Cell\obj\Debug\net8.0-windows\Cell_5v4r32ik_wpftmp.AssemblyInfo.cs", "C#", 11, 0, 0, 0, 0, 10, 5, 26
"c:\Users\chris\source\repos\Cell\Cell\obj\Debug\net8.0-windows\Cell_5v4r32ik_wpftmp.GeneratedMSBuildEditorConfig.editorconfig", "Properties", 0, 0, 0, 0, 21, 0, 1, 22
"c:\Users\chris\source\repos\Cell\Cell\obj\Debug\net8.0-windows\Cell_5v4r32ik_wpftmp.GlobalUsings.g.cs", "C#", 5, 0, 0, 0, 0, 1, 1, 7
"c:\Users\chris\source\repos\Cell\Cell\obj\Debug\net8.0-windows\Cell_5v4r32ik_wpftmp.sourcelink.json", "JSON", 0, 0, 0, 1, 0, 0, 0, 1
"c:\Users\chris\source\repos\Cell\Cell\obj\Debug\net8.0-windows\Cell_5vfojcmm_wpftmp.AssemblyInfo.cs", "C#", 11, 0, 0, 0, 0, 10, 5, 26
"c:\Users\chris\source\repos\Cell\Cell\obj\Debug\net8.0-windows\Cell_5vfojcmm_wpftmp.GeneratedMSBuildEditorConfig.editorconfig", "Properties", 0, 0, 0, 0, 21, 0, 1, 22
"c:\Users\chris\source\repos\Cell\Cell\obj\Debug\net8.0-windows\Cell_5vfojcmm_wpftmp.GlobalUsings.g.cs", "C#", 5, 0, 0, 0, 0, 1, 1, 7
"c:\Users\chris\source\repos\Cell\Cell\obj\Debug\net8.0-windows\Cell_5vfojcmm_wpftmp.sourcelink.json", "JSON", 0, 0, 0, 1, 0, 0, 0, 1
"c:\Users\chris\source\repos\Cell\Cell\obj\Debug\net8.0-windows\Cell_5vqkvtvg_wpftmp.AssemblyInfo.cs", "C#", 11, 0, 0, 0, 0, 10, 5, 26
"c:\Users\chris\source\repos\Cell\Cell\obj\Debug\net8.0-windows\Cell_5vqkvtvg_wpftmp.GeneratedMSBuildEditorConfig.editorconfig", "Properties", 0, 0, 0, 0, 21, 0, 1, 22
"c:\Users\chris\source\repos\Cell\Cell\obj\Debug\net8.0-windows\Cell_5vqkvtvg_wpftmp.GlobalUsings.g.cs", "C#", 5, 0, 0, 0, 0, 1, 1, 7
"c:\Users\chris\source\repos\Cell\Cell\obj\Debug\net8.0-windows\Cell_5vqkvtvg_wpftmp.sourcelink.json", "JSON", 0, 0, 0, 1, 0, 0, 0, 1
"c:\Users\chris\source\repos\Cell\Cell\obj\Debug\net8.0-windows\Cell_5xjfnkdf_wpftmp.AssemblyInfo.cs", "C#", 11, 0, 0, 0, 0, 10, 5, 26
"c:\Users\chris\source\repos\Cell\Cell\obj\Debug\net8.0-windows\Cell_5xjfnkdf_wpftmp.GeneratedMSBuildEditorConfig.editorconfig", "Properties", 0, 0, 0, 0, 13, 0, 1, 14
"c:\Users\chris\source\repos\Cell\Cell\obj\Debug\net8.0-windows\Cell_5xjfnkdf_wpftmp.GlobalUsings.g.cs", "C#", 5, 0, 0, 0, 0, 1, 1, 7
"c:\Users\chris\source\repos\Cell\Cell\obj\Debug\net8.0-windows\Cell_5yda5ucd_wpftmp.AssemblyInfo.cs", "C#", 11, 0, 0, 0, 0, 10, 5, 26
"c:\Users\chris\source\repos\Cell\Cell\obj\Debug\net8.0-windows\Cell_5yda5ucd_wpftmp.GeneratedMSBuildEditorConfig.editorconfig", "Properties", 0, 0, 0, 0, 13, 0, 1, 14
"c:\Users\chris\source\repos\Cell\Cell\obj\Debug\net8.0-windows\Cell_5yda5ucd_wpftmp.GlobalUsings.g.cs", "C#", 5, 0, 0, 0, 0, 1, 1, 7
"c:\Users\chris\source\repos\Cell\Cell\obj\Debug\net8.0-windows\Cell_5yh4atyi_wpftmp.AssemblyInfo.cs", "C#", 11, 0, 0, 0, 0, 10, 5, 26
"c:\Users\chris\source\repos\Cell\Cell\obj\Debug\net8.0-windows\Cell_5yh4atyi_wpftmp.GeneratedMSBuildEditorConfig.editorconfig", "Properties", 0, 0, 0, 0, 21, 0, 1, 22
"c:\Users\chris\source\repos\Cell\Cell\obj\Debug\net8.0-windows\Cell_5yh4atyi_wpftmp.GlobalUsings.g.cs", "C#", 5, 0, 0, 0, 0, 1, 1, 7
"c:\Users\chris\source\repos\Cell\Cell\obj\Debug\net8.0-windows\Cell_5yh4atyi_wpftmp.sourcelink.json", "JSON", 0, 0, 0, 1, 0, 0, 0, 1
"c:\Users\chris\source\repos\Cell\Cell\obj\Debug\net8.0-windows\Cell_5yy21ox1_wpftmp.AssemblyInfo.cs", "C#", 11, 0, 0, 0, 0, 10, 5, 26
"c:\Users\chris\source\repos\Cell\Cell\obj\Debug\net8.0-windows\Cell_5yy21ox1_wpftmp.GeneratedMSBuildEditorConfig.editorconfig", "Properties", 0, 0, 0, 0, 13, 0, 1, 14
"c:\Users\chris\source\repos\Cell\Cell\obj\Debug\net8.0-windows\Cell_5yy21ox1_wpftmp.GlobalUsings.g.cs", "C#", 5, 0, 0, 0, 0, 1, 1, 7
"c:\Users\chris\source\repos\Cell\Cell\obj\Debug\net8.0-windows\Cell_a0bvwo4g_wpftmp.AssemblyInfo.cs", "C#", 11, 0, 0, 0, 0, 10, 5, 26
"c:\Users\chris\source\repos\Cell\Cell\obj\Debug\net8.0-windows\Cell_a0bvwo4g_wpftmp.GeneratedMSBuildEditorConfig.editorconfig", "Properties", 0, 0, 0, 0, 21, 0, 1, 22
"c:\Users\chris\source\repos\Cell\Cell\obj\Debug\net8.0-windows\Cell_a0bvwo4g_wpftmp.GlobalUsings.g.cs", "C#", 5, 0, 0, 0, 0, 1, 1, 7
"c:\Users\chris\source\repos\Cell\Cell\obj\Debug\net8.0-windows\Cell_a0bvwo4g_wpftmp.sourcelink.json", "JSON", 0, 0, 0, 1, 0, 0, 0, 1
"c:\Users\chris\source\repos\Cell\Cell\obj\Debug\net8.0-windows\Cell_a1c035ol_wpftmp.AssemblyInfo.cs", "C#", 11, 0, 0, 0, 0, 10, 5, 26
"c:\Users\chris\source\repos\Cell\Cell\obj\Debug\net8.0-windows\Cell_a1c035ol_wpftmp.GeneratedMSBuildEditorConfig.editorconfig", "Properties", 0, 0, 0, 0, 21, 0, 1, 22
"c:\Users\chris\source\repos\Cell\Cell\obj\Debug\net8.0-windows\Cell_a1c035ol_wpftmp.GlobalUsings.g.cs", "C#", 5, 0, 0, 0, 0, 1, 1, 7
"c:\Users\chris\source\repos\Cell\Cell\obj\Debug\net8.0-windows\Cell_a1c035ol_wpftmp.sourcelink.json", "JSON", 0, 0, 0, 1, 0, 0, 0, 1
"c:\Users\chris\source\repos\Cell\Cell\obj\Debug\net8.0-windows\Cell_a1pzrkb0_wpftmp.AssemblyInfo.cs", "C#", 11, 0, 0, 0, 0, 10, 5, 26
"c:\Users\chris\source\repos\Cell\Cell\obj\Debug\net8.0-windows\Cell_a1pzrkb0_wpftmp.GeneratedMSBuildEditorConfig.editorconfig", "Properties", 0, 0, 0, 0, 21, 0, 1, 22
"c:\Users\chris\source\repos\Cell\Cell\obj\Debug\net8.0-windows\Cell_a1pzrkb0_wpftmp.GlobalUsings.g.cs", "C#", 5, 0, 0, 0, 0, 1, 1, 7
"c:\Users\chris\source\repos\Cell\Cell\obj\Debug\net8.0-windows\Cell_a1pzrkb0_wpftmp.sourcelink.json", "JSON", 0, 0, 0, 1, 0, 0, 0, 1
"c:\Users\chris\source\repos\Cell\Cell\obj\Debug\net8.0-windows\Cell_a30ik3rw_wpftmp.AssemblyInfo.cs", "C#", 11, 0, 0, 0, 0, 10, 5, 26
"c:\Users\chris\source\repos\Cell\Cell\obj\Debug\net8.0-windows\Cell_a30ik3rw_wpftmp.GeneratedMSBuildEditorConfig.editorconfig", "Properties", 0, 0, 0, 0, 21, 0, 1, 22
"c:\Users\chris\source\repos\Cell\Cell\obj\Debug\net8.0-windows\Cell_a30ik3rw_wpftmp.GlobalUsings.g.cs", "C#", 5, 0, 0, 0, 0, 1, 1, 7
"c:\Users\chris\source\repos\Cell\Cell\obj\Debug\net8.0-windows\Cell_a30ik3rw_wpftmp.sourcelink.json", "JSON", 0, 0, 0, 1, 0, 0, 0, 1
"c:\Users\chris\source\repos\Cell\Cell\obj\Debug\net8.0-windows\Cell_a3gklh3f_wpftmp.AssemblyInfo.cs", "C#", 11, 0, 0, 0, 0, 10, 5, 26
"c:\Users\chris\source\repos\Cell\Cell\obj\Debug\net8.0-windows\Cell_a3gklh3f_wpftmp.GeneratedMSBuildEditorConfig.editorconfig", "Properties", 0, 0, 0, 0, 21, 0, 1, 22
"c:\Users\chris\source\repos\Cell\Cell\obj\Debug\net8.0-windows\Cell_a3gklh3f_wpftmp.GlobalUsings.g.cs", "C#", 5, 0, 0, 0, 0, 1, 1, 7
"c:\Users\chris\source\repos\Cell\Cell\obj\Debug\net8.0-windows\Cell_a3gklh3f_wpftmp.sourcelink.json", "JSON", 0, 0, 0, 1, 0, 0, 0, 1
"c:\Users\chris\source\repos\Cell\Cell\obj\Debug\net8.0-windows\Cell_a43ebglj_wpftmp.AssemblyInfo.cs", "C#", 11, 0, 0, 0, 0, 10, 5, 26
"c:\Users\chris\source\repos\Cell\Cell\obj\Debug\net8.0-windows\Cell_a43ebglj_wpftmp.GeneratedMSBuildEditorConfig.editorconfig", "Properties", 0, 0, 0, 0, 21, 0, 1, 22
"c:\Users\chris\source\repos\Cell\Cell\obj\Debug\net8.0-windows\Cell_a43ebglj_wpftmp.GlobalUsings.g.cs", "C#", 5, 0, 0, 0, 0, 1, 1, 7
"c:\Users\chris\source\repos\Cell\Cell\obj\Debug\net8.0-windows\Cell_a43ebglj_wpftmp.sourcelink.json", "JSON", 0, 0, 0, 1, 0, 0, 0, 1
"c:\Users\chris\source\repos\Cell\Cell\obj\Debug\net8.0-windows\Cell_aajozw4e_wpftmp.AssemblyInfo.cs", "C#", 11, 0, 0, 0, 0, 10, 5, 26
"c:\Users\chris\source\repos\Cell\Cell\obj\Debug\net8.0-windows\Cell_aajozw4e_wpftmp.GeneratedMSBuildEditorConfig.editorconfig", "Properties", 0, 0, 0, 0, 21, 0, 1, 22
"c:\Users\chris\source\repos\Cell\Cell\obj\Debug\net8.0-windows\Cell_aajozw4e_wpftmp.GlobalUsings.g.cs", "C#", 5, 0, 0, 0, 0, 1, 1, 7
"c:\Users\chris\source\repos\Cell\Cell\obj\Debug\net8.0-windows\Cell_aajozw4e_wpftmp.sourcelink.json", "JSON", 0, 0, 0, 1, 0, 0, 0, 1
"c:\Users\chris\source\repos\Cell\Cell\obj\Debug\net8.0-windows\Cell_aat3ph0k_wpftmp.AssemblyInfo.cs", "C#", 11, 0, 0, 0, 0, 10, 5, 26
"c:\Users\chris\source\repos\Cell\Cell\obj\Debug\net8.0-windows\Cell_aat3ph0k_wpftmp.GeneratedMSBuildEditorConfig.editorconfig", "Properties", 0, 0, 0, 0, 21, 0, 1, 22
"c:\Users\chris\source\repos\Cell\Cell\obj\Debug\net8.0-windows\Cell_aat3ph0k_wpftmp.GlobalUsings.g.cs", "C#", 5, 0, 0, 0, 0, 1, 1, 7
"c:\Users\chris\source\repos\Cell\Cell\obj\Debug\net8.0-windows\Cell_aat3ph0k_wpftmp.sourcelink.json", "JSON", 0, 0, 0, 1, 0, 0, 0, 1
"c:\Users\chris\source\repos\Cell\Cell\obj\Debug\net8.0-windows\Cell_abs0laea_wpftmp.AssemblyInfo.cs", "C#", 11, 0, 0, 0, 0, 10, 5, 26
"c:\Users\chris\source\repos\Cell\Cell\obj\Debug\net8.0-windows\Cell_abs0laea_wpftmp.GeneratedMSBuildEditorConfig.editorconfig", "Properties", 0, 0, 0, 0, 13, 0, 1, 14
"c:\Users\chris\source\repos\Cell\Cell\obj\Debug\net8.0-windows\Cell_abs0laea_wpftmp.GlobalUsings.g.cs", "C#", 5, 0, 0, 0, 0, 1, 1, 7
"c:\Users\chris\source\repos\Cell\Cell\obj\Debug\net8.0-windows\Cell_ac42cthz_wpftmp.AssemblyInfo.cs", "C#", 11, 0, 0, 0, 0, 10, 5, 26
"c:\Users\chris\source\repos\Cell\Cell\obj\Debug\net8.0-windows\Cell_ac42cthz_wpftmp.GeneratedMSBuildEditorConfig.editorconfig", "Properties", 0, 0, 0, 0, 21, 0, 1, 22
"c:\Users\chris\source\repos\Cell\Cell\obj\Debug\net8.0-windows\Cell_ac42cthz_wpftmp.GlobalUsings.g.cs", "C#", 5, 0, 0, 0, 0, 1, 1, 7
"c:\Users\chris\source\repos\Cell\Cell\obj\Debug\net8.0-windows\Cell_ac42cthz_wpftmp.sourcelink.json", "JSON", 0, 0, 0, 1, 0, 0, 0, 1
"c:\Users\chris\source\repos\Cell\Cell\obj\Debug\net8.0-windows\Cell_acjo3oiu_wpftmp.AssemblyInfo.cs", "C#", 11, 0, 0, 0, 0, 10, 5, 26
"c:\Users\chris\source\repos\Cell\Cell\obj\Debug\net8.0-windows\Cell_acjo3oiu_wpftmp.GeneratedMSBuildEditorConfig.editorconfig", "Properties", 0, 0, 0, 0, 13, 0, 1, 14
"c:\Users\chris\source\repos\Cell\Cell\obj\Debug\net8.0-windows\Cell_acjo3oiu_wpftmp.GlobalUsings.g.cs", "C#", 5, 0, 0, 0, 0, 1, 1, 7
"c:\Users\chris\source\repos\Cell\Cell\obj\Debug\net8.0-windows\Cell_acnpv5c4_wpftmp.AssemblyInfo.cs", "C#", 11, 0, 0, 0, 0, 10, 5, 26
"c:\Users\chris\source\repos\Cell\Cell\obj\Debug\net8.0-windows\Cell_acnpv5c4_wpftmp.GeneratedMSBuildEditorConfig.editorconfig", "Properties", 0, 0, 0, 0, 21, 0, 1, 22
"c:\Users\chris\source\repos\Cell\Cell\obj\Debug\net8.0-windows\Cell_acnpv5c4_wpftmp.GlobalUsings.g.cs", "C#", 5, 0, 0, 0, 0, 1, 1, 7
"c:\Users\chris\source\repos\Cell\Cell\obj\Debug\net8.0-windows\Cell_acnpv5c4_wpftmp.sourcelink.json", "JSON", 0, 0, 0, 1, 0, 0, 0, 1
"c:\Users\chris\source\repos\Cell\Cell\obj\Debug\net8.0-windows\Cell_aejvlc0t_wpftmp.AssemblyInfo.cs", "C#", 11, 0, 0, 0, 0, 10, 5, 26
"c:\Users\chris\source\repos\Cell\Cell\obj\Debug\net8.0-windows\Cell_aejvlc0t_wpftmp.GeneratedMSBuildEditorConfig.editorconfig", "Properties", 0, 0, 0, 0, 13, 0, 1, 14
"c:\Users\chris\source\repos\Cell\Cell\obj\Debug\net8.0-windows\Cell_aejvlc0t_wpftmp.GlobalUsings.g.cs", "C#", 5, 0, 0, 0, 0, 1, 1, 7
"c:\Users\chris\source\repos\Cell\Cell\obj\Debug\net8.0-windows\Cell_afa2hpnp_wpftmp.AssemblyInfo.cs", "C#", 11, 0, 0, 0, 0, 10, 5, 26
"c:\Users\chris\source\repos\Cell\Cell\obj\Debug\net8.0-windows\Cell_afa2hpnp_wpftmp.GeneratedMSBuildEditorConfig.editorconfig", "Properties", 0, 0, 0, 0, 21, 0, 1, 22
"c:\Users\chris\source\repos\Cell\Cell\obj\Debug\net8.0-windows\Cell_afa2hpnp_wpftmp.GlobalUsings.g.cs", "C#", 5, 0, 0, 0, 0, 1, 1, 7
"c:\Users\chris\source\repos\Cell\Cell\obj\Debug\net8.0-windows\Cell_afa2hpnp_wpftmp.sourcelink.json", "JSON", 0, 0, 0, 1, 0, 0, 0, 1
"c:\Users\chris\source\repos\Cell\Cell\obj\Debug\net8.0-windows\Cell_aggobolx_wpftmp.AssemblyInfo.cs", "C#", 11, 0, 0, 0, 0, 10, 5, 26
"c:\Users\chris\source\repos\Cell\Cell\obj\Debug\net8.0-windows\Cell_aggobolx_wpftmp.GeneratedMSBuildEditorConfig.editorconfig", "Properties", 0, 0, 0, 0, 21, 0, 1, 22
"c:\Users\chris\source\repos\Cell\Cell\obj\Debug\net8.0-windows\Cell_aggobolx_wpftmp.GlobalUsings.g.cs", "C#", 5, 0, 0, 0, 0, 1, 1, 7
"c:\Users\chris\source\repos\Cell\Cell\obj\Debug\net8.0-windows\Cell_aggobolx_wpftmp.sourcelink.json", "JSON", 0, 0, 0, 1, 0, 0, 0, 1
"c:\Users\chris\source\repos\Cell\Cell\obj\Debug\net8.0-windows\Cell_aidut5c4_wpftmp.AssemblyInfo.cs", "C#", 11, 0, 0, 0, 0, 10, 5, 26
"c:\Users\chris\source\repos\Cell\Cell\obj\Debug\net8.0-windows\Cell_aidut5c4_wpftmp.GeneratedMSBuildEditorConfig.editorconfig", "Properties", 0, 0, 0, 0, 21, 0, 1, 22
"c:\Users\chris\source\repos\Cell\Cell\obj\Debug\net8.0-windows\Cell_aidut5c4_wpftmp.GlobalUsings.g.cs", "C#", 5, 0, 0, 0, 0, 1, 1, 7
"c:\Users\chris\source\repos\Cell\Cell\obj\Debug\net8.0-windows\Cell_aidut5c4_wpftmp.sourcelink.json", "JSON", 0, 0, 0, 1, 0, 0, 0, 1
"c:\Users\chris\source\repos\Cell\Cell\obj\Debug\net8.0-windows\Cell_aiu0ynmy_wpftmp.AssemblyInfo.cs", "C#", 11, 0, 0, 0, 0, 10, 5, 26
"c:\Users\chris\source\repos\Cell\Cell\obj\Debug\net8.0-windows\Cell_aiu0ynmy_wpftmp.GeneratedMSBuildEditorConfig.editorconfig", "Properties", 0, 0, 0, 0, 21, 0, 1, 22
"c:\Users\chris\source\repos\Cell\Cell\obj\Debug\net8.0-windows\Cell_aiu0ynmy_wpftmp.GlobalUsings.g.cs", "C#", 5, 0, 0, 0, 0, 1, 1, 7
"c:\Users\chris\source\repos\Cell\Cell\obj\Debug\net8.0-windows\Cell_aiu0ynmy_wpftmp.sourcelink.json", "JSON", 0, 0, 0, 1, 0, 0, 0, 1
"c:\Users\chris\source\repos\Cell\Cell\obj\Debug\net8.0-windows\Cell_aj3c5mih_wpftmp.AssemblyInfo.cs", "C#", 11, 0, 0, 0, 0, 10, 5, 26
"c:\Users\chris\source\repos\Cell\Cell\obj\Debug\net8.0-windows\Cell_aj3c5mih_wpftmp.GeneratedMSBuildEditorConfig.editorconfig", "Properties", 0, 0, 0, 0, 21, 0, 1, 22
"c:\Users\chris\source\repos\Cell\Cell\obj\Debug\net8.0-windows\Cell_aj3c5mih_wpftmp.GlobalUsings.g.cs", "C#", 5, 0, 0, 0, 0, 1, 1, 7
"c:\Users\chris\source\repos\Cell\Cell\obj\Debug\net8.0-windows\Cell_aj3c5mih_wpftmp.sourcelink.json", "JSON", 0, 0, 0, 1, 0, 0, 0, 1
"c:\Users\chris\source\repos\Cell\Cell\obj\Debug\net8.0-windows\Cell_ajzvppjl_wpftmp.AssemblyInfo.cs", "C#", 11, 0, 0, 0, 0, 10, 5, 26
"c:\Users\chris\source\repos\Cell\Cell\obj\Debug\net8.0-windows\Cell_ajzvppjl_wpftmp.GeneratedMSBuildEditorConfig.editorconfig", "Properties", 0, 0, 0, 0, 13, 0, 1, 14
"c:\Users\chris\source\repos\Cell\Cell\obj\Debug\net8.0-windows\Cell_ajzvppjl_wpftmp.GlobalUsings.g.cs", "C#", 5, 0, 0, 0, 0, 1, 1, 7
"c:\Users\chris\source\repos\Cell\Cell\obj\Debug\net8.0-windows\Cell_akafwk12_wpftmp.AssemblyInfo.cs", "C#", 11, 0, 0, 0, 0, 10, 5, 26
"c:\Users\chris\source\repos\Cell\Cell\obj\Debug\net8.0-windows\Cell_akafwk12_wpftmp.GeneratedMSBuildEditorConfig.editorconfig", "Properties", 0, 0, 0, 0, 13, 0, 1, 14
"c:\Users\chris\source\repos\Cell\Cell\obj\Debug\net8.0-windows\Cell_akafwk12_wpftmp.GlobalUsings.g.cs", "C#", 5, 0, 0, 0, 0, 1, 1, 7
"c:\Users\chris\source\repos\Cell\Cell\obj\Debug\net8.0-windows\Cell_ake10xml_wpftmp.AssemblyInfo.cs", "C#", 11, 0, 0, 0, 0, 10, 5, 26
"c:\Users\chris\source\repos\Cell\Cell\obj\Debug\net8.0-windows\Cell_ake10xml_wpftmp.GeneratedMSBuildEditorConfig.editorconfig", "Properties", 0, 0, 0, 0, 21, 0, 1, 22
"c:\Users\chris\source\repos\Cell\Cell\obj\Debug\net8.0-windows\Cell_ake10xml_wpftmp.GlobalUsings.g.cs", "C#", 5, 0, 0, 0, 0, 1, 1, 7
"c:\Users\chris\source\repos\Cell\Cell\obj\Debug\net8.0-windows\Cell_ake10xml_wpftmp.sourcelink.json", "JSON", 0, 0, 0, 1, 0, 0, 0, 1
"c:\Users\chris\source\repos\Cell\Cell\obj\Debug\net8.0-windows\Cell_akekv0al_wpftmp.AssemblyInfo.cs", "C#", 11, 0, 0, 0, 0, 10, 5, 26
"c:\Users\chris\source\repos\Cell\Cell\obj\Debug\net8.0-windows\Cell_akekv0al_wpftmp.GeneratedMSBuildEditorConfig.editorconfig", "Properties", 0, 0, 0, 0, 21, 0, 1, 22
"c:\Users\chris\source\repos\Cell\Cell\obj\Debug\net8.0-windows\Cell_akekv0al_wpftmp.GlobalUsings.g.cs", "C#", 5, 0, 0, 0, 0, 1, 1, 7
"c:\Users\chris\source\repos\Cell\Cell\obj\Debug\net8.0-windows\Cell_akekv0al_wpftmp.sourcelink.json", "JSON", 0, 0, 0, 1, 0, 0, 0, 1
"c:\Users\chris\source\repos\Cell\Cell\obj\Debug\net8.0-windows\Cell_akhs41kk_wpftmp.AssemblyInfo.cs", "C#", 11, 0, 0, 0, 0, 10, 5, 26
"c:\Users\chris\source\repos\Cell\Cell\obj\Debug\net8.0-windows\Cell_akhs41kk_wpftmp.GeneratedMSBuildEditorConfig.editorconfig", "Properties", 0, 0, 0, 0, 21, 0, 1, 22
"c:\Users\chris\source\repos\Cell\Cell\obj\Debug\net8.0-windows\Cell_akhs41kk_wpftmp.GlobalUsings.g.cs", "C#", 5, 0, 0, 0, 0, 1, 1, 7
"c:\Users\chris\source\repos\Cell\Cell\obj\Debug\net8.0-windows\Cell_akhs41kk_wpftmp.sourcelink.json", "JSON", 0, 0, 0, 1, 0, 0, 0, 1
"c:\Users\chris\source\repos\Cell\Cell\obj\Debug\net8.0-windows\Cell_al2jdndc_wpftmp.AssemblyInfo.cs", "C#", 11, 0, 0, 0, 0, 10, 5, 26
"c:\Users\chris\source\repos\Cell\Cell\obj\Debug\net8.0-windows\Cell_al2jdndc_wpftmp.GeneratedMSBuildEditorConfig.editorconfig", "Properties", 0, 0, 0, 0, 21, 0, 1, 22
"c:\Users\chris\source\repos\Cell\Cell\obj\Debug\net8.0-windows\Cell_al2jdndc_wpftmp.GlobalUsings.g.cs", "C#", 5, 0, 0, 0, 0, 1, 1, 7
"c:\Users\chris\source\repos\Cell\Cell\obj\Debug\net8.0-windows\Cell_al2jdndc_wpftmp.sourcelink.json", "JSON", 0, 0, 0, 1, 0, 0, 0, 1
"c:\Users\chris\source\repos\Cell\Cell\obj\Debug\net8.0-windows\Cell_alw0oaqr_wpftmp.AssemblyInfo.cs", "C#", 11, 0, 0, 0, 0, 10, 5, 26
"c:\Users\chris\source\repos\Cell\Cell\obj\Debug\net8.0-windows\Cell_alw0oaqr_wpftmp.GeneratedMSBuildEditorConfig.editorconfig", "Properties", 0, 0, 0, 0, 21, 0, 1, 22
"c:\Users\chris\source\repos\Cell\Cell\obj\Debug\net8.0-windows\Cell_alw0oaqr_wpftmp.GlobalUsings.g.cs", "C#", 5, 0, 0, 0, 0, 1, 1, 7
"c:\Users\chris\source\repos\Cell\Cell\obj\Debug\net8.0-windows\Cell_alw0oaqr_wpftmp.sourcelink.json", "JSON", 0, 0, 0, 1, 0, 0, 0, 1
"c:\Users\chris\source\repos\Cell\Cell\obj\Debug\net8.0-windows\Cell_amkqytkq_wpftmp.AssemblyInfo.cs", "C#", 11, 0, 0, 0, 0, 10, 5, 26
"c:\Users\chris\source\repos\Cell\Cell\obj\Debug\net8.0-windows\Cell_amkqytkq_wpftmp.GeneratedMSBuildEditorConfig.editorconfig", "Properties", 0, 0, 0, 0, 21, 0, 1, 22
"c:\Users\chris\source\repos\Cell\Cell\obj\Debug\net8.0-windows\Cell_amkqytkq_wpftmp.GlobalUsings.g.cs", "C#", 5, 0, 0, 0, 0, 1, 1, 7
"c:\Users\chris\source\repos\Cell\Cell\obj\Debug\net8.0-windows\Cell_amkqytkq_wpftmp.sourcelink.json", "JSON", 0, 0, 0, 1, 0, 0, 0, 1
"c:\Users\chris\source\repos\Cell\Cell\obj\Debug\net8.0-windows\Cell_an1w3udd_wpftmp.AssemblyInfo.cs", "C#", 11, 0, 0, 0, 0, 10, 5, 26
"c:\Users\chris\source\repos\Cell\Cell\obj\Debug\net8.0-windows\Cell_an1w3udd_wpftmp.GeneratedMSBuildEditorConfig.editorconfig", "Properties", 0, 0, 0, 0, 13, 0, 1, 14
"c:\Users\chris\source\repos\Cell\Cell\obj\Debug\net8.0-windows\Cell_an1w3udd_wpftmp.GlobalUsings.g.cs", "C#", 5, 0, 0, 0, 0, 1, 1, 7
"c:\Users\chris\source\repos\Cell\Cell\obj\Debug\net8.0-windows\Cell_ansu4d0d_wpftmp.AssemblyInfo.cs", "C#", 11, 0, 0, 0, 0, 10, 5, 26
"c:\Users\chris\source\repos\Cell\Cell\obj\Debug\net8.0-windows\Cell_ansu4d0d_wpftmp.GeneratedMSBuildEditorConfig.editorconfig", "Properties", 0, 0, 0, 0, 21, 0, 1, 22
"c:\Users\chris\source\repos\Cell\Cell\obj\Debug\net8.0-windows\Cell_ansu4d0d_wpftmp.GlobalUsings.g.cs", "C#", 5, 0, 0, 0, 0, 1, 1, 7
"c:\Users\chris\source\repos\Cell\Cell\obj\Debug\net8.0-windows\Cell_ansu4d0d_wpftmp.sourcelink.json", "JSON", 0, 0, 0, 1, 0, 0, 0, 1
"c:\Users\chris\source\repos\Cell\Cell\obj\Debug\net8.0-windows\Cell_anuhb35d_wpftmp.AssemblyInfo.cs", "C#", 11, 0, 0, 0, 0, 10, 5, 26
"c:\Users\chris\source\repos\Cell\Cell\obj\Debug\net8.0-windows\Cell_anuhb35d_wpftmp.GeneratedMSBuildEditorConfig.editorconfig", "Properties", 0, 0, 0, 0, 21, 0, 1, 22
"c:\Users\chris\source\repos\Cell\Cell\obj\Debug\net8.0-windows\Cell_anuhb35d_wpftmp.GlobalUsings.g.cs", "C#", 5, 0, 0, 0, 0, 1, 1, 7
"c:\Users\chris\source\repos\Cell\Cell\obj\Debug\net8.0-windows\Cell_anuhb35d_wpftmp.sourcelink.json", "JSON", 0, 0, 0, 1, 0, 0, 0, 1
"c:\Users\chris\source\repos\Cell\Cell\obj\Debug\net8.0-windows\Cell_aoewnvbe_wpftmp.AssemblyInfo.cs", "C#", 11, 0, 0, 0, 0, 10, 5, 26
"c:\Users\chris\source\repos\Cell\Cell\obj\Debug\net8.0-windows\Cell_aoewnvbe_wpftmp.GeneratedMSBuildEditorConfig.editorconfig", "Properties", 0, 0, 0, 0, 21, 0, 1, 22
"c:\Users\chris\source\repos\Cell\Cell\obj\Debug\net8.0-windows\Cell_aoewnvbe_wpftmp.GlobalUsings.g.cs", "C#", 5, 0, 0, 0, 0, 1, 1, 7
"c:\Users\chris\source\repos\Cell\Cell\obj\Debug\net8.0-windows\Cell_aoewnvbe_wpftmp.sourcelink.json", "JSON", 0, 0, 0, 1, 0, 0, 0, 1
"c:\Users\chris\source\repos\Cell\Cell\obj\Debug\net8.0-windows\Cell_aorrbtrl_wpftmp.AssemblyInfo.cs", "C#", 11, 0, 0, 0, 0, 10, 5, 26
"c:\Users\chris\source\repos\Cell\Cell\obj\Debug\net8.0-windows\Cell_aorrbtrl_wpftmp.GeneratedMSBuildEditorConfig.editorconfig", "Properties", 0, 0, 0, 0, 21, 0, 1, 22
"c:\Users\chris\source\repos\Cell\Cell\obj\Debug\net8.0-windows\Cell_aorrbtrl_wpftmp.GlobalUsings.g.cs", "C#", 5, 0, 0, 0, 0, 1, 1, 7
"c:\Users\chris\source\repos\Cell\Cell\obj\Debug\net8.0-windows\Cell_aorrbtrl_wpftmp.sourcelink.json", "JSON", 0, 0, 0, 1, 0, 0, 0, 1
"c:\Users\chris\source\repos\Cell\Cell\obj\Debug\net8.0-windows\Cell_aqpqocpv_wpftmp.AssemblyInfo.cs", "C#", 11, 0, 0, 0, 0, 10, 5, 26
"c:\Users\chris\source\repos\Cell\Cell\obj\Debug\net8.0-windows\Cell_aqpqocpv_wpftmp.GeneratedMSBuildEditorConfig.editorconfig", "Properties", 0, 0, 0, 0, 21, 0, 1, 22
"c:\Users\chris\source\repos\Cell\Cell\obj\Debug\net8.0-windows\Cell_aqpqocpv_wpftmp.GlobalUsings.g.cs", "C#", 5, 0, 0, 0, 0, 1, 1, 7
"c:\Users\chris\source\repos\Cell\Cell\obj\Debug\net8.0-windows\Cell_aqpqocpv_wpftmp.sourcelink.json", "JSON", 0, 0, 0, 1, 0, 0, 0, 1
"c:\Users\chris\source\repos\Cell\Cell\obj\Debug\net8.0-windows\Cell_aqxxoaer_wpftmp.AssemblyInfo.cs", "C#", 11, 0, 0, 0, 0, 10, 5, 26
"c:\Users\chris\source\repos\Cell\Cell\obj\Debug\net8.0-windows\Cell_aqxxoaer_wpftmp.GeneratedMSBuildEditorConfig.editorconfig", "Properties", 0, 0, 0, 0, 13, 0, 1, 14
"c:\Users\chris\source\repos\Cell\Cell\obj\Debug\net8.0-windows\Cell_aqxxoaer_wpftmp.GlobalUsings.g.cs", "C#", 5, 0, 0, 0, 0, 1, 1, 7
"c:\Users\chris\source\repos\Cell\Cell\obj\Debug\net8.0-windows\Cell_aropef1i_wpftmp.AssemblyInfo.cs", "C#", 11, 0, 0, 0, 0, 10, 5, 26
"c:\Users\chris\source\repos\Cell\Cell\obj\Debug\net8.0-windows\Cell_aropef1i_wpftmp.GeneratedMSBuildEditorConfig.editorconfig", "Properties", 0, 0, 0, 0, 21, 0, 1, 22
"c:\Users\chris\source\repos\Cell\Cell\obj\Debug\net8.0-windows\Cell_aropef1i_wpftmp.GlobalUsings.g.cs", "C#", 5, 0, 0, 0, 0, 1, 1, 7
"c:\Users\chris\source\repos\Cell\Cell\obj\Debug\net8.0-windows\Cell_aropef1i_wpftmp.sourcelink.json", "JSON", 0, 0, 0, 1, 0, 0, 0, 1
"c:\Users\chris\source\repos\Cell\Cell\obj\Debug\net8.0-windows\Cell_arozo4ai_wpftmp.AssemblyInfo.cs", "C#", 11, 0, 0, 0, 0, 10, 5, 26
"c:\Users\chris\source\repos\Cell\Cell\obj\Debug\net8.0-windows\Cell_arozo4ai_wpftmp.GeneratedMSBuildEditorConfig.editorconfig", "Properties", 0, 0, 0, 0, 21, 0, 1, 22
"c:\Users\chris\source\repos\Cell\Cell\obj\Debug\net8.0-windows\Cell_arozo4ai_wpftmp.GlobalUsings.g.cs", "C#", 5, 0, 0, 0, 0, 1, 1, 7
"c:\Users\chris\source\repos\Cell\Cell\obj\Debug\net8.0-windows\Cell_arozo4ai_wpftmp.sourcelink.json", "JSON", 0, 0, 0, 1, 0, 0, 0, 1
"c:\Users\chris\source\repos\Cell\Cell\obj\Debug\net8.0-windows\Cell_as2ftf30_wpftmp.AssemblyInfo.cs", "C#", 11, 0, 0, 0, 0, 10, 5, 26
"c:\Users\chris\source\repos\Cell\Cell\obj\Debug\net8.0-windows\Cell_as2ftf30_wpftmp.GeneratedMSBuildEditorConfig.editorconfig", "Properties", 0, 0, 0, 0, 21, 0, 1, 22
"c:\Users\chris\source\repos\Cell\Cell\obj\Debug\net8.0-windows\Cell_as2ftf30_wpftmp.GlobalUsings.g.cs", "C#", 5, 0, 0, 0, 0, 1, 1, 7
"c:\Users\chris\source\repos\Cell\Cell\obj\Debug\net8.0-windows\Cell_as2ftf30_wpftmp.sourcelink.json", "JSON", 0, 0, 0, 1, 0, 0, 0, 1
"c:\Users\chris\source\repos\Cell\Cell\obj\Debug\net8.0-windows\Cell_asbh25fq_wpftmp.AssemblyInfo.cs", "C#", 11, 0, 0, 0, 0, 10, 5, 26
"c:\Users\chris\source\repos\Cell\Cell\obj\Debug\net8.0-windows\Cell_asbh25fq_wpftmp.GeneratedMSBuildEditorConfig.editorconfig", "Properties", 0, 0, 0, 0, 13, 0, 1, 14
"c:\Users\chris\source\repos\Cell\Cell\obj\Debug\net8.0-windows\Cell_asbh25fq_wpftmp.GlobalUsings.g.cs", "C#", 5, 0, 0, 0, 0, 1, 1, 7
"c:\Users\chris\source\repos\Cell\Cell\obj\Debug\net8.0-windows\Cell_asrndtyz_wpftmp.AssemblyInfo.cs", "C#", 11, 0, 0, 0, 0, 10, 5, 26
"c:\Users\chris\source\repos\Cell\Cell\obj\Debug\net8.0-windows\Cell_asrndtyz_wpftmp.GeneratedMSBuildEditorConfig.editorconfig", "Properties", 0, 0, 0, 0, 21, 0, 1, 22
"c:\Users\chris\source\repos\Cell\Cell\obj\Debug\net8.0-windows\Cell_asrndtyz_wpftmp.GlobalUsings.g.cs", "C#", 5, 0, 0, 0, 0, 1, 1, 7
"c:\Users\chris\source\repos\Cell\Cell\obj\Debug\net8.0-windows\Cell_asrndtyz_wpftmp.sourcelink.json", "JSON", 0, 0, 0, 1, 0, 0, 0, 1
"c:\Users\chris\source\repos\Cell\Cell\obj\Debug\net8.0-windows\Cell_at3o0atd_wpftmp.AssemblyInfo.cs", "C#", 11, 0, 0, 0, 0, 10, 5, 26
"c:\Users\chris\source\repos\Cell\Cell\obj\Debug\net8.0-windows\Cell_at3o0atd_wpftmp.GeneratedMSBuildEditorConfig.editorconfig", "Properties", 0, 0, 0, 0, 21, 0, 1, 22
"c:\Users\chris\source\repos\Cell\Cell\obj\Debug\net8.0-windows\Cell_at3o0atd_wpftmp.GlobalUsings.g.cs", "C#", 5, 0, 0, 0, 0, 1, 1, 7
"c:\Users\chris\source\repos\Cell\Cell\obj\Debug\net8.0-windows\Cell_at3o0atd_wpftmp.sourcelink.json", "JSON", 0, 0, 0, 1, 0, 0, 0, 1
"c:\Users\chris\source\repos\Cell\Cell\obj\Debug\net8.0-windows\Cell_au3hjqez_wpftmp.AssemblyInfo.cs", "C#", 11, 0, 0, 0, 0, 10, 5, 26
"c:\Users\chris\source\repos\Cell\Cell\obj\Debug\net8.0-windows\Cell_au3hjqez_wpftmp.GeneratedMSBuildEditorConfig.editorconfig", "Properties", 0, 0, 0, 0, 21, 0, 1, 22
"c:\Users\chris\source\repos\Cell\Cell\obj\Debug\net8.0-windows\Cell_au3hjqez_wpftmp.GlobalUsings.g.cs", "C#", 5, 0, 0, 0, 0, 1, 1, 7
"c:\Users\chris\source\repos\Cell\Cell\obj\Debug\net8.0-windows\Cell_au3hjqez_wpftmp.sourcelink.json", "JSON", 0, 0, 0, 1, 0, 0, 0, 1
"c:\Users\chris\source\repos\Cell\Cell\obj\Debug\net8.0-windows\Cell_audmxxjw_wpftmp.AssemblyInfo.cs", "C#", 11, 0, 0, 0, 0, 10, 5, 26
"c:\Users\chris\source\repos\Cell\Cell\obj\Debug\net8.0-windows\Cell_audmxxjw_wpftmp.GeneratedMSBuildEditorConfig.editorconfig", "Properties", 0, 0, 0, 0, 21, 0, 1, 22
"c:\Users\chris\source\repos\Cell\Cell\obj\Debug\net8.0-windows\Cell_audmxxjw_wpftmp.GlobalUsings.g.cs", "C#", 5, 0, 0, 0, 0, 1, 1, 7
"c:\Users\chris\source\repos\Cell\Cell\obj\Debug\net8.0-windows\Cell_audmxxjw_wpftmp.sourcelink.json", "JSON", 0, 0, 0, 1, 0, 0, 0, 1
"c:\Users\chris\source\repos\Cell\Cell\obj\Debug\net8.0-windows\Cell_auhkjhzu_wpftmp.AssemblyInfo.cs", "C#", 11, 0, 0, 0, 0, 10, 5, 26
"c:\Users\chris\source\repos\Cell\Cell\obj\Debug\net8.0-windows\Cell_auhkjhzu_wpftmp.GeneratedMSBuildEditorConfig.editorconfig", "Properties", 0, 0, 0, 0, 21, 0, 1, 22
"c:\Users\chris\source\repos\Cell\Cell\obj\Debug\net8.0-windows\Cell_auhkjhzu_wpftmp.GlobalUsings.g.cs", "C#", 5, 0, 0, 0, 0, 1, 1, 7
"c:\Users\chris\source\repos\Cell\Cell\obj\Debug\net8.0-windows\Cell_auhkjhzu_wpftmp.sourcelink.json", "JSON", 0, 0, 0, 1, 0, 0, 0, 1
"c:\Users\chris\source\repos\Cell\Cell\obj\Debug\net8.0-windows\Cell_awm3r4kd_wpftmp.AssemblyInfo.cs", "C#", 11, 0, 0, 0, 0, 10, 5, 26
"c:\Users\chris\source\repos\Cell\Cell\obj\Debug\net8.0-windows\Cell_awm3r4kd_wpftmp.GeneratedMSBuildEditorConfig.editorconfig", "Properties", 0, 0, 0, 0, 21, 0, 1, 22
"c:\Users\chris\source\repos\Cell\Cell\obj\Debug\net8.0-windows\Cell_awm3r4kd_wpftmp.GlobalUsings.g.cs", "C#", 5, 0, 0, 0, 0, 1, 1, 7
"c:\Users\chris\source\repos\Cell\Cell\obj\Debug\net8.0-windows\Cell_awm3r4kd_wpftmp.sourcelink.json", "JSON", 0, 0, 0, 1, 0, 0, 0, 1
"c:\Users\chris\source\repos\Cell\Cell\obj\Debug\net8.0-windows\Cell_axyiqakn_wpftmp.AssemblyInfo.cs", "C#", 11, 0, 0, 0, 0, 10, 5, 26
"c:\Users\chris\source\repos\Cell\Cell\obj\Debug\net8.0-windows\Cell_axyiqakn_wpftmp.GeneratedMSBuildEditorConfig.editorconfig", "Properties", 0, 0, 0, 0, 21, 0, 1, 22
"c:\Users\chris\source\repos\Cell\Cell\obj\Debug\net8.0-windows\Cell_axyiqakn_wpftmp.GlobalUsings.g.cs", "C#", 5, 0, 0, 0, 0, 1, 1, 7
"c:\Users\chris\source\repos\Cell\Cell\obj\Debug\net8.0-windows\Cell_axyiqakn_wpftmp.sourcelink.json", "JSON", 0, 0, 0, 1, 0, 0, 0, 1
"c:\Users\chris\source\repos\Cell\Cell\obj\Debug\net8.0-windows\Cell_ayfhhsmn_wpftmp.AssemblyInfo.cs", "C#", 11, 0, 0, 0, 0, 10, 5, 26
"c:\Users\chris\source\repos\Cell\Cell\obj\Debug\net8.0-windows\Cell_ayfhhsmn_wpftmp.GeneratedMSBuildEditorConfig.editorconfig", "Properties", 0, 0, 0, 0, 21, 0, 1, 22
"c:\Users\chris\source\repos\Cell\Cell\obj\Debug\net8.0-windows\Cell_ayfhhsmn_wpftmp.GlobalUsings.g.cs", "C#", 5, 0, 0, 0, 0, 1, 1, 7
"c:\Users\chris\source\repos\Cell\Cell\obj\Debug\net8.0-windows\Cell_ayfhhsmn_wpftmp.sourcelink.json", "JSON", 0, 0, 0, 1, 0, 0, 0, 1
"c:\Users\chris\source\repos\Cell\Cell\obj\Debug\net8.0-windows\Cell_az1r0cpx_wpftmp.AssemblyInfo.cs", "C#", 11, 0, 0, 0, 0, 10, 5, 26
"c:\Users\chris\source\repos\Cell\Cell\obj\Debug\net8.0-windows\Cell_az1r0cpx_wpftmp.GeneratedMSBuildEditorConfig.editorconfig", "Properties", 0, 0, 0, 0, 21, 0, 1, 22
"c:\Users\chris\source\repos\Cell\Cell\obj\Debug\net8.0-windows\Cell_az1r0cpx_wpftmp.GlobalUsings.g.cs", "C#", 5, 0, 0, 0, 0, 1, 1, 7
"c:\Users\chris\source\repos\Cell\Cell\obj\Debug\net8.0-windows\Cell_az1r0cpx_wpftmp.sourcelink.json", "JSON", 0, 0, 0, 1, 0, 0, 0, 1
"c:\Users\chris\source\repos\Cell\Cell\obj\Debug\net8.0-windows\Cell_azahk1jk_wpftmp.AssemblyInfo.cs", "C#", 11, 0, 0, 0, 0, 10, 5, 26
"c:\Users\chris\source\repos\Cell\Cell\obj\Debug\net8.0-windows\Cell_azahk1jk_wpftmp.GeneratedMSBuildEditorConfig.editorconfig", "Properties", 0, 0, 0, 0, 21, 0, 1, 22
"c:\Users\chris\source\repos\Cell\Cell\obj\Debug\net8.0-windows\Cell_azahk1jk_wpftmp.GlobalUsings.g.cs", "C#", 5, 0, 0, 0, 0, 1, 1, 7
"c:\Users\chris\source\repos\Cell\Cell\obj\Debug\net8.0-windows\Cell_azahk1jk_wpftmp.sourcelink.json", "JSON", 0, 0, 0, 1, 0, 0, 0, 1
"c:\Users\chris\source\repos\Cell\Cell\obj\Debug\net8.0-windows\Cell_azgh25ye_wpftmp.AssemblyInfo.cs", "C#", 11, 0, 0, 0, 0, 10, 5, 26
"c:\Users\chris\source\repos\Cell\Cell\obj\Debug\net8.0-windows\Cell_azgh25ye_wpftmp.GeneratedMSBuildEditorConfig.editorconfig", "Properties", 0, 0, 0, 0, 13, 0, 1, 14
"c:\Users\chris\source\repos\Cell\Cell\obj\Debug\net8.0-windows\Cell_azgh25ye_wpftmp.GlobalUsings.g.cs", "C#", 5, 0, 0, 0, 0, 1, 1, 7
"c:\Users\chris\source\repos\Cell\Cell\obj\Debug\net8.0-windows\Cell_azkunsiv_wpftmp.AssemblyInfo.cs", "C#", 11, 0, 0, 0, 0, 10, 5, 26
"c:\Users\chris\source\repos\Cell\Cell\obj\Debug\net8.0-windows\Cell_azkunsiv_wpftmp.GeneratedMSBuildEditorConfig.editorconfig", "Properties", 0, 0, 0, 0, 21, 0, 1, 22
"c:\Users\chris\source\repos\Cell\Cell\obj\Debug\net8.0-windows\Cell_azkunsiv_wpftmp.GlobalUsings.g.cs", "C#", 5, 0, 0, 0, 0, 1, 1, 7
"c:\Users\chris\source\repos\Cell\Cell\obj\Debug\net8.0-windows\Cell_azkunsiv_wpftmp.sourcelink.json", "JSON", 0, 0, 0, 1, 0, 0, 0, 1
"c:\Users\chris\source\repos\Cell\Cell\obj\Debug\net8.0-windows\Cell_azyye23s_wpftmp.AssemblyInfo.cs", "C#", 11, 0, 0, 0, 0, 10, 5, 26
"c:\Users\chris\source\repos\Cell\Cell\obj\Debug\net8.0-windows\Cell_azyye23s_wpftmp.GeneratedMSBuildEditorConfig.editorconfig", "Properties", 0, 0, 0, 0, 21, 0, 1, 22
"c:\Users\chris\source\repos\Cell\Cell\obj\Debug\net8.0-windows\Cell_azyye23s_wpftmp.GlobalUsings.g.cs", "C#", 5, 0, 0, 0, 0, 1, 1, 7
"c:\Users\chris\source\repos\Cell\Cell\obj\Debug\net8.0-windows\Cell_b1e2zhqz_wpftmp.AssemblyInfo.cs", "C#", 11, 0, 0, 0, 0, 10, 5, 26
"c:\Users\chris\source\repos\Cell\Cell\obj\Debug\net8.0-windows\Cell_b1e2zhqz_wpftmp.GeneratedMSBuildEditorConfig.editorconfig", "Properties", 0, 0, 0, 0, 21, 0, 1, 22
"c:\Users\chris\source\repos\Cell\Cell\obj\Debug\net8.0-windows\Cell_b1e2zhqz_wpftmp.GlobalUsings.g.cs", "C#", 5, 0, 0, 0, 0, 1, 1, 7
"c:\Users\chris\source\repos\Cell\Cell\obj\Debug\net8.0-windows\Cell_b1e2zhqz_wpftmp.sourcelink.json", "JSON", 0, 0, 0, 1, 0, 0, 0, 1
"c:\Users\chris\source\repos\Cell\Cell\obj\Debug\net8.0-windows\Cell_b1nsfnlp_wpftmp.AssemblyInfo.cs", "C#", 11, 0, 0, 0, 0, 10, 5, 26
"c:\Users\chris\source\repos\Cell\Cell\obj\Debug\net8.0-windows\Cell_b1nsfnlp_wpftmp.GeneratedMSBuildEditorConfig.editorconfig", "Properties", 0, 0, 0, 0, 21, 0, 1, 22
"c:\Users\chris\source\repos\Cell\Cell\obj\Debug\net8.0-windows\Cell_b1nsfnlp_wpftmp.GlobalUsings.g.cs", "C#", 5, 0, 0, 0, 0, 1, 1, 7
"c:\Users\chris\source\repos\Cell\Cell\obj\Debug\net8.0-windows\Cell_b1nsfnlp_wpftmp.sourcelink.json", "JSON", 0, 0, 0, 1, 0, 0, 0, 1
"c:\Users\chris\source\repos\Cell\Cell\obj\Debug\net8.0-windows\Cell_b23o5z4y_wpftmp.AssemblyInfo.cs", "C#", 11, 0, 0, 0, 0, 10, 5, 26
"c:\Users\chris\source\repos\Cell\Cell\obj\Debug\net8.0-windows\Cell_b23o5z4y_wpftmp.GeneratedMSBuildEditorConfig.editorconfig", "Properties", 0, 0, 0, 0, 21, 0, 1, 22
"c:\Users\chris\source\repos\Cell\Cell\obj\Debug\net8.0-windows\Cell_b23o5z4y_wpftmp.GlobalUsings.g.cs", "C#", 5, 0, 0, 0, 0, 1, 1, 7
"c:\Users\chris\source\repos\Cell\Cell\obj\Debug\net8.0-windows\Cell_b23o5z4y_wpftmp.sourcelink.json", "JSON", 0, 0, 0, 1, 0, 0, 0, 1
"c:\Users\chris\source\repos\Cell\Cell\obj\Debug\net8.0-windows\Cell_b3b0wcsq_wpftmp.AssemblyInfo.cs", "C#", 11, 0, 0, 0, 0, 10, 5, 26
"c:\Users\chris\source\repos\Cell\Cell\obj\Debug\net8.0-windows\Cell_b3b0wcsq_wpftmp.GeneratedMSBuildEditorConfig.editorconfig", "Properties", 0, 0, 0, 0, 21, 0, 1, 22
"c:\Users\chris\source\repos\Cell\Cell\obj\Debug\net8.0-windows\Cell_b3b0wcsq_wpftmp.GlobalUsings.g.cs", "C#", 5, 0, 0, 0, 0, 1, 1, 7
"c:\Users\chris\source\repos\Cell\Cell\obj\Debug\net8.0-windows\Cell_b3b0wcsq_wpftmp.sourcelink.json", "JSON", 0, 0, 0, 1, 0, 0, 0, 1
"c:\Users\chris\source\repos\Cell\Cell\obj\Debug\net8.0-windows\Cell_b3epf0xi_wpftmp.AssemblyInfo.cs", "C#", 11, 0, 0, 0, 0, 10, 5, 26
"c:\Users\chris\source\repos\Cell\Cell\obj\Debug\net8.0-windows\Cell_b3epf0xi_wpftmp.GeneratedMSBuildEditorConfig.editorconfig", "Properties", 0, 0, 0, 0, 21, 0, 1, 22
"c:\Users\chris\source\repos\Cell\Cell\obj\Debug\net8.0-windows\Cell_b3epf0xi_wpftmp.GlobalUsings.g.cs", "C#", 5, 0, 0, 0, 0, 1, 1, 7
"c:\Users\chris\source\repos\Cell\Cell\obj\Debug\net8.0-windows\Cell_b3epf0xi_wpftmp.sourcelink.json", "JSON", 0, 0, 0, 1, 0, 0, 0, 1
"c:\Users\chris\source\repos\Cell\Cell\obj\Debug\net8.0-windows\Cell_b3lovxft_wpftmp.AssemblyInfo.cs", "C#", 11, 0, 0, 0, 0, 10, 5, 26
"c:\Users\chris\source\repos\Cell\Cell\obj\Debug\net8.0-windows\Cell_b3lovxft_wpftmp.GeneratedMSBuildEditorConfig.editorconfig", "Properties", 0, 0, 0, 0, 21, 0, 1, 22
"c:\Users\chris\source\repos\Cell\Cell\obj\Debug\net8.0-windows\Cell_b3lovxft_wpftmp.GlobalUsings.g.cs", "C#", 5, 0, 0, 0, 0, 1, 1, 7
"c:\Users\chris\source\repos\Cell\Cell\obj\Debug\net8.0-windows\Cell_b43kij00_wpftmp.AssemblyInfo.cs", "C#", 11, 0, 0, 0, 0, 10, 5, 26
"c:\Users\chris\source\repos\Cell\Cell\obj\Debug\net8.0-windows\Cell_b43kij00_wpftmp.GeneratedMSBuildEditorConfig.editorconfig", "Properties", 0, 0, 0, 0, 21, 0, 1, 22
"c:\Users\chris\source\repos\Cell\Cell\obj\Debug\net8.0-windows\Cell_b43kij00_wpftmp.GlobalUsings.g.cs", "C#", 5, 0, 0, 0, 0, 1, 1, 7
"c:\Users\chris\source\repos\Cell\Cell\obj\Debug\net8.0-windows\Cell_b43kij00_wpftmp.sourcelink.json", "JSON", 0, 0, 0, 1, 0, 0, 0, 1
"c:\Users\chris\source\repos\Cell\Cell\obj\Debug\net8.0-windows\Cell_b5ustfal_wpftmp.AssemblyInfo.cs", "C#", 11, 0, 0, 0, 0, 10, 5, 26
"c:\Users\chris\source\repos\Cell\Cell\obj\Debug\net8.0-windows\Cell_b5ustfal_wpftmp.GeneratedMSBuildEditorConfig.editorconfig", "Properties", 0, 0, 0, 0, 21, 0, 1, 22
"c:\Users\chris\source\repos\Cell\Cell\obj\Debug\net8.0-windows\Cell_b5ustfal_wpftmp.GlobalUsings.g.cs", "C#", 5, 0, 0, 0, 0, 1, 1, 7
"c:\Users\chris\source\repos\Cell\Cell\obj\Debug\net8.0-windows\Cell_b5ustfal_wpftmp.sourcelink.json", "JSON", 0, 0, 0, 1, 0, 0, 0, 1
"c:\Users\chris\source\repos\Cell\Cell\obj\Debug\net8.0-windows\Cell_baosvmss_wpftmp.AssemblyInfo.cs", "C#", 11, 0, 0, 0, 0, 10, 5, 26
"c:\Users\chris\source\repos\Cell\Cell\obj\Debug\net8.0-windows\Cell_baosvmss_wpftmp.GeneratedMSBuildEditorConfig.editorconfig", "Properties", 0, 0, 0, 0, 21, 0, 1, 22
"c:\Users\chris\source\repos\Cell\Cell\obj\Debug\net8.0-windows\Cell_baosvmss_wpftmp.GlobalUsings.g.cs", "C#", 5, 0, 0, 0, 0, 1, 1, 7
"c:\Users\chris\source\repos\Cell\Cell\obj\Debug\net8.0-windows\Cell_baosvmss_wpftmp.sourcelink.json", "JSON", 0, 0, 0, 1, 0, 0, 0, 1
"c:\Users\chris\source\repos\Cell\Cell\obj\Debug\net8.0-windows\Cell_bbhcqctt_wpftmp.AssemblyInfo.cs", "C#", 11, 0, 0, 0, 0, 10, 5, 26
"c:\Users\chris\source\repos\Cell\Cell\obj\Debug\net8.0-windows\Cell_bbhcqctt_wpftmp.GeneratedMSBuildEditorConfig.editorconfig", "Properties", 0, 0, 0, 0, 21, 0, 1, 22
"c:\Users\chris\source\repos\Cell\Cell\obj\Debug\net8.0-windows\Cell_bbhcqctt_wpftmp.GlobalUsings.g.cs", "C#", 5, 0, 0, 0, 0, 1, 1, 7
"c:\Users\chris\source\repos\Cell\Cell\obj\Debug\net8.0-windows\Cell_bbhcqctt_wpftmp.sourcelink.json", "JSON", 0, 0, 0, 1, 0, 0, 0, 1
"c:\Users\chris\source\repos\Cell\Cell\obj\Debug\net8.0-windows\Cell_bbw0doqr_wpftmp.AssemblyInfo.cs", "C#", 11, 0, 0, 0, 0, 10, 5, 26
"c:\Users\chris\source\repos\Cell\Cell\obj\Debug\net8.0-windows\Cell_bbw0doqr_wpftmp.GeneratedMSBuildEditorConfig.editorconfig", "Properties", 0, 0, 0, 0, 21, 0, 1, 22
"c:\Users\chris\source\repos\Cell\Cell\obj\Debug\net8.0-windows\Cell_bbw0doqr_wpftmp.GlobalUsings.g.cs", "C#", 5, 0, 0, 0, 0, 1, 1, 7
"c:\Users\chris\source\repos\Cell\Cell\obj\Debug\net8.0-windows\Cell_bbw0doqr_wpftmp.sourcelink.json", "JSON", 0, 0, 0, 1, 0, 0, 0, 1
"c:\Users\chris\source\repos\Cell\Cell\obj\Debug\net8.0-windows\Cell_bc2p3mcy_wpftmp.AssemblyInfo.cs", "C#", 11, 0, 0, 0, 0, 10, 5, 26
"c:\Users\chris\source\repos\Cell\Cell\obj\Debug\net8.0-windows\Cell_bc2p3mcy_wpftmp.GeneratedMSBuildEditorConfig.editorconfig", "Properties", 0, 0, 0, 0, 21, 0, 1, 22
"c:\Users\chris\source\repos\Cell\Cell\obj\Debug\net8.0-windows\Cell_bc2p3mcy_wpftmp.GlobalUsings.g.cs", "C#", 5, 0, 0, 0, 0, 1, 1, 7
"c:\Users\chris\source\repos\Cell\Cell\obj\Debug\net8.0-windows\Cell_bc2p3mcy_wpftmp.sourcelink.json", "JSON", 0, 0, 0, 1, 0, 0, 0, 1
"c:\Users\chris\source\repos\Cell\Cell\obj\Debug\net8.0-windows\Cell_bcs2evbr_wpftmp.AssemblyInfo.cs", "C#", 11, 0, 0, 0, 0, 10, 5, 26
"c:\Users\chris\source\repos\Cell\Cell\obj\Debug\net8.0-windows\Cell_bcs2evbr_wpftmp.GeneratedMSBuildEditorConfig.editorconfig", "Properties", 0, 0, 0, 0, 13, 0, 1, 14
"c:\Users\chris\source\repos\Cell\Cell\obj\Debug\net8.0-windows\Cell_bcs2evbr_wpftmp.GlobalUsings.g.cs", "C#", 5, 0, 0, 0, 0, 1, 1, 7
"c:\Users\chris\source\repos\Cell\Cell\obj\Debug\net8.0-windows\Cell_bdhni31b_wpftmp.AssemblyInfo.cs", "C#", 11, 0, 0, 0, 0, 10, 5, 26
"c:\Users\chris\source\repos\Cell\Cell\obj\Debug\net8.0-windows\Cell_bdhni31b_wpftmp.GeneratedMSBuildEditorConfig.editorconfig", "Properties", 0, 0, 0, 0, 21, 0, 1, 22
"c:\Users\chris\source\repos\Cell\Cell\obj\Debug\net8.0-windows\Cell_bdhni31b_wpftmp.GlobalUsings.g.cs", "C#", 5, 0, 0, 0, 0, 1, 1, 7
"c:\Users\chris\source\repos\Cell\Cell\obj\Debug\net8.0-windows\Cell_bdhni31b_wpftmp.sourcelink.json", "JSON", 0, 0, 0, 1, 0, 0, 0, 1
"c:\Users\chris\source\repos\Cell\Cell\obj\Debug\net8.0-windows\Cell_bdxisazm_wpftmp.AssemblyInfo.cs", "C#", 11, 0, 0, 0, 0, 10, 5, 26
"c:\Users\chris\source\repos\Cell\Cell\obj\Debug\net8.0-windows\Cell_bdxisazm_wpftmp.GeneratedMSBuildEditorConfig.editorconfig", "Properties", 0, 0, 0, 0, 21, 0, 1, 22
"c:\Users\chris\source\repos\Cell\Cell\obj\Debug\net8.0-windows\Cell_bdxisazm_wpftmp.GlobalUsings.g.cs", "C#", 5, 0, 0, 0, 0, 1, 1, 7
"c:\Users\chris\source\repos\Cell\Cell\obj\Debug\net8.0-windows\Cell_bdxisazm_wpftmp.sourcelink.json", "JSON", 0, 0, 0, 1, 0, 0, 0, 1
"c:\Users\chris\source\repos\Cell\Cell\obj\Debug\net8.0-windows\Cell_bf23c4iy_wpftmp.AssemblyInfo.cs", "C#", 11, 0, 0, 0, 0, 10, 5, 26
"c:\Users\chris\source\repos\Cell\Cell\obj\Debug\net8.0-windows\Cell_bf23c4iy_wpftmp.GeneratedMSBuildEditorConfig.editorconfig", "Properties", 0, 0, 0, 0, 21, 0, 1, 22
"c:\Users\chris\source\repos\Cell\Cell\obj\Debug\net8.0-windows\Cell_bf23c4iy_wpftmp.GlobalUsings.g.cs", "C#", 5, 0, 0, 0, 0, 1, 1, 7
"c:\Users\chris\source\repos\Cell\Cell\obj\Debug\net8.0-windows\Cell_bf23c4iy_wpftmp.sourcelink.json", "JSON", 0, 0, 0, 1, 0, 0, 0, 1
"c:\Users\chris\source\repos\Cell\Cell\obj\Debug\net8.0-windows\Cell_bhkco2nx_wpftmp.AssemblyInfo.cs", "C#", 11, 0, 0, 0, 0, 10, 5, 26
"c:\Users\chris\source\repos\Cell\Cell\obj\Debug\net8.0-windows\Cell_bhkco2nx_wpftmp.GeneratedMSBuildEditorConfig.editorconfig", "Properties", 0, 0, 0, 0, 21, 0, 1, 22
"c:\Users\chris\source\repos\Cell\Cell\obj\Debug\net8.0-windows\Cell_bhkco2nx_wpftmp.GlobalUsings.g.cs", "C#", 5, 0, 0, 0, 0, 1, 1, 7
"c:\Users\chris\source\repos\Cell\Cell\obj\Debug\net8.0-windows\Cell_bhkco2nx_wpftmp.sourcelink.json", "JSON", 0, 0, 0, 1, 0, 0, 0, 1
"c:\Users\chris\source\repos\Cell\Cell\obj\Debug\net8.0-windows\Cell_bibrhvnx_wpftmp.AssemblyInfo.cs", "C#", 11, 0, 0, 0, 0, 10, 5, 26
"c:\Users\chris\source\repos\Cell\Cell\obj\Debug\net8.0-windows\Cell_bibrhvnx_wpftmp.GeneratedMSBuildEditorConfig.editorconfig", "Properties", 0, 0, 0, 0, 13, 0, 1, 14
"c:\Users\chris\source\repos\Cell\Cell\obj\Debug\net8.0-windows\Cell_bibrhvnx_wpftmp.GlobalUsings.g.cs", "C#", 5, 0, 0, 0, 0, 1, 1, 7
"c:\Users\chris\source\repos\Cell\Cell\obj\Debug\net8.0-windows\Cell_bj044y3f_wpftmp.AssemblyInfo.cs", "C#", 11, 0, 0, 0, 0, 10, 5, 26
"c:\Users\chris\source\repos\Cell\Cell\obj\Debug\net8.0-windows\Cell_bj044y3f_wpftmp.GeneratedMSBuildEditorConfig.editorconfig", "Properties", 0, 0, 0, 0, 21, 0, 1, 22
"c:\Users\chris\source\repos\Cell\Cell\obj\Debug\net8.0-windows\Cell_bj044y3f_wpftmp.GlobalUsings.g.cs", "C#", 5, 0, 0, 0, 0, 1, 1, 7
"c:\Users\chris\source\repos\Cell\Cell\obj\Debug\net8.0-windows\Cell_bj044y3f_wpftmp.sourcelink.json", "JSON", 0, 0, 0, 1, 0, 0, 0, 1
"c:\Users\chris\source\repos\Cell\Cell\obj\Debug\net8.0-windows\Cell_bjoik44h_wpftmp.AssemblyInfo.cs", "C#", 11, 0, 0, 0, 0, 10, 5, 26
"c:\Users\chris\source\repos\Cell\Cell\obj\Debug\net8.0-windows\Cell_bjoik44h_wpftmp.GeneratedMSBuildEditorConfig.editorconfig", "Properties", 0, 0, 0, 0, 21, 0, 1, 22
"c:\Users\chris\source\repos\Cell\Cell\obj\Debug\net8.0-windows\Cell_bjoik44h_wpftmp.GlobalUsings.g.cs", "C#", 5, 0, 0, 0, 0, 1, 1, 7
"c:\Users\chris\source\repos\Cell\Cell\obj\Debug\net8.0-windows\Cell_bjoik44h_wpftmp.sourcelink.json", "JSON", 0, 0, 0, 1, 0, 0, 0, 1
"c:\Users\chris\source\repos\Cell\Cell\obj\Debug\net8.0-windows\Cell_bjudklhz_wpftmp.AssemblyInfo.cs", "C#", 11, 0, 0, 0, 0, 10, 5, 26
"c:\Users\chris\source\repos\Cell\Cell\obj\Debug\net8.0-windows\Cell_bjudklhz_wpftmp.GeneratedMSBuildEditorConfig.editorconfig", "Properties", 0, 0, 0, 0, 13, 0, 1, 14
"c:\Users\chris\source\repos\Cell\Cell\obj\Debug\net8.0-windows\Cell_bjudklhz_wpftmp.GlobalUsings.g.cs", "C#", 5, 0, 0, 0, 0, 1, 1, 7
"c:\Users\chris\source\repos\Cell\Cell\obj\Debug\net8.0-windows\Cell_bjya0u30_wpftmp.AssemblyInfo.cs", "C#", 11, 0, 0, 0, 0, 10, 5, 26
"c:\Users\chris\source\repos\Cell\Cell\obj\Debug\net8.0-windows\Cell_bjya0u30_wpftmp.GeneratedMSBuildEditorConfig.editorconfig", "Properties", 0, 0, 0, 0, 21, 0, 1, 22
"c:\Users\chris\source\repos\Cell\Cell\obj\Debug\net8.0-windows\Cell_bjya0u30_wpftmp.GlobalUsings.g.cs", "C#", 5, 0, 0, 0, 0, 1, 1, 7
"c:\Users\chris\source\repos\Cell\Cell\obj\Debug\net8.0-windows\Cell_bjya0u30_wpftmp.sourcelink.json", "JSON", 0, 0, 0, 1, 0, 0, 0, 1
"c:\Users\chris\source\repos\Cell\Cell\obj\Debug\net8.0-windows\Cell_bjyupbso_wpftmp.AssemblyInfo.cs", "C#", 11, 0, 0, 0, 0, 10, 5, 26
"c:\Users\chris\source\repos\Cell\Cell\obj\Debug\net8.0-windows\Cell_bjyupbso_wpftmp.GeneratedMSBuildEditorConfig.editorconfig", "Properties", 0, 0, 0, 0, 21, 0, 1, 22
"c:\Users\chris\source\repos\Cell\Cell\obj\Debug\net8.0-windows\Cell_bjyupbso_wpftmp.GlobalUsings.g.cs", "C#", 5, 0, 0, 0, 0, 1, 1, 7
"c:\Users\chris\source\repos\Cell\Cell\obj\Debug\net8.0-windows\Cell_bjyupbso_wpftmp.sourcelink.json", "JSON", 0, 0, 0, 1, 0, 0, 0, 1
"c:\Users\chris\source\repos\Cell\Cell\obj\Debug\net8.0-windows\Cell_bm053ds4_wpftmp.AssemblyInfo.cs", "C#", 11, 0, 0, 0, 0, 10, 5, 26
"c:\Users\chris\source\repos\Cell\Cell\obj\Debug\net8.0-windows\Cell_bm053ds4_wpftmp.GeneratedMSBuildEditorConfig.editorconfig", "Properties", 0, 0, 0, 0, 21, 0, 1, 22
"c:\Users\chris\source\repos\Cell\Cell\obj\Debug\net8.0-windows\Cell_bm053ds4_wpftmp.GlobalUsings.g.cs", "C#", 5, 0, 0, 0, 0, 1, 1, 7
"c:\Users\chris\source\repos\Cell\Cell\obj\Debug\net8.0-windows\Cell_bm053ds4_wpftmp.sourcelink.json", "JSON", 0, 0, 0, 1, 0, 0, 0, 1
"c:\Users\chris\source\repos\Cell\Cell\obj\Debug\net8.0-windows\Cell_bmh4vveb_wpftmp.AssemblyInfo.cs", "C#", 11, 0, 0, 0, 0, 10, 5, 26
"c:\Users\chris\source\repos\Cell\Cell\obj\Debug\net8.0-windows\Cell_bmh4vveb_wpftmp.GeneratedMSBuildEditorConfig.editorconfig", "Properties", 0, 0, 0, 0, 13, 0, 1, 14
"c:\Users\chris\source\repos\Cell\Cell\obj\Debug\net8.0-windows\Cell_bmh4vveb_wpftmp.GlobalUsings.g.cs", "C#", 5, 0, 0, 0, 0, 1, 1, 7
"c:\Users\chris\source\repos\Cell\Cell\obj\Debug\net8.0-windows\Cell_bnyp2rjo_wpftmp.AssemblyInfo.cs", "C#", 11, 0, 0, 0, 0, 10, 5, 26
"c:\Users\chris\source\repos\Cell\Cell\obj\Debug\net8.0-windows\Cell_bnyp2rjo_wpftmp.GeneratedMSBuildEditorConfig.editorconfig", "Properties", 0, 0, 0, 0, 21, 0, 1, 22
"c:\Users\chris\source\repos\Cell\Cell\obj\Debug\net8.0-windows\Cell_bnyp2rjo_wpftmp.GlobalUsings.g.cs", "C#", 5, 0, 0, 0, 0, 1, 1, 7
"c:\Users\chris\source\repos\Cell\Cell\obj\Debug\net8.0-windows\Cell_bnyp2rjo_wpftmp.sourcelink.json", "JSON", 0, 0, 0, 1, 0, 0, 0, 1
"c:\Users\chris\source\repos\Cell\Cell\obj\Debug\net8.0-windows\Cell_bobhs51m_wpftmp.AssemblyInfo.cs", "C#", 11, 0, 0, 0, 0, 10, 5, 26
"c:\Users\chris\source\repos\Cell\Cell\obj\Debug\net8.0-windows\Cell_bobhs51m_wpftmp.GeneratedMSBuildEditorConfig.editorconfig", "Properties", 0, 0, 0, 0, 21, 0, 1, 22
"c:\Users\chris\source\repos\Cell\Cell\obj\Debug\net8.0-windows\Cell_bobhs51m_wpftmp.GlobalUsings.g.cs", "C#", 5, 0, 0, 0, 0, 1, 1, 7
"c:\Users\chris\source\repos\Cell\Cell\obj\Debug\net8.0-windows\Cell_bobhs51m_wpftmp.sourcelink.json", "JSON", 0, 0, 0, 1, 0, 0, 0, 1
"c:\Users\chris\source\repos\Cell\Cell\obj\Debug\net8.0-windows\Cell_bp0qgusi_wpftmp.AssemblyInfo.cs", "C#", 11, 0, 0, 0, 0, 10, 5, 26
"c:\Users\chris\source\repos\Cell\Cell\obj\Debug\net8.0-windows\Cell_bp0qgusi_wpftmp.GeneratedMSBuildEditorConfig.editorconfig", "Properties", 0, 0, 0, 0, 13, 0, 1, 14
"c:\Users\chris\source\repos\Cell\Cell\obj\Debug\net8.0-windows\Cell_bp0qgusi_wpftmp.GlobalUsings.g.cs", "C#", 5, 0, 0, 0, 0, 1, 1, 7
"c:\Users\chris\source\repos\Cell\Cell\obj\Debug\net8.0-windows\Cell_bpqb0ufe_wpftmp.AssemblyInfo.cs", "C#", 11, 0, 0, 0, 0, 10, 5, 26
"c:\Users\chris\source\repos\Cell\Cell\obj\Debug\net8.0-windows\Cell_bpqb0ufe_wpftmp.GeneratedMSBuildEditorConfig.editorconfig", "Properties", 0, 0, 0, 0, 21, 0, 1, 22
"c:\Users\chris\source\repos\Cell\Cell\obj\Debug\net8.0-windows\Cell_bpqb0ufe_wpftmp.GlobalUsings.g.cs", "C#", 5, 0, 0, 0, 0, 1, 1, 7
"c:\Users\chris\source\repos\Cell\Cell\obj\Debug\net8.0-windows\Cell_bpqb0ufe_wpftmp.sourcelink.json", "JSON", 0, 0, 0, 1, 0, 0, 0, 1
"c:\Users\chris\source\repos\Cell\Cell\obj\Debug\net8.0-windows\Cell_bsfr0vlw_wpftmp.AssemblyInfo.cs", "C#", 11, 0, 0, 0, 0, 10, 5, 26
"c:\Users\chris\source\repos\Cell\Cell\obj\Debug\net8.0-windows\Cell_bsfr0vlw_wpftmp.GeneratedMSBuildEditorConfig.editorconfig", "Properties", 0, 0, 0, 0, 21, 0, 1, 22
"c:\Users\chris\source\repos\Cell\Cell\obj\Debug\net8.0-windows\Cell_bsfr0vlw_wpftmp.GlobalUsings.g.cs", "C#", 5, 0, 0, 0, 0, 1, 1, 7
"c:\Users\chris\source\repos\Cell\Cell\obj\Debug\net8.0-windows\Cell_bsfr0vlw_wpftmp.sourcelink.json", "JSON", 0, 0, 0, 1, 0, 0, 0, 1
"c:\Users\chris\source\repos\Cell\Cell\obj\Debug\net8.0-windows\Cell_bsh232js_wpftmp.AssemblyInfo.cs", "C#", 11, 0, 0, 0, 0, 10, 5, 26
"c:\Users\chris\source\repos\Cell\Cell\obj\Debug\net8.0-windows\Cell_bsh232js_wpftmp.GeneratedMSBuildEditorConfig.editorconfig", "Properties", 0, 0, 0, 0, 21, 0, 1, 22
"c:\Users\chris\source\repos\Cell\Cell\obj\Debug\net8.0-windows\Cell_bsh232js_wpftmp.GlobalUsings.g.cs", "C#", 5, 0, 0, 0, 0, 1, 1, 7
"c:\Users\chris\source\repos\Cell\Cell\obj\Debug\net8.0-windows\Cell_bsh232js_wpftmp.sourcelink.json", "JSON", 0, 0, 0, 1, 0, 0, 0, 1
"c:\Users\chris\source\repos\Cell\Cell\obj\Debug\net8.0-windows\Cell_bt1msfi1_wpftmp.AssemblyInfo.cs", "C#", 11, 0, 0, 0, 0, 10, 5, 26
"c:\Users\chris\source\repos\Cell\Cell\obj\Debug\net8.0-windows\Cell_bt1msfi1_wpftmp.GeneratedMSBuildEditorConfig.editorconfig", "Properties", 0, 0, 0, 0, 21, 0, 1, 22
"c:\Users\chris\source\repos\Cell\Cell\obj\Debug\net8.0-windows\Cell_bt1msfi1_wpftmp.GlobalUsings.g.cs", "C#", 5, 0, 0, 0, 0, 1, 1, 7
"c:\Users\chris\source\repos\Cell\Cell\obj\Debug\net8.0-windows\Cell_bt1msfi1_wpftmp.sourcelink.json", "JSON", 0, 0, 0, 1, 0, 0, 0, 1
"c:\Users\chris\source\repos\Cell\Cell\obj\Debug\net8.0-windows\Cell_bt2g0ip1_wpftmp.AssemblyInfo.cs", "C#", 11, 0, 0, 0, 0, 10, 5, 26
"c:\Users\chris\source\repos\Cell\Cell\obj\Debug\net8.0-windows\Cell_bt2g0ip1_wpftmp.GeneratedMSBuildEditorConfig.editorconfig", "Properties", 0, 0, 0, 0, 21, 0, 1, 22
"c:\Users\chris\source\repos\Cell\Cell\obj\Debug\net8.0-windows\Cell_bt2g0ip1_wpftmp.GlobalUsings.g.cs", "C#", 5, 0, 0, 0, 0, 1, 1, 7
"c:\Users\chris\source\repos\Cell\Cell\obj\Debug\net8.0-windows\Cell_bt2g0ip1_wpftmp.sourcelink.json", "JSON", 0, 0, 0, 1, 0, 0, 0, 1
"c:\Users\chris\source\repos\Cell\Cell\obj\Debug\net8.0-windows\Cell_buw03kcx_wpftmp.AssemblyInfo.cs", "C#", 11, 0, 0, 0, 0, 10, 5, 26
"c:\Users\chris\source\repos\Cell\Cell\obj\Debug\net8.0-windows\Cell_buw03kcx_wpftmp.GeneratedMSBuildEditorConfig.editorconfig", "Properties", 0, 0, 0, 0, 21, 0, 1, 22
"c:\Users\chris\source\repos\Cell\Cell\obj\Debug\net8.0-windows\Cell_buw03kcx_wpftmp.GlobalUsings.g.cs", "C#", 5, 0, 0, 0, 0, 1, 1, 7
"c:\Users\chris\source\repos\Cell\Cell\obj\Debug\net8.0-windows\Cell_buw03kcx_wpftmp.sourcelink.json", "JSON", 0, 0, 0, 1, 0, 0, 0, 1
"c:\Users\chris\source\repos\Cell\Cell\obj\Debug\net8.0-windows\Cell_bv2mnhpy_wpftmp.AssemblyInfo.cs", "C#", 11, 0, 0, 0, 0, 10, 5, 26
"c:\Users\chris\source\repos\Cell\Cell\obj\Debug\net8.0-windows\Cell_bv2mnhpy_wpftmp.GeneratedMSBuildEditorConfig.editorconfig", "Properties", 0, 0, 0, 0, 21, 0, 1, 22
"c:\Users\chris\source\repos\Cell\Cell\obj\Debug\net8.0-windows\Cell_bv2mnhpy_wpftmp.GlobalUsings.g.cs", "C#", 5, 0, 0, 0, 0, 1, 1, 7
"c:\Users\chris\source\repos\Cell\Cell\obj\Debug\net8.0-windows\Cell_bv2mnhpy_wpftmp.sourcelink.json", "JSON", 0, 0, 0, 1, 0, 0, 0, 1
"c:\Users\chris\source\repos\Cell\Cell\obj\Debug\net8.0-windows\Cell_bvdy4djs_wpftmp.AssemblyInfo.cs", "C#", 11, 0, 0, 0, 0, 10, 5, 26
"c:\Users\chris\source\repos\Cell\Cell\obj\Debug\net8.0-windows\Cell_bvdy4djs_wpftmp.GeneratedMSBuildEditorConfig.editorconfig", "Properties", 0, 0, 0, 0, 21, 0, 1, 22
"c:\Users\chris\source\repos\Cell\Cell\obj\Debug\net8.0-windows\Cell_bvdy4djs_wpftmp.GlobalUsings.g.cs", "C#", 5, 0, 0, 0, 0, 1, 1, 7
"c:\Users\chris\source\repos\Cell\Cell\obj\Debug\net8.0-windows\Cell_bvdy4djs_wpftmp.sourcelink.json", "JSON", 0, 0, 0, 1, 0, 0, 0, 1
"c:\Users\chris\source\repos\Cell\Cell\obj\Debug\net8.0-windows\Cell_bvx3lgsh_wpftmp.AssemblyInfo.cs", "C#", 11, 0, 0, 0, 0, 10, 5, 26
"c:\Users\chris\source\repos\Cell\Cell\obj\Debug\net8.0-windows\Cell_bvx3lgsh_wpftmp.GeneratedMSBuildEditorConfig.editorconfig", "Properties", 0, 0, 0, 0, 13, 0, 1, 14
"c:\Users\chris\source\repos\Cell\Cell\obj\Debug\net8.0-windows\Cell_bvx3lgsh_wpftmp.GlobalUsings.g.cs", "C#", 5, 0, 0, 0, 0, 1, 1, 7
"c:\Users\chris\source\repos\Cell\Cell\obj\Debug\net8.0-windows\Cell_bwm03rxy_wpftmp.AssemblyInfo.cs", "C#", 11, 0, 0, 0, 0, 10, 5, 26
"c:\Users\chris\source\repos\Cell\Cell\obj\Debug\net8.0-windows\Cell_bwm03rxy_wpftmp.GeneratedMSBuildEditorConfig.editorconfig", "Properties", 0, 0, 0, 0, 13, 0, 1, 14
"c:\Users\chris\source\repos\Cell\Cell\obj\Debug\net8.0-windows\Cell_bwm03rxy_wpftmp.GlobalUsings.g.cs", "C#", 5, 0, 0, 0, 0, 1, 1, 7
"c:\Users\chris\source\repos\Cell\Cell\obj\Debug\net8.0-windows\Cell_bxg2xjdo_wpftmp.AssemblyInfo.cs", "C#", 11, 0, 0, 0, 0, 10, 5, 26
"c:\Users\chris\source\repos\Cell\Cell\obj\Debug\net8.0-windows\Cell_bxg2xjdo_wpftmp.GeneratedMSBuildEditorConfig.editorconfig", "Properties", 0, 0, 0, 0, 21, 0, 1, 22
"c:\Users\chris\source\repos\Cell\Cell\obj\Debug\net8.0-windows\Cell_bxg2xjdo_wpftmp.GlobalUsings.g.cs", "C#", 5, 0, 0, 0, 0, 1, 1, 7
"c:\Users\chris\source\repos\Cell\Cell\obj\Debug\net8.0-windows\Cell_bxg2xjdo_wpftmp.sourcelink.json", "JSON", 0, 0, 0, 1, 0, 0, 0, 1
"c:\Users\chris\source\repos\Cell\Cell\obj\Debug\net8.0-windows\Cell_bxpo44cs_wpftmp.AssemblyInfo.cs", "C#", 11, 0, 0, 0, 0, 10, 5, 26
"c:\Users\chris\source\repos\Cell\Cell\obj\Debug\net8.0-windows\Cell_bxpo44cs_wpftmp.GeneratedMSBuildEditorConfig.editorconfig", "Properties", 0, 0, 0, 0, 21, 0, 1, 22
"c:\Users\chris\source\repos\Cell\Cell\obj\Debug\net8.0-windows\Cell_bxpo44cs_wpftmp.GlobalUsings.g.cs", "C#", 5, 0, 0, 0, 0, 1, 1, 7
"c:\Users\chris\source\repos\Cell\Cell\obj\Debug\net8.0-windows\Cell_bxpo44cs_wpftmp.sourcelink.json", "JSON", 0, 0, 0, 1, 0, 0, 0, 1
"c:\Users\chris\source\repos\Cell\Cell\obj\Debug\net8.0-windows\Cell_by2mwwkw_wpftmp.AssemblyInfo.cs", "C#", 11, 0, 0, 0, 0, 10, 5, 26
"c:\Users\chris\source\repos\Cell\Cell\obj\Debug\net8.0-windows\Cell_by2mwwkw_wpftmp.GeneratedMSBuildEditorConfig.editorconfig", "Properties", 0, 0, 0, 0, 21, 0, 1, 22
"c:\Users\chris\source\repos\Cell\Cell\obj\Debug\net8.0-windows\Cell_by2mwwkw_wpftmp.GlobalUsings.g.cs", "C#", 5, 0, 0, 0, 0, 1, 1, 7
"c:\Users\chris\source\repos\Cell\Cell\obj\Debug\net8.0-windows\Cell_by2mwwkw_wpftmp.sourcelink.json", "JSON", 0, 0, 0, 1, 0, 0, 0, 1
"c:\Users\chris\source\repos\Cell\Cell\obj\Debug\net8.0-windows\Cell_by3e3or2_wpftmp.AssemblyInfo.cs", "C#", 11, 0, 0, 0, 0, 10, 5, 26
"c:\Users\chris\source\repos\Cell\Cell\obj\Debug\net8.0-windows\Cell_by3e3or2_wpftmp.GeneratedMSBuildEditorConfig.editorconfig", "Properties", 0, 0, 0, 0, 21, 0, 1, 22
"c:\Users\chris\source\repos\Cell\Cell\obj\Debug\net8.0-windows\Cell_by3e3or2_wpftmp.GlobalUsings.g.cs", "C#", 5, 0, 0, 0, 0, 1, 1, 7
"c:\Users\chris\source\repos\Cell\Cell\obj\Debug\net8.0-windows\Cell_by3e3or2_wpftmp.sourcelink.json", "JSON", 0, 0, 0, 1, 0, 0, 0, 1
"c:\Users\chris\source\repos\Cell\Cell\obj\Debug\net8.0-windows\Cell_bygoyzjz_wpftmp.AssemblyInfo.cs", "C#", 11, 0, 0, 0, 0, 10, 5, 26
"c:\Users\chris\source\repos\Cell\Cell\obj\Debug\net8.0-windows\Cell_bygoyzjz_wpftmp.GeneratedMSBuildEditorConfig.editorconfig", "Properties", 0, 0, 0, 0, 21, 0, 1, 22
"c:\Users\chris\source\repos\Cell\Cell\obj\Debug\net8.0-windows\Cell_bygoyzjz_wpftmp.GlobalUsings.g.cs", "C#", 5, 0, 0, 0, 0, 1, 1, 7
"c:\Users\chris\source\repos\Cell\Cell\obj\Debug\net8.0-windows\Cell_bygoyzjz_wpftmp.sourcelink.json", "JSON", 0, 0, 0, 1, 0, 0, 0, 1
"c:\Users\chris\source\repos\Cell\Cell\obj\Debug\net8.0-windows\Cell_bzakvsvf_wpftmp.AssemblyInfo.cs", "C#", 11, 0, 0, 0, 0, 10, 5, 26
"c:\Users\chris\source\repos\Cell\Cell\obj\Debug\net8.0-windows\Cell_bzakvsvf_wpftmp.GeneratedMSBuildEditorConfig.editorconfig", "Properties", 0, 0, 0, 0, 21, 0, 1, 22
"c:\Users\chris\source\repos\Cell\Cell\obj\Debug\net8.0-windows\Cell_bzakvsvf_wpftmp.GlobalUsings.g.cs", "C#", 5, 0, 0, 0, 0, 1, 1, 7
"c:\Users\chris\source\repos\Cell\Cell\obj\Debug\net8.0-windows\Cell_bzakvsvf_wpftmp.sourcelink.json", "JSON", 0, 0, 0, 1, 0, 0, 0, 1
"c:\Users\chris\source\repos\Cell\Cell\obj\Debug\net8.0-windows\Cell_bzd0h3iv_wpftmp.AssemblyInfo.cs", "C#", 11, 0, 0, 0, 0, 10, 5, 26
"c:\Users\chris\source\repos\Cell\Cell\obj\Debug\net8.0-windows\Cell_bzd0h3iv_wpftmp.GeneratedMSBuildEditorConfig.editorconfig", "Properties", 0, 0, 0, 0, 21, 0, 1, 22
"c:\Users\chris\source\repos\Cell\Cell\obj\Debug\net8.0-windows\Cell_bzd0h3iv_wpftmp.GlobalUsings.g.cs", "C#", 5, 0, 0, 0, 0, 1, 1, 7
"c:\Users\chris\source\repos\Cell\Cell\obj\Debug\net8.0-windows\Cell_bzd0h3iv_wpftmp.sourcelink.json", "JSON", 0, 0, 0, 1, 0, 0, 0, 1
"c:\Users\chris\source\repos\Cell\Cell\obj\Debug\net8.0-windows\Cell_bzqft4rx_wpftmp.AssemblyInfo.cs", "C#", 11, 0, 0, 0, 0, 10, 5, 26
"c:\Users\chris\source\repos\Cell\Cell\obj\Debug\net8.0-windows\Cell_bzqft4rx_wpftmp.GeneratedMSBuildEditorConfig.editorconfig", "Properties", 0, 0, 0, 0, 21, 0, 1, 22
"c:\Users\chris\source\repos\Cell\Cell\obj\Debug\net8.0-windows\Cell_bzqft4rx_wpftmp.GlobalUsings.g.cs", "C#", 5, 0, 0, 0, 0, 1, 1, 7
"c:\Users\chris\source\repos\Cell\Cell\obj\Debug\net8.0-windows\Cell_bzqft4rx_wpftmp.sourcelink.json", "JSON", 0, 0, 0, 1, 0, 0, 0, 1
"c:\Users\chris\source\repos\Cell\Cell\obj\Debug\net8.0-windows\Cell_c01gp3xk_wpftmp.AssemblyInfo.cs", "C#", 11, 0, 0, 0, 0, 10, 5, 26
"c:\Users\chris\source\repos\Cell\Cell\obj\Debug\net8.0-windows\Cell_c01gp3xk_wpftmp.GeneratedMSBuildEditorConfig.editorconfig", "Properties", 0, 0, 0, 0, 21, 0, 1, 22
"c:\Users\chris\source\repos\Cell\Cell\obj\Debug\net8.0-windows\Cell_c01gp3xk_wpftmp.GlobalUsings.g.cs", "C#", 5, 0, 0, 0, 0, 1, 1, 7
"c:\Users\chris\source\repos\Cell\Cell\obj\Debug\net8.0-windows\Cell_c01gp3xk_wpftmp.sourcelink.json", "JSON", 0, 0, 0, 1, 0, 0, 0, 1
"c:\Users\chris\source\repos\Cell\Cell\obj\Debug\net8.0-windows\Cell_c1umd0f4_wpftmp.AssemblyInfo.cs", "C#", 11, 0, 0, 0, 0, 10, 5, 26
"c:\Users\chris\source\repos\Cell\Cell\obj\Debug\net8.0-windows\Cell_c1umd0f4_wpftmp.GeneratedMSBuildEditorConfig.editorconfig", "Properties", 0, 0, 0, 0, 21, 0, 1, 22
"c:\Users\chris\source\repos\Cell\Cell\obj\Debug\net8.0-windows\Cell_c1umd0f4_wpftmp.GlobalUsings.g.cs", "C#", 5, 0, 0, 0, 0, 1, 1, 7
"c:\Users\chris\source\repos\Cell\Cell\obj\Debug\net8.0-windows\Cell_c1umd0f4_wpftmp.sourcelink.json", "JSON", 0, 0, 0, 1, 0, 0, 0, 1
"c:\Users\chris\source\repos\Cell\Cell\obj\Debug\net8.0-windows\Cell_c2njdxts_wpftmp.AssemblyInfo.cs", "C#", 11, 0, 0, 0, 0, 10, 5, 26
"c:\Users\chris\source\repos\Cell\Cell\obj\Debug\net8.0-windows\Cell_c2njdxts_wpftmp.GeneratedMSBuildEditorConfig.editorconfig", "Properties", 0, 0, 0, 0, 21, 0, 1, 22
"c:\Users\chris\source\repos\Cell\Cell\obj\Debug\net8.0-windows\Cell_c2njdxts_wpftmp.GlobalUsings.g.cs", "C#", 5, 0, 0, 0, 0, 1, 1, 7
"c:\Users\chris\source\repos\Cell\Cell\obj\Debug\net8.0-windows\Cell_c2njdxts_wpftmp.sourcelink.json", "JSON", 0, 0, 0, 1, 0, 0, 0, 1
"c:\Users\chris\source\repos\Cell\Cell\obj\Debug\net8.0-windows\Cell_c43zn04e_wpftmp.AssemblyInfo.cs", "C#", 11, 0, 0, 0, 0, 10, 5, 26
"c:\Users\chris\source\repos\Cell\Cell\obj\Debug\net8.0-windows\Cell_c43zn04e_wpftmp.GeneratedMSBuildEditorConfig.editorconfig", "Properties", 0, 0, 0, 0, 13, 0, 1, 14
"c:\Users\chris\source\repos\Cell\Cell\obj\Debug\net8.0-windows\Cell_c43zn04e_wpftmp.GlobalUsings.g.cs", "C#", 5, 0, 0, 0, 0, 1, 1, 7
"c:\Users\chris\source\repos\Cell\Cell\obj\Debug\net8.0-windows\Cell_c4ehjcrv_wpftmp.AssemblyInfo.cs", "C#", 11, 0, 0, 0, 0, 10, 5, 26
"c:\Users\chris\source\repos\Cell\Cell\obj\Debug\net8.0-windows\Cell_c4ehjcrv_wpftmp.GeneratedMSBuildEditorConfig.editorconfig", "Properties", 0, 0, 0, 0, 21, 0, 1, 22
"c:\Users\chris\source\repos\Cell\Cell\obj\Debug\net8.0-windows\Cell_c4ehjcrv_wpftmp.GlobalUsings.g.cs", "C#", 5, 0, 0, 0, 0, 1, 1, 7
"c:\Users\chris\source\repos\Cell\Cell\obj\Debug\net8.0-windows\Cell_c4ehjcrv_wpftmp.sourcelink.json", "JSON", 0, 0, 0, 1, 0, 0, 0, 1
"c:\Users\chris\source\repos\Cell\Cell\obj\Debug\net8.0-windows\Cell_c4pwym0z_wpftmp.AssemblyInfo.cs", "C#", 11, 0, 0, 0, 0, 10, 5, 26
"c:\Users\chris\source\repos\Cell\Cell\obj\Debug\net8.0-windows\Cell_c4pwym0z_wpftmp.GeneratedMSBuildEditorConfig.editorconfig", "Properties", 0, 0, 0, 0, 21, 0, 1, 22
"c:\Users\chris\source\repos\Cell\Cell\obj\Debug\net8.0-windows\Cell_c4pwym0z_wpftmp.GlobalUsings.g.cs", "C#", 5, 0, 0, 0, 0, 1, 1, 7
"c:\Users\chris\source\repos\Cell\Cell\obj\Debug\net8.0-windows\Cell_c4pwym0z_wpftmp.sourcelink.json", "JSON", 0, 0, 0, 1, 0, 0, 0, 1
"c:\Users\chris\source\repos\Cell\Cell\obj\Debug\net8.0-windows\Cell_c4uub5lf_wpftmp.AssemblyInfo.cs", "C#", 11, 0, 0, 0, 0, 10, 5, 26
"c:\Users\chris\source\repos\Cell\Cell\obj\Debug\net8.0-windows\Cell_c4uub5lf_wpftmp.GeneratedMSBuildEditorConfig.editorconfig", "Properties", 0, 0, 0, 0, 21, 0, 1, 22
"c:\Users\chris\source\repos\Cell\Cell\obj\Debug\net8.0-windows\Cell_c4uub5lf_wpftmp.GlobalUsings.g.cs", "C#", 5, 0, 0, 0, 0, 1, 1, 7
"c:\Users\chris\source\repos\Cell\Cell\obj\Debug\net8.0-windows\Cell_c4uub5lf_wpftmp.sourcelink.json", "JSON", 0, 0, 0, 1, 0, 0, 0, 1
"c:\Users\chris\source\repos\Cell\Cell\obj\Debug\net8.0-windows\Cell_c50hixzk_wpftmp.AssemblyInfo.cs", "C#", 11, 0, 0, 0, 0, 10, 5, 26
"c:\Users\chris\source\repos\Cell\Cell\obj\Debug\net8.0-windows\Cell_c50hixzk_wpftmp.GeneratedMSBuildEditorConfig.editorconfig", "Properties", 0, 0, 0, 0, 21, 0, 1, 22
"c:\Users\chris\source\repos\Cell\Cell\obj\Debug\net8.0-windows\Cell_c50hixzk_wpftmp.GlobalUsings.g.cs", "C#", 5, 0, 0, 0, 0, 1, 1, 7
"c:\Users\chris\source\repos\Cell\Cell\obj\Debug\net8.0-windows\Cell_c50hixzk_wpftmp.sourcelink.json", "JSON", 0, 0, 0, 1, 0, 0, 0, 1
"c:\Users\chris\source\repos\Cell\Cell\obj\Debug\net8.0-windows\Cell_c52j01it_wpftmp.AssemblyInfo.cs", "C#", 11, 0, 0, 0, 0, 10, 5, 26
"c:\Users\chris\source\repos\Cell\Cell\obj\Debug\net8.0-windows\Cell_c52j01it_wpftmp.GeneratedMSBuildEditorConfig.editorconfig", "Properties", 0, 0, 0, 0, 21, 0, 1, 22
"c:\Users\chris\source\repos\Cell\Cell\obj\Debug\net8.0-windows\Cell_c52j01it_wpftmp.GlobalUsings.g.cs", "C#", 5, 0, 0, 0, 0, 1, 1, 7
"c:\Users\chris\source\repos\Cell\Cell\obj\Debug\net8.0-windows\Cell_c52j01it_wpftmp.sourcelink.json", "JSON", 0, 0, 0, 1, 0, 0, 0, 1
"c:\Users\chris\source\repos\Cell\Cell\obj\Debug\net8.0-windows\Cell_c5ygrhyd_wpftmp.AssemblyInfo.cs", "C#", 11, 0, 0, 0, 0, 10, 5, 26
"c:\Users\chris\source\repos\Cell\Cell\obj\Debug\net8.0-windows\Cell_c5ygrhyd_wpftmp.GeneratedMSBuildEditorConfig.editorconfig", "Properties", 0, 0, 0, 0, 21, 0, 1, 22
"c:\Users\chris\source\repos\Cell\Cell\obj\Debug\net8.0-windows\Cell_c5ygrhyd_wpftmp.GlobalUsings.g.cs", "C#", 5, 0, 0, 0, 0, 1, 1, 7
"c:\Users\chris\source\repos\Cell\Cell\obj\Debug\net8.0-windows\Cell_c5ygrhyd_wpftmp.sourcelink.json", "JSON", 0, 0, 0, 1, 0, 0, 0, 1
"c:\Users\chris\source\repos\Cell\Cell\obj\Debug\net8.0-windows\Cell_caaxpl01_wpftmp.AssemblyInfo.cs", "C#", 11, 0, 0, 0, 0, 10, 5, 26
"c:\Users\chris\source\repos\Cell\Cell\obj\Debug\net8.0-windows\Cell_caaxpl01_wpftmp.GeneratedMSBuildEditorConfig.editorconfig", "Properties", 0, 0, 0, 0, 21, 0, 1, 22
"c:\Users\chris\source\repos\Cell\Cell\obj\Debug\net8.0-windows\Cell_caaxpl01_wpftmp.GlobalUsings.g.cs", "C#", 5, 0, 0, 0, 0, 1, 1, 7
"c:\Users\chris\source\repos\Cell\Cell\obj\Debug\net8.0-windows\Cell_caaxpl01_wpftmp.sourcelink.json", "JSON", 0, 0, 0, 1, 0, 0, 0, 1
"c:\Users\chris\source\repos\Cell\Cell\obj\Debug\net8.0-windows\Cell_cagx3mt0_wpftmp.AssemblyInfo.cs", "C#", 11, 0, 0, 0, 0, 10, 5, 26
"c:\Users\chris\source\repos\Cell\Cell\obj\Debug\net8.0-windows\Cell_cagx3mt0_wpftmp.GeneratedMSBuildEditorConfig.editorconfig", "Properties", 0, 0, 0, 0, 21, 0, 1, 22
"c:\Users\chris\source\repos\Cell\Cell\obj\Debug\net8.0-windows\Cell_cagx3mt0_wpftmp.GlobalUsings.g.cs", "C#", 5, 0, 0, 0, 0, 1, 1, 7
"c:\Users\chris\source\repos\Cell\Cell\obj\Debug\net8.0-windows\Cell_cagx3mt0_wpftmp.sourcelink.json", "JSON", 0, 0, 0, 1, 0, 0, 0, 1
"c:\Users\chris\source\repos\Cell\Cell\obj\Debug\net8.0-windows\Cell_cb02goln_wpftmp.AssemblyInfo.cs", "C#", 11, 0, 0, 0, 0, 10, 5, 26
"c:\Users\chris\source\repos\Cell\Cell\obj\Debug\net8.0-windows\Cell_cb02goln_wpftmp.GeneratedMSBuildEditorConfig.editorconfig", "Properties", 0, 0, 0, 0, 13, 0, 1, 14
"c:\Users\chris\source\repos\Cell\Cell\obj\Debug\net8.0-windows\Cell_cb02goln_wpftmp.GlobalUsings.g.cs", "C#", 5, 0, 0, 0, 0, 1, 1, 7
"c:\Users\chris\source\repos\Cell\Cell\obj\Debug\net8.0-windows\Cell_cbvuqesi_wpftmp.AssemblyInfo.cs", "C#", 11, 0, 0, 0, 0, 10, 5, 26
"c:\Users\chris\source\repos\Cell\Cell\obj\Debug\net8.0-windows\Cell_cbvuqesi_wpftmp.GeneratedMSBuildEditorConfig.editorconfig", "Properties", 0, 0, 0, 0, 21, 0, 1, 22
"c:\Users\chris\source\repos\Cell\Cell\obj\Debug\net8.0-windows\Cell_cbvuqesi_wpftmp.GlobalUsings.g.cs", "C#", 5, 0, 0, 0, 0, 1, 1, 7
"c:\Users\chris\source\repos\Cell\Cell\obj\Debug\net8.0-windows\Cell_cbvuqesi_wpftmp.sourcelink.json", "JSON", 0, 0, 0, 1, 0, 0, 0, 1
"c:\Users\chris\source\repos\Cell\Cell\obj\Debug\net8.0-windows\Cell_cciz5get_wpftmp.AssemblyInfo.cs", "C#", 11, 0, 0, 0, 0, 10, 5, 26
"c:\Users\chris\source\repos\Cell\Cell\obj\Debug\net8.0-windows\Cell_cciz5get_wpftmp.GeneratedMSBuildEditorConfig.editorconfig", "Properties", 0, 0, 0, 0, 21, 0, 1, 22
"c:\Users\chris\source\repos\Cell\Cell\obj\Debug\net8.0-windows\Cell_cciz5get_wpftmp.GlobalUsings.g.cs", "C#", 5, 0, 0, 0, 0, 1, 1, 7
"c:\Users\chris\source\repos\Cell\Cell\obj\Debug\net8.0-windows\Cell_cciz5get_wpftmp.sourcelink.json", "JSON", 0, 0, 0, 1, 0, 0, 0, 1
"c:\Users\chris\source\repos\Cell\Cell\obj\Debug\net8.0-windows\Cell_ccsgnw2u_wpftmp.AssemblyInfo.cs", "C#", 11, 0, 0, 0, 0, 10, 5, 26
"c:\Users\chris\source\repos\Cell\Cell\obj\Debug\net8.0-windows\Cell_ccsgnw2u_wpftmp.GeneratedMSBuildEditorConfig.editorconfig", "Properties", 0, 0, 0, 0, 21, 0, 1, 22
"c:\Users\chris\source\repos\Cell\Cell\obj\Debug\net8.0-windows\Cell_ccsgnw2u_wpftmp.GlobalUsings.g.cs", "C#", 5, 0, 0, 0, 0, 1, 1, 7
"c:\Users\chris\source\repos\Cell\Cell\obj\Debug\net8.0-windows\Cell_ccsgnw2u_wpftmp.sourcelink.json", "JSON", 0, 0, 0, 1, 0, 0, 0, 1
"c:\Users\chris\source\repos\Cell\Cell\obj\Debug\net8.0-windows\Cell_cd2avpj4_wpftmp.AssemblyInfo.cs", "C#", 11, 0, 0, 0, 0, 10, 5, 26
"c:\Users\chris\source\repos\Cell\Cell\obj\Debug\net8.0-windows\Cell_cd2avpj4_wpftmp.GeneratedMSBuildEditorConfig.editorconfig", "Properties", 0, 0, 0, 0, 21, 0, 1, 22
"c:\Users\chris\source\repos\Cell\Cell\obj\Debug\net8.0-windows\Cell_cd2avpj4_wpftmp.GlobalUsings.g.cs", "C#", 5, 0, 0, 0, 0, 1, 1, 7
"c:\Users\chris\source\repos\Cell\Cell\obj\Debug\net8.0-windows\Cell_cd2avpj4_wpftmp.sourcelink.json", "JSON", 0, 0, 0, 1, 0, 0, 0, 1
"c:\Users\chris\source\repos\Cell\Cell\obj\Debug\net8.0-windows\Cell_cdal0iok_wpftmp.AssemblyInfo.cs", "C#", 11, 0, 0, 0, 0, 10, 5, 26
"c:\Users\chris\source\repos\Cell\Cell\obj\Debug\net8.0-windows\Cell_cdal0iok_wpftmp.GeneratedMSBuildEditorConfig.editorconfig", "Properties", 0, 0, 0, 0, 21, 0, 1, 22
"c:\Users\chris\source\repos\Cell\Cell\obj\Debug\net8.0-windows\Cell_cdal0iok_wpftmp.GlobalUsings.g.cs", "C#", 5, 0, 0, 0, 0, 1, 1, 7
"c:\Users\chris\source\repos\Cell\Cell\obj\Debug\net8.0-windows\Cell_cdal0iok_wpftmp.sourcelink.json", "JSON", 0, 0, 0, 1, 0, 0, 0, 1
"c:\Users\chris\source\repos\Cell\Cell\obj\Debug\net8.0-windows\Cell_ceap4qhg_wpftmp.AssemblyInfo.cs", "C#", 11, 0, 0, 0, 0, 10, 5, 26
"c:\Users\chris\source\repos\Cell\Cell\obj\Debug\net8.0-windows\Cell_ceap4qhg_wpftmp.GeneratedMSBuildEditorConfig.editorconfig", "Properties", 0, 0, 0, 0, 21, 0, 1, 22
"c:\Users\chris\source\repos\Cell\Cell\obj\Debug\net8.0-windows\Cell_ceap4qhg_wpftmp.GlobalUsings.g.cs", "C#", 5, 0, 0, 0, 0, 1, 1, 7
"c:\Users\chris\source\repos\Cell\Cell\obj\Debug\net8.0-windows\Cell_ceap4qhg_wpftmp.sourcelink.json", "JSON", 0, 0, 0, 1, 0, 0, 0, 1
"c:\Users\chris\source\repos\Cell\Cell\obj\Debug\net8.0-windows\Cell_cef0nuct_wpftmp.AssemblyInfo.cs", "C#", 11, 0, 0, 0, 0, 10, 5, 26
"c:\Users\chris\source\repos\Cell\Cell\obj\Debug\net8.0-windows\Cell_cef0nuct_wpftmp.GeneratedMSBuildEditorConfig.editorconfig", "Properties", 0, 0, 0, 0, 13, 0, 1, 14
"c:\Users\chris\source\repos\Cell\Cell\obj\Debug\net8.0-windows\Cell_cef0nuct_wpftmp.GlobalUsings.g.cs", "C#", 5, 0, 0, 0, 0, 1, 1, 7
"c:\Users\chris\source\repos\Cell\Cell\obj\Debug\net8.0-windows\Cell_cgfgahef_wpftmp.AssemblyInfo.cs", "C#", 11, 0, 0, 0, 0, 10, 5, 26
"c:\Users\chris\source\repos\Cell\Cell\obj\Debug\net8.0-windows\Cell_cgfgahef_wpftmp.GeneratedMSBuildEditorConfig.editorconfig", "Properties", 0, 0, 0, 0, 21, 0, 1, 22
"c:\Users\chris\source\repos\Cell\Cell\obj\Debug\net8.0-windows\Cell_cgfgahef_wpftmp.GlobalUsings.g.cs", "C#", 5, 0, 0, 0, 0, 1, 1, 7
"c:\Users\chris\source\repos\Cell\Cell\obj\Debug\net8.0-windows\Cell_cgfgahef_wpftmp.sourcelink.json", "JSON", 0, 0, 0, 1, 0, 0, 0, 1
"c:\Users\chris\source\repos\Cell\Cell\obj\Debug\net8.0-windows\Cell_cgy4nuvj_wpftmp.AssemblyInfo.cs", "C#", 11, 0, 0, 0, 0, 10, 5, 26
"c:\Users\chris\source\repos\Cell\Cell\obj\Debug\net8.0-windows\Cell_cgy4nuvj_wpftmp.GeneratedMSBuildEditorConfig.editorconfig", "Properties", 0, 0, 0, 0, 21, 0, 1, 22
"c:\Users\chris\source\repos\Cell\Cell\obj\Debug\net8.0-windows\Cell_cgy4nuvj_wpftmp.GlobalUsings.g.cs", "C#", 5, 0, 0, 0, 0, 1, 1, 7
"c:\Users\chris\source\repos\Cell\Cell\obj\Debug\net8.0-windows\Cell_cgy4nuvj_wpftmp.sourcelink.json", "JSON", 0, 0, 0, 1, 0, 0, 0, 1
"c:\Users\chris\source\repos\Cell\Cell\obj\Debug\net8.0-windows\Cell_ci1ago5b_wpftmp.AssemblyInfo.cs", "C#", 11, 0, 0, 0, 0, 10, 5, 26
"c:\Users\chris\source\repos\Cell\Cell\obj\Debug\net8.0-windows\Cell_ci1ago5b_wpftmp.GeneratedMSBuildEditorConfig.editorconfig", "Properties", 0, 0, 0, 0, 21, 0, 1, 22
"c:\Users\chris\source\repos\Cell\Cell\obj\Debug\net8.0-windows\Cell_ci1ago5b_wpftmp.GlobalUsings.g.cs", "C#", 5, 0, 0, 0, 0, 1, 1, 7
"c:\Users\chris\source\repos\Cell\Cell\obj\Debug\net8.0-windows\Cell_ci1ago5b_wpftmp.sourcelink.json", "JSON", 0, 0, 0, 1, 0, 0, 0, 1
"c:\Users\chris\source\repos\Cell\Cell\obj\Debug\net8.0-windows\Cell_cibp5odh_wpftmp.AssemblyInfo.cs", "C#", 11, 0, 0, 0, 0, 10, 5, 26
"c:\Users\chris\source\repos\Cell\Cell\obj\Debug\net8.0-windows\Cell_cibp5odh_wpftmp.GeneratedMSBuildEditorConfig.editorconfig", "Properties", 0, 0, 0, 0, 21, 0, 1, 22
"c:\Users\chris\source\repos\Cell\Cell\obj\Debug\net8.0-windows\Cell_cibp5odh_wpftmp.GlobalUsings.g.cs", "C#", 5, 0, 0, 0, 0, 1, 1, 7
"c:\Users\chris\source\repos\Cell\Cell\obj\Debug\net8.0-windows\Cell_cibp5odh_wpftmp.sourcelink.json", "JSON", 0, 0, 0, 1, 0, 0, 0, 1
"c:\Users\chris\source\repos\Cell\Cell\obj\Debug\net8.0-windows\Cell_cmfhz0jc_wpftmp.AssemblyInfo.cs", "C#", 11, 0, 0, 0, 0, 10, 5, 26
"c:\Users\chris\source\repos\Cell\Cell\obj\Debug\net8.0-windows\Cell_cmfhz0jc_wpftmp.GeneratedMSBuildEditorConfig.editorconfig", "Properties", 0, 0, 0, 0, 21, 0, 1, 22
"c:\Users\chris\source\repos\Cell\Cell\obj\Debug\net8.0-windows\Cell_cmfhz0jc_wpftmp.GlobalUsings.g.cs", "C#", 5, 0, 0, 0, 0, 1, 1, 7
"c:\Users\chris\source\repos\Cell\Cell\obj\Debug\net8.0-windows\Cell_cmfhz0jc_wpftmp.sourcelink.json", "JSON", 0, 0, 0, 1, 0, 0, 0, 1
"c:\Users\chris\source\repos\Cell\Cell\obj\Debug\net8.0-windows\Cell_cn2sb4l0_wpftmp.AssemblyInfo.cs", "C#", 11, 0, 0, 0, 0, 10, 5, 26
"c:\Users\chris\source\repos\Cell\Cell\obj\Debug\net8.0-windows\Cell_cn2sb4l0_wpftmp.GeneratedMSBuildEditorConfig.editorconfig", "Properties", 0, 0, 0, 0, 13, 0, 1, 14
"c:\Users\chris\source\repos\Cell\Cell\obj\Debug\net8.0-windows\Cell_cn2sb4l0_wpftmp.GlobalUsings.g.cs", "C#", 5, 0, 0, 0, 0, 1, 1, 7
"c:\Users\chris\source\repos\Cell\Cell\obj\Debug\net8.0-windows\Cell_cn3f3gxz_wpftmp.AssemblyInfo.cs", "C#", 11, 0, 0, 0, 0, 10, 5, 26
"c:\Users\chris\source\repos\Cell\Cell\obj\Debug\net8.0-windows\Cell_cn3f3gxz_wpftmp.GeneratedMSBuildEditorConfig.editorconfig", "Properties", 0, 0, 0, 0, 13, 0, 1, 14
"c:\Users\chris\source\repos\Cell\Cell\obj\Debug\net8.0-windows\Cell_cn3f3gxz_wpftmp.GlobalUsings.g.cs", "C#", 5, 0, 0, 0, 0, 1, 1, 7
"c:\Users\chris\source\repos\Cell\Cell\obj\Debug\net8.0-windows\Cell_cndxadet_wpftmp.AssemblyInfo.cs", "C#", 11, 0, 0, 0, 0, 10, 5, 26
"c:\Users\chris\source\repos\Cell\Cell\obj\Debug\net8.0-windows\Cell_cndxadet_wpftmp.GeneratedMSBuildEditorConfig.editorconfig", "Properties", 0, 0, 0, 0, 13, 0, 1, 14
"c:\Users\chris\source\repos\Cell\Cell\obj\Debug\net8.0-windows\Cell_cndxadet_wpftmp.GlobalUsings.g.cs", "C#", 5, 0, 0, 0, 0, 1, 1, 7
"c:\Users\chris\source\repos\Cell\Cell\obj\Debug\net8.0-windows\Cell_cngcn5n5_wpftmp.AssemblyInfo.cs", "C#", 11, 0, 0, 0, 0, 10, 5, 26
"c:\Users\chris\source\repos\Cell\Cell\obj\Debug\net8.0-windows\Cell_cngcn5n5_wpftmp.GeneratedMSBuildEditorConfig.editorconfig", "Properties", 0, 0, 0, 0, 21, 0, 1, 22
"c:\Users\chris\source\repos\Cell\Cell\obj\Debug\net8.0-windows\Cell_cngcn5n5_wpftmp.GlobalUsings.g.cs", "C#", 5, 0, 0, 0, 0, 1, 1, 7
"c:\Users\chris\source\repos\Cell\Cell\obj\Debug\net8.0-windows\Cell_cngcn5n5_wpftmp.sourcelink.json", "JSON", 0, 0, 0, 1, 0, 0, 0, 1
"c:\Users\chris\source\repos\Cell\Cell\obj\Debug\net8.0-windows\Cell_cohk1j1v_wpftmp.AssemblyInfo.cs", "C#", 11, 0, 0, 0, 0, 10, 5, 26
"c:\Users\chris\source\repos\Cell\Cell\obj\Debug\net8.0-windows\Cell_cohk1j1v_wpftmp.GeneratedMSBuildEditorConfig.editorconfig", "Properties", 0, 0, 0, 0, 21, 0, 1, 22
"c:\Users\chris\source\repos\Cell\Cell\obj\Debug\net8.0-windows\Cell_cohk1j1v_wpftmp.GlobalUsings.g.cs", "C#", 5, 0, 0, 0, 0, 1, 1, 7
"c:\Users\chris\source\repos\Cell\Cell\obj\Debug\net8.0-windows\Cell_cohk1j1v_wpftmp.sourcelink.json", "JSON", 0, 0, 0, 1, 0, 0, 0, 1
"c:\Users\chris\source\repos\Cell\Cell\obj\Debug\net8.0-windows\Cell_cohroadk_wpftmp.AssemblyInfo.cs", "C#", 11, 0, 0, 0, 0, 10, 5, 26
"c:\Users\chris\source\repos\Cell\Cell\obj\Debug\net8.0-windows\Cell_cohroadk_wpftmp.GeneratedMSBuildEditorConfig.editorconfig", "Properties", 0, 0, 0, 0, 21, 0, 1, 22
"c:\Users\chris\source\repos\Cell\Cell\obj\Debug\net8.0-windows\Cell_cohroadk_wpftmp.GlobalUsings.g.cs", "C#", 5, 0, 0, 0, 0, 1, 1, 7
"c:\Users\chris\source\repos\Cell\Cell\obj\Debug\net8.0-windows\Cell_cohroadk_wpftmp.sourcelink.json", "JSON", 0, 0, 0, 1, 0, 0, 0, 1
"c:\Users\chris\source\repos\Cell\Cell\obj\Debug\net8.0-windows\Cell_corkxbon_wpftmp.AssemblyInfo.cs", "C#", 11, 0, 0, 0, 0, 10, 5, 26
"c:\Users\chris\source\repos\Cell\Cell\obj\Debug\net8.0-windows\Cell_corkxbon_wpftmp.GeneratedMSBuildEditorConfig.editorconfig", "Properties", 0, 0, 0, 0, 21, 0, 1, 22
"c:\Users\chris\source\repos\Cell\Cell\obj\Debug\net8.0-windows\Cell_corkxbon_wpftmp.GlobalUsings.g.cs", "C#", 5, 0, 0, 0, 0, 1, 1, 7
"c:\Users\chris\source\repos\Cell\Cell\obj\Debug\net8.0-windows\Cell_corkxbon_wpftmp.sourcelink.json", "JSON", 0, 0, 0, 1, 0, 0, 0, 1
"c:\Users\chris\source\repos\Cell\Cell\obj\Debug\net8.0-windows\Cell_cp2ezl44_wpftmp.AssemblyInfo.cs", "C#", 11, 0, 0, 0, 0, 10, 5, 26
"c:\Users\chris\source\repos\Cell\Cell\obj\Debug\net8.0-windows\Cell_cp2ezl44_wpftmp.GeneratedMSBuildEditorConfig.editorconfig", "Properties", 0, 0, 0, 0, 21, 0, 1, 22
"c:\Users\chris\source\repos\Cell\Cell\obj\Debug\net8.0-windows\Cell_cp2ezl44_wpftmp.GlobalUsings.g.cs", "C#", 5, 0, 0, 0, 0, 1, 1, 7
"c:\Users\chris\source\repos\Cell\Cell\obj\Debug\net8.0-windows\Cell_cp2ezl44_wpftmp.sourcelink.json", "JSON", 0, 0, 0, 1, 0, 0, 0, 1
"c:\Users\chris\source\repos\Cell\Cell\obj\Debug\net8.0-windows\Cell_cp5i5lvv_wpftmp.AssemblyInfo.cs", "C#", 11, 0, 0, 0, 0, 10, 5, 26
"c:\Users\chris\source\repos\Cell\Cell\obj\Debug\net8.0-windows\Cell_cp5i5lvv_wpftmp.GeneratedMSBuildEditorConfig.editorconfig", "Properties", 0, 0, 0, 0, 21, 0, 1, 22
"c:\Users\chris\source\repos\Cell\Cell\obj\Debug\net8.0-windows\Cell_cp5i5lvv_wpftmp.GlobalUsings.g.cs", "C#", 5, 0, 0, 0, 0, 1, 1, 7
"c:\Users\chris\source\repos\Cell\Cell\obj\Debug\net8.0-windows\Cell_cp5i5lvv_wpftmp.sourcelink.json", "JSON", 0, 0, 0, 1, 0, 0, 0, 1
"c:\Users\chris\source\repos\Cell\Cell\obj\Debug\net8.0-windows\Cell_cpeyhcgm_wpftmp.AssemblyInfo.cs", "C#", 11, 0, 0, 0, 0, 10, 5, 26
"c:\Users\chris\source\repos\Cell\Cell\obj\Debug\net8.0-windows\Cell_cpeyhcgm_wpftmp.GeneratedMSBuildEditorConfig.editorconfig", "Properties", 0, 0, 0, 0, 21, 0, 1, 22
"c:\Users\chris\source\repos\Cell\Cell\obj\Debug\net8.0-windows\Cell_cpeyhcgm_wpftmp.GlobalUsings.g.cs", "C#", 5, 0, 0, 0, 0, 1, 1, 7
"c:\Users\chris\source\repos\Cell\Cell\obj\Debug\net8.0-windows\Cell_cpeyhcgm_wpftmp.sourcelink.json", "JSON", 0, 0, 0, 1, 0, 0, 0, 1
"c:\Users\chris\source\repos\Cell\Cell\obj\Debug\net8.0-windows\Cell_cpsefjgh_wpftmp.AssemblyInfo.cs", "C#", 11, 0, 0, 0, 0, 10, 5, 26
"c:\Users\chris\source\repos\Cell\Cell\obj\Debug\net8.0-windows\Cell_cpsefjgh_wpftmp.GeneratedMSBuildEditorConfig.editorconfig", "Properties", 0, 0, 0, 0, 13, 0, 1, 14
"c:\Users\chris\source\repos\Cell\Cell\obj\Debug\net8.0-windows\Cell_cpsefjgh_wpftmp.GlobalUsings.g.cs", "C#", 5, 0, 0, 0, 0, 1, 1, 7
"c:\Users\chris\source\repos\Cell\Cell\obj\Debug\net8.0-windows\Cell_cquad2oz_wpftmp.AssemblyInfo.cs", "C#", 11, 0, 0, 0, 0, 10, 5, 26
"c:\Users\chris\source\repos\Cell\Cell\obj\Debug\net8.0-windows\Cell_cquad2oz_wpftmp.GeneratedMSBuildEditorConfig.editorconfig", "Properties", 0, 0, 0, 0, 21, 0, 1, 22
"c:\Users\chris\source\repos\Cell\Cell\obj\Debug\net8.0-windows\Cell_cquad2oz_wpftmp.GlobalUsings.g.cs", "C#", 5, 0, 0, 0, 0, 1, 1, 7
"c:\Users\chris\source\repos\Cell\Cell\obj\Debug\net8.0-windows\Cell_cquad2oz_wpftmp.sourcelink.json", "JSON", 0, 0, 0, 1, 0, 0, 0, 1
"c:\Users\chris\source\repos\Cell\Cell\obj\Debug\net8.0-windows\Cell_cr2ah0xj_wpftmp.AssemblyInfo.cs", "C#", 11, 0, 0, 0, 0, 10, 5, 26
"c:\Users\chris\source\repos\Cell\Cell\obj\Debug\net8.0-windows\Cell_cr2ah0xj_wpftmp.GeneratedMSBuildEditorConfig.editorconfig", "Properties", 0, 0, 0, 0, 21, 0, 1, 22
"c:\Users\chris\source\repos\Cell\Cell\obj\Debug\net8.0-windows\Cell_cr2ah0xj_wpftmp.GlobalUsings.g.cs", "C#", 5, 0, 0, 0, 0, 1, 1, 7
"c:\Users\chris\source\repos\Cell\Cell\obj\Debug\net8.0-windows\Cell_cr2ah0xj_wpftmp.sourcelink.json", "JSON", 0, 0, 0, 1, 0, 0, 0, 1
"c:\Users\chris\source\repos\Cell\Cell\obj\Debug\net8.0-windows\Cell_cspqdy3b_wpftmp.AssemblyInfo.cs", "C#", 11, 0, 0, 0, 0, 10, 5, 26
"c:\Users\chris\source\repos\Cell\Cell\obj\Debug\net8.0-windows\Cell_cspqdy3b_wpftmp.GeneratedMSBuildEditorConfig.editorconfig", "Properties", 0, 0, 0, 0, 21, 0, 1, 22
"c:\Users\chris\source\repos\Cell\Cell\obj\Debug\net8.0-windows\Cell_cspqdy3b_wpftmp.GlobalUsings.g.cs", "C#", 5, 0, 0, 0, 0, 1, 1, 7
"c:\Users\chris\source\repos\Cell\Cell\obj\Debug\net8.0-windows\Cell_cspqdy3b_wpftmp.sourcelink.json", "JSON", 0, 0, 0, 1, 0, 0, 0, 1
"c:\Users\chris\source\repos\Cell\Cell\obj\Debug\net8.0-windows\Cell_ct2pu5xw_wpftmp.AssemblyInfo.cs", "C#", 11, 0, 0, 0, 0, 10, 5, 26
"c:\Users\chris\source\repos\Cell\Cell\obj\Debug\net8.0-windows\Cell_ct2pu5xw_wpftmp.GeneratedMSBuildEditorConfig.editorconfig", "Properties", 0, 0, 0, 0, 21, 0, 1, 22
"c:\Users\chris\source\repos\Cell\Cell\obj\Debug\net8.0-windows\Cell_ct2pu5xw_wpftmp.GlobalUsings.g.cs", "C#", 5, 0, 0, 0, 0, 1, 1, 7
"c:\Users\chris\source\repos\Cell\Cell\obj\Debug\net8.0-windows\Cell_ct2pu5xw_wpftmp.sourcelink.json", "JSON", 0, 0, 0, 1, 0, 0, 0, 1
"c:\Users\chris\source\repos\Cell\Cell\obj\Debug\net8.0-windows\Cell_ctq31pfg_wpftmp.AssemblyInfo.cs", "C#", 11, 0, 0, 0, 0, 10, 5, 26
"c:\Users\chris\source\repos\Cell\Cell\obj\Debug\net8.0-windows\Cell_ctq31pfg_wpftmp.GeneratedMSBuildEditorConfig.editorconfig", "Properties", 0, 0, 0, 0, 21, 0, 1, 22
"c:\Users\chris\source\repos\Cell\Cell\obj\Debug\net8.0-windows\Cell_ctq31pfg_wpftmp.GlobalUsings.g.cs", "C#", 5, 0, 0, 0, 0, 1, 1, 7
"c:\Users\chris\source\repos\Cell\Cell\obj\Debug\net8.0-windows\Cell_ctq31pfg_wpftmp.sourcelink.json", "JSON", 0, 0, 0, 1, 0, 0, 0, 1
"c:\Users\chris\source\repos\Cell\Cell\obj\Debug\net8.0-windows\Cell_cuakrtqv_wpftmp.AssemblyInfo.cs", "C#", 11, 0, 0, 0, 0, 10, 5, 26
"c:\Users\chris\source\repos\Cell\Cell\obj\Debug\net8.0-windows\Cell_cuakrtqv_wpftmp.GeneratedMSBuildEditorConfig.editorconfig", "Properties", 0, 0, 0, 0, 21, 0, 1, 22
"c:\Users\chris\source\repos\Cell\Cell\obj\Debug\net8.0-windows\Cell_cuakrtqv_wpftmp.GlobalUsings.g.cs", "C#", 5, 0, 0, 0, 0, 1, 1, 7
"c:\Users\chris\source\repos\Cell\Cell\obj\Debug\net8.0-windows\Cell_cuakrtqv_wpftmp.sourcelink.json", "JSON", 0, 0, 0, 1, 0, 0, 0, 1
"c:\Users\chris\source\repos\Cell\Cell\obj\Debug\net8.0-windows\Cell_cujzrcii_wpftmp.AssemblyInfo.cs", "C#", 11, 0, 0, 0, 0, 10, 5, 26
"c:\Users\chris\source\repos\Cell\Cell\obj\Debug\net8.0-windows\Cell_cujzrcii_wpftmp.GeneratedMSBuildEditorConfig.editorconfig", "Properties", 0, 0, 0, 0, 21, 0, 1, 22
"c:\Users\chris\source\repos\Cell\Cell\obj\Debug\net8.0-windows\Cell_cujzrcii_wpftmp.GlobalUsings.g.cs", "C#", 5, 0, 0, 0, 0, 1, 1, 7
"c:\Users\chris\source\repos\Cell\Cell\obj\Debug\net8.0-windows\Cell_cujzrcii_wpftmp.sourcelink.json", "JSON", 0, 0, 0, 1, 0, 0, 0, 1
"c:\Users\chris\source\repos\Cell\Cell\obj\Debug\net8.0-windows\Cell_cuqw2pln_wpftmp.AssemblyInfo.cs", "C#", 11, 0, 0, 0, 0, 10, 5, 26
"c:\Users\chris\source\repos\Cell\Cell\obj\Debug\net8.0-windows\Cell_cuqw2pln_wpftmp.GeneratedMSBuildEditorConfig.editorconfig", "Properties", 0, 0, 0, 0, 21, 0, 1, 22
"c:\Users\chris\source\repos\Cell\Cell\obj\Debug\net8.0-windows\Cell_cuqw2pln_wpftmp.GlobalUsings.g.cs", "C#", 5, 0, 0, 0, 0, 1, 1, 7
"c:\Users\chris\source\repos\Cell\Cell\obj\Debug\net8.0-windows\Cell_cuqw2pln_wpftmp.sourcelink.json", "JSON", 0, 0, 0, 1, 0, 0, 0, 1
"c:\Users\chris\source\repos\Cell\Cell\obj\Debug\net8.0-windows\Cell_cvdguapx_wpftmp.AssemblyInfo.cs", "C#", 11, 0, 0, 0, 0, 10, 5, 26
"c:\Users\chris\source\repos\Cell\Cell\obj\Debug\net8.0-windows\Cell_cvdguapx_wpftmp.GeneratedMSBuildEditorConfig.editorconfig", "Properties", 0, 0, 0, 0, 21, 0, 1, 22
"c:\Users\chris\source\repos\Cell\Cell\obj\Debug\net8.0-windows\Cell_cvdguapx_wpftmp.GlobalUsings.g.cs", "C#", 5, 0, 0, 0, 0, 1, 1, 7
"c:\Users\chris\source\repos\Cell\Cell\obj\Debug\net8.0-windows\Cell_cvdguapx_wpftmp.sourcelink.json", "JSON", 0, 0, 0, 1, 0, 0, 0, 1
"c:\Users\chris\source\repos\Cell\Cell\obj\Debug\net8.0-windows\Cell_cvng05gl_wpftmp.AssemblyInfo.cs", "C#", 11, 0, 0, 0, 0, 10, 5, 26
"c:\Users\chris\source\repos\Cell\Cell\obj\Debug\net8.0-windows\Cell_cvng05gl_wpftmp.GeneratedMSBuildEditorConfig.editorconfig", "Properties", 0, 0, 0, 0, 21, 0, 1, 22
"c:\Users\chris\source\repos\Cell\Cell\obj\Debug\net8.0-windows\Cell_cvng05gl_wpftmp.GlobalUsings.g.cs", "C#", 5, 0, 0, 0, 0, 1, 1, 7
"c:\Users\chris\source\repos\Cell\Cell\obj\Debug\net8.0-windows\Cell_cvng05gl_wpftmp.sourcelink.json", "JSON", 0, 0, 0, 1, 0, 0, 0, 1
"c:\Users\chris\source\repos\Cell\Cell\obj\Debug\net8.0-windows\Cell_cwsuszuk_wpftmp.AssemblyInfo.cs", "C#", 11, 0, 0, 0, 0, 10, 5, 26
"c:\Users\chris\source\repos\Cell\Cell\obj\Debug\net8.0-windows\Cell_cwsuszuk_wpftmp.GeneratedMSBuildEditorConfig.editorconfig", "Properties", 0, 0, 0, 0, 13, 0, 1, 14
"c:\Users\chris\source\repos\Cell\Cell\obj\Debug\net8.0-windows\Cell_cwsuszuk_wpftmp.GlobalUsings.g.cs", "C#", 5, 0, 0, 0, 0, 1, 1, 7
"c:\Users\chris\source\repos\Cell\Cell\obj\Debug\net8.0-windows\Cell_cxdhwhq5_wpftmp.AssemblyInfo.cs", "C#", 11, 0, 0, 0, 0, 10, 5, 26
"c:\Users\chris\source\repos\Cell\Cell\obj\Debug\net8.0-windows\Cell_cxdhwhq5_wpftmp.GeneratedMSBuildEditorConfig.editorconfig", "Properties", 0, 0, 0, 0, 13, 0, 1, 14
"c:\Users\chris\source\repos\Cell\Cell\obj\Debug\net8.0-windows\Cell_cxdhwhq5_wpftmp.GlobalUsings.g.cs", "C#", 5, 0, 0, 0, 0, 1, 1, 7
"c:\Users\chris\source\repos\Cell\Cell\obj\Debug\net8.0-windows\Cell_cxhatjrk_wpftmp.AssemblyInfo.cs", "C#", 11, 0, 0, 0, 0, 10, 5, 26
"c:\Users\chris\source\repos\Cell\Cell\obj\Debug\net8.0-windows\Cell_cxhatjrk_wpftmp.GeneratedMSBuildEditorConfig.editorconfig", "Properties", 0, 0, 0, 0, 21, 0, 1, 22
"c:\Users\chris\source\repos\Cell\Cell\obj\Debug\net8.0-windows\Cell_cxhatjrk_wpftmp.GlobalUsings.g.cs", "C#", 5, 0, 0, 0, 0, 1, 1, 7
"c:\Users\chris\source\repos\Cell\Cell\obj\Debug\net8.0-windows\Cell_cxhatjrk_wpftmp.sourcelink.json", "JSON", 0, 0, 0, 1, 0, 0, 0, 1
"c:\Users\chris\source\repos\Cell\Cell\obj\Debug\net8.0-windows\Cell_cyekkbqn_wpftmp.AssemblyInfo.cs", "C#", 11, 0, 0, 0, 0, 10, 5, 26
"c:\Users\chris\source\repos\Cell\Cell\obj\Debug\net8.0-windows\Cell_cyekkbqn_wpftmp.GeneratedMSBuildEditorConfig.editorconfig", "Properties", 0, 0, 0, 0, 21, 0, 1, 22
"c:\Users\chris\source\repos\Cell\Cell\obj\Debug\net8.0-windows\Cell_cyekkbqn_wpftmp.GlobalUsings.g.cs", "C#", 5, 0, 0, 0, 0, 1, 1, 7
"c:\Users\chris\source\repos\Cell\Cell\obj\Debug\net8.0-windows\Cell_cyekkbqn_wpftmp.sourcelink.json", "JSON", 0, 0, 0, 1, 0, 0, 0, 1
"c:\Users\chris\source\repos\Cell\Cell\obj\Debug\net8.0-windows\Cell_d0c4jlu1_wpftmp.AssemblyInfo.cs", "C#", 11, 0, 0, 0, 0, 10, 5, 26
"c:\Users\chris\source\repos\Cell\Cell\obj\Debug\net8.0-windows\Cell_d0c4jlu1_wpftmp.GeneratedMSBuildEditorConfig.editorconfig", "Properties", 0, 0, 0, 0, 21, 0, 1, 22
"c:\Users\chris\source\repos\Cell\Cell\obj\Debug\net8.0-windows\Cell_d0c4jlu1_wpftmp.GlobalUsings.g.cs", "C#", 5, 0, 0, 0, 0, 1, 1, 7
"c:\Users\chris\source\repos\Cell\Cell\obj\Debug\net8.0-windows\Cell_d0c4jlu1_wpftmp.sourcelink.json", "JSON", 0, 0, 0, 1, 0, 0, 0, 1
"c:\Users\chris\source\repos\Cell\Cell\obj\Debug\net8.0-windows\Cell_d1pqytgo_wpftmp.AssemblyInfo.cs", "C#", 11, 0, 0, 0, 0, 10, 5, 26
"c:\Users\chris\source\repos\Cell\Cell\obj\Debug\net8.0-windows\Cell_d1pqytgo_wpftmp.GeneratedMSBuildEditorConfig.editorconfig", "Properties", 0, 0, 0, 0, 21, 0, 1, 22
"c:\Users\chris\source\repos\Cell\Cell\obj\Debug\net8.0-windows\Cell_d1pqytgo_wpftmp.GlobalUsings.g.cs", "C#", 5, 0, 0, 0, 0, 1, 1, 7
"c:\Users\chris\source\repos\Cell\Cell\obj\Debug\net8.0-windows\Cell_d1pqytgo_wpftmp.sourcelink.json", "JSON", 0, 0, 0, 1, 0, 0, 0, 1
"c:\Users\chris\source\repos\Cell\Cell\obj\Debug\net8.0-windows\Cell_d2acygtt_wpftmp.AssemblyInfo.cs", "C#", 11, 0, 0, 0, 0, 10, 5, 26
"c:\Users\chris\source\repos\Cell\Cell\obj\Debug\net8.0-windows\Cell_d2acygtt_wpftmp.GeneratedMSBuildEditorConfig.editorconfig", "Properties", 0, 0, 0, 0, 21, 0, 1, 22
"c:\Users\chris\source\repos\Cell\Cell\obj\Debug\net8.0-windows\Cell_d2acygtt_wpftmp.GlobalUsings.g.cs", "C#", 5, 0, 0, 0, 0, 1, 1, 7
"c:\Users\chris\source\repos\Cell\Cell\obj\Debug\net8.0-windows\Cell_d2acygtt_wpftmp.sourcelink.json", "JSON", 0, 0, 0, 1, 0, 0, 0, 1
"c:\Users\chris\source\repos\Cell\Cell\obj\Debug\net8.0-windows\Cell_d3lxf2iy_wpftmp.AssemblyInfo.cs", "C#", 11, 0, 0, 0, 0, 10, 5, 26
"c:\Users\chris\source\repos\Cell\Cell\obj\Debug\net8.0-windows\Cell_d3lxf2iy_wpftmp.GeneratedMSBuildEditorConfig.editorconfig", "Properties", 0, 0, 0, 0, 21, 0, 1, 22
"c:\Users\chris\source\repos\Cell\Cell\obj\Debug\net8.0-windows\Cell_d3lxf2iy_wpftmp.GlobalUsings.g.cs", "C#", 5, 0, 0, 0, 0, 1, 1, 7
"c:\Users\chris\source\repos\Cell\Cell\obj\Debug\net8.0-windows\Cell_d3lxf2iy_wpftmp.sourcelink.json", "JSON", 0, 0, 0, 1, 0, 0, 0, 1
"c:\Users\chris\source\repos\Cell\Cell\obj\Debug\net8.0-windows\Cell_d3o5j1t4_wpftmp.AssemblyInfo.cs", "C#", 11, 0, 0, 0, 0, 10, 5, 26
"c:\Users\chris\source\repos\Cell\Cell\obj\Debug\net8.0-windows\Cell_d3o5j1t4_wpftmp.GeneratedMSBuildEditorConfig.editorconfig", "Properties", 0, 0, 0, 0, 13, 0, 1, 14
"c:\Users\chris\source\repos\Cell\Cell\obj\Debug\net8.0-windows\Cell_d3o5j1t4_wpftmp.GlobalUsings.g.cs", "C#", 5, 0, 0, 0, 0, 1, 1, 7
"c:\Users\chris\source\repos\Cell\Cell\obj\Debug\net8.0-windows\Cell_d4j4o3qt_wpftmp.AssemblyInfo.cs", "C#", 11, 0, 0, 0, 0, 10, 5, 26
"c:\Users\chris\source\repos\Cell\Cell\obj\Debug\net8.0-windows\Cell_d4j4o3qt_wpftmp.GeneratedMSBuildEditorConfig.editorconfig", "Properties", 0, 0, 0, 0, 21, 0, 1, 22
"c:\Users\chris\source\repos\Cell\Cell\obj\Debug\net8.0-windows\Cell_d4j4o3qt_wpftmp.GlobalUsings.g.cs", "C#", 5, 0, 0, 0, 0, 1, 1, 7
"c:\Users\chris\source\repos\Cell\Cell\obj\Debug\net8.0-windows\Cell_d4j4o3qt_wpftmp.sourcelink.json", "JSON", 0, 0, 0, 1, 0, 0, 0, 1
"c:\Users\chris\source\repos\Cell\Cell\obj\Debug\net8.0-windows\Cell_d4pqwocj_wpftmp.AssemblyInfo.cs", "C#", 11, 0, 0, 0, 0, 10, 5, 26
"c:\Users\chris\source\repos\Cell\Cell\obj\Debug\net8.0-windows\Cell_d4pqwocj_wpftmp.GeneratedMSBuildEditorConfig.editorconfig", "Properties", 0, 0, 0, 0, 13, 0, 1, 14
"c:\Users\chris\source\repos\Cell\Cell\obj\Debug\net8.0-windows\Cell_d4pqwocj_wpftmp.GlobalUsings.g.cs", "C#", 5, 0, 0, 0, 0, 1, 1, 7
"c:\Users\chris\source\repos\Cell\Cell\obj\Debug\net8.0-windows\Cell_d4tkeg04_wpftmp.AssemblyInfo.cs", "C#", 11, 0, 0, 0, 0, 10, 5, 26
"c:\Users\chris\source\repos\Cell\Cell\obj\Debug\net8.0-windows\Cell_d4tkeg04_wpftmp.GeneratedMSBuildEditorConfig.editorconfig", "Properties", 0, 0, 0, 0, 13, 0, 1, 14
"c:\Users\chris\source\repos\Cell\Cell\obj\Debug\net8.0-windows\Cell_d4tkeg04_wpftmp.GlobalUsings.g.cs", "C#", 5, 0, 0, 0, 0, 1, 1, 7
"c:\Users\chris\source\repos\Cell\Cell\obj\Debug\net8.0-windows\Cell_d5ju1l5y_wpftmp.AssemblyInfo.cs", "C#", 11, 0, 0, 0, 0, 10, 5, 26
"c:\Users\chris\source\repos\Cell\Cell\obj\Debug\net8.0-windows\Cell_d5ju1l5y_wpftmp.GeneratedMSBuildEditorConfig.editorconfig", "Properties", 0, 0, 0, 0, 21, 0, 1, 22
"c:\Users\chris\source\repos\Cell\Cell\obj\Debug\net8.0-windows\Cell_d5ju1l5y_wpftmp.GlobalUsings.g.cs", "C#", 5, 0, 0, 0, 0, 1, 1, 7
"c:\Users\chris\source\repos\Cell\Cell\obj\Debug\net8.0-windows\Cell_d5ju1l5y_wpftmp.sourcelink.json", "JSON", 0, 0, 0, 1, 0, 0, 0, 1
"c:\Users\chris\source\repos\Cell\Cell\obj\Debug\net8.0-windows\Cell_d5v2qdpk_wpftmp.AssemblyInfo.cs", "C#", 11, 0, 0, 0, 0, 10, 5, 26
"c:\Users\chris\source\repos\Cell\Cell\obj\Debug\net8.0-windows\Cell_d5v2qdpk_wpftmp.GeneratedMSBuildEditorConfig.editorconfig", "Properties", 0, 0, 0, 0, 21, 0, 1, 22
"c:\Users\chris\source\repos\Cell\Cell\obj\Debug\net8.0-windows\Cell_d5v2qdpk_wpftmp.GlobalUsings.g.cs", "C#", 5, 0, 0, 0, 0, 1, 1, 7
"c:\Users\chris\source\repos\Cell\Cell\obj\Debug\net8.0-windows\Cell_d5v2qdpk_wpftmp.sourcelink.json", "JSON", 0, 0, 0, 1, 0, 0, 0, 1
"c:\Users\chris\source\repos\Cell\Cell\obj\Debug\net8.0-windows\Cell_dadqx3vl_wpftmp.AssemblyInfo.cs", "C#", 11, 0, 0, 0, 0, 10, 5, 26
"c:\Users\chris\source\repos\Cell\Cell\obj\Debug\net8.0-windows\Cell_dadqx3vl_wpftmp.GeneratedMSBuildEditorConfig.editorconfig", "Properties", 0, 0, 0, 0, 21, 0, 1, 22
"c:\Users\chris\source\repos\Cell\Cell\obj\Debug\net8.0-windows\Cell_dadqx3vl_wpftmp.GlobalUsings.g.cs", "C#", 5, 0, 0, 0, 0, 1, 1, 7
"c:\Users\chris\source\repos\Cell\Cell\obj\Debug\net8.0-windows\Cell_dadqx3vl_wpftmp.sourcelink.json", "JSON", 0, 0, 0, 1, 0, 0, 0, 1
"c:\Users\chris\source\repos\Cell\Cell\obj\Debug\net8.0-windows\Cell_dao3xjts_wpftmp.AssemblyInfo.cs", "C#", 11, 0, 0, 0, 0, 10, 5, 26
"c:\Users\chris\source\repos\Cell\Cell\obj\Debug\net8.0-windows\Cell_dao3xjts_wpftmp.GeneratedMSBuildEditorConfig.editorconfig", "Properties", 0, 0, 0, 0, 21, 0, 1, 22
"c:\Users\chris\source\repos\Cell\Cell\obj\Debug\net8.0-windows\Cell_dao3xjts_wpftmp.GlobalUsings.g.cs", "C#", 5, 0, 0, 0, 0, 1, 1, 7
"c:\Users\chris\source\repos\Cell\Cell\obj\Debug\net8.0-windows\Cell_dao3xjts_wpftmp.sourcelink.json", "JSON", 0, 0, 0, 1, 0, 0, 0, 1
"c:\Users\chris\source\repos\Cell\Cell\obj\Debug\net8.0-windows\Cell_dbfmhtsr_wpftmp.AssemblyInfo.cs", "C#", 11, 0, 0, 0, 0, 10, 5, 26
"c:\Users\chris\source\repos\Cell\Cell\obj\Debug\net8.0-windows\Cell_dbfmhtsr_wpftmp.GeneratedMSBuildEditorConfig.editorconfig", "Properties", 0, 0, 0, 0, 13, 0, 1, 14
"c:\Users\chris\source\repos\Cell\Cell\obj\Debug\net8.0-windows\Cell_dbfmhtsr_wpftmp.GlobalUsings.g.cs", "C#", 5, 0, 0, 0, 0, 1, 1, 7
"c:\Users\chris\source\repos\Cell\Cell\obj\Debug\net8.0-windows\Cell_dcrkbwsy_wpftmp.AssemblyInfo.cs", "C#", 11, 0, 0, 0, 0, 10, 5, 26
"c:\Users\chris\source\repos\Cell\Cell\obj\Debug\net8.0-windows\Cell_dcrkbwsy_wpftmp.GeneratedMSBuildEditorConfig.editorconfig", "Properties", 0, 0, 0, 0, 21, 0, 1, 22
"c:\Users\chris\source\repos\Cell\Cell\obj\Debug\net8.0-windows\Cell_dcrkbwsy_wpftmp.GlobalUsings.g.cs", "C#", 5, 0, 0, 0, 0, 1, 1, 7
"c:\Users\chris\source\repos\Cell\Cell\obj\Debug\net8.0-windows\Cell_dcrkbwsy_wpftmp.sourcelink.json", "JSON", 0, 0, 0, 1, 0, 0, 0, 1
"c:\Users\chris\source\repos\Cell\Cell\obj\Debug\net8.0-windows\Cell_dd1gxnin_wpftmp.AssemblyInfo.cs", "C#", 11, 0, 0, 0, 0, 10, 5, 26
"c:\Users\chris\source\repos\Cell\Cell\obj\Debug\net8.0-windows\Cell_dd1gxnin_wpftmp.GeneratedMSBuildEditorConfig.editorconfig", "Properties", 0, 0, 0, 0, 21, 0, 1, 22
"c:\Users\chris\source\repos\Cell\Cell\obj\Debug\net8.0-windows\Cell_dd1gxnin_wpftmp.GlobalUsings.g.cs", "C#", 5, 0, 0, 0, 0, 1, 1, 7
"c:\Users\chris\source\repos\Cell\Cell\obj\Debug\net8.0-windows\Cell_dd1gxnin_wpftmp.sourcelink.json", "JSON", 0, 0, 0, 1, 0, 0, 0, 1
"c:\Users\chris\source\repos\Cell\Cell\obj\Debug\net8.0-windows\Cell_ddpegpsy_wpftmp.AssemblyInfo.cs", "C#", 11, 0, 0, 0, 0, 10, 5, 26
"c:\Users\chris\source\repos\Cell\Cell\obj\Debug\net8.0-windows\Cell_ddpegpsy_wpftmp.GeneratedMSBuildEditorConfig.editorconfig", "Properties", 0, 0, 0, 0, 13, 0, 1, 14
"c:\Users\chris\source\repos\Cell\Cell\obj\Debug\net8.0-windows\Cell_ddpegpsy_wpftmp.GlobalUsings.g.cs", "C#", 5, 0, 0, 0, 0, 1, 1, 7
"c:\Users\chris\source\repos\Cell\Cell\obj\Debug\net8.0-windows\Cell_de5tjmut_wpftmp.AssemblyInfo.cs", "C#", 11, 0, 0, 0, 0, 10, 5, 26
"c:\Users\chris\source\repos\Cell\Cell\obj\Debug\net8.0-windows\Cell_de5tjmut_wpftmp.GeneratedMSBuildEditorConfig.editorconfig", "Properties", 0, 0, 0, 0, 21, 0, 1, 22
"c:\Users\chris\source\repos\Cell\Cell\obj\Debug\net8.0-windows\Cell_de5tjmut_wpftmp.GlobalUsings.g.cs", "C#", 5, 0, 0, 0, 0, 1, 1, 7
"c:\Users\chris\source\repos\Cell\Cell\obj\Debug\net8.0-windows\Cell_de5tjmut_wpftmp.sourcelink.json", "JSON", 0, 0, 0, 1, 0, 0, 0, 1
"c:\Users\chris\source\repos\Cell\Cell\obj\Debug\net8.0-windows\Cell_deeeldbz_wpftmp.AssemblyInfo.cs", "C#", 11, 0, 0, 0, 0, 10, 5, 26
"c:\Users\chris\source\repos\Cell\Cell\obj\Debug\net8.0-windows\Cell_deeeldbz_wpftmp.GeneratedMSBuildEditorConfig.editorconfig", "Properties", 0, 0, 0, 0, 21, 0, 1, 22
"c:\Users\chris\source\repos\Cell\Cell\obj\Debug\net8.0-windows\Cell_deeeldbz_wpftmp.GlobalUsings.g.cs", "C#", 5, 0, 0, 0, 0, 1, 1, 7
"c:\Users\chris\source\repos\Cell\Cell\obj\Debug\net8.0-windows\Cell_deeeldbz_wpftmp.sourcelink.json", "JSON", 0, 0, 0, 1, 0, 0, 0, 1
"c:\Users\chris\source\repos\Cell\Cell\obj\Debug\net8.0-windows\Cell_depzvejm_wpftmp.AssemblyInfo.cs", "C#", 11, 0, 0, 0, 0, 10, 5, 26
"c:\Users\chris\source\repos\Cell\Cell\obj\Debug\net8.0-windows\Cell_depzvejm_wpftmp.GeneratedMSBuildEditorConfig.editorconfig", "Properties", 0, 0, 0, 0, 13, 0, 1, 14
"c:\Users\chris\source\repos\Cell\Cell\obj\Debug\net8.0-windows\Cell_depzvejm_wpftmp.GlobalUsings.g.cs", "C#", 5, 0, 0, 0, 0, 1, 1, 7
"c:\Users\chris\source\repos\Cell\Cell\obj\Debug\net8.0-windows\Cell_dfosx1f1_wpftmp.AssemblyInfo.cs", "C#", 11, 0, 0, 0, 0, 10, 5, 26
"c:\Users\chris\source\repos\Cell\Cell\obj\Debug\net8.0-windows\Cell_dfosx1f1_wpftmp.GeneratedMSBuildEditorConfig.editorconfig", "Properties", 0, 0, 0, 0, 21, 0, 1, 22
"c:\Users\chris\source\repos\Cell\Cell\obj\Debug\net8.0-windows\Cell_dfosx1f1_wpftmp.GlobalUsings.g.cs", "C#", 5, 0, 0, 0, 0, 1, 1, 7
"c:\Users\chris\source\repos\Cell\Cell\obj\Debug\net8.0-windows\Cell_dfosx1f1_wpftmp.sourcelink.json", "JSON", 0, 0, 0, 1, 0, 0, 0, 1
"c:\Users\chris\source\repos\Cell\Cell\obj\Debug\net8.0-windows\Cell_dgs33ec2_wpftmp.AssemblyInfo.cs", "C#", 11, 0, 0, 0, 0, 10, 5, 26
"c:\Users\chris\source\repos\Cell\Cell\obj\Debug\net8.0-windows\Cell_dgs33ec2_wpftmp.GeneratedMSBuildEditorConfig.editorconfig", "Properties", 0, 0, 0, 0, 21, 0, 1, 22
"c:\Users\chris\source\repos\Cell\Cell\obj\Debug\net8.0-windows\Cell_dgs33ec2_wpftmp.GlobalUsings.g.cs", "C#", 5, 0, 0, 0, 0, 1, 1, 7
"c:\Users\chris\source\repos\Cell\Cell\obj\Debug\net8.0-windows\Cell_dgs33ec2_wpftmp.sourcelink.json", "JSON", 0, 0, 0, 1, 0, 0, 0, 1
"c:\Users\chris\source\repos\Cell\Cell\obj\Debug\net8.0-windows\Cell_dhl1hw2f_wpftmp.AssemblyInfo.cs", "C#", 11, 0, 0, 0, 0, 10, 5, 26
"c:\Users\chris\source\repos\Cell\Cell\obj\Debug\net8.0-windows\Cell_dhl1hw2f_wpftmp.GeneratedMSBuildEditorConfig.editorconfig", "Properties", 0, 0, 0, 0, 21, 0, 1, 22
"c:\Users\chris\source\repos\Cell\Cell\obj\Debug\net8.0-windows\Cell_dhl1hw2f_wpftmp.GlobalUsings.g.cs", "C#", 5, 0, 0, 0, 0, 1, 1, 7
"c:\Users\chris\source\repos\Cell\Cell\obj\Debug\net8.0-windows\Cell_dhl1hw2f_wpftmp.sourcelink.json", "JSON", 0, 0, 0, 1, 0, 0, 0, 1
"c:\Users\chris\source\repos\Cell\Cell\obj\Debug\net8.0-windows\Cell_di2bg4f0_wpftmp.AssemblyInfo.cs", "C#", 11, 0, 0, 0, 0, 10, 5, 26
"c:\Users\chris\source\repos\Cell\Cell\obj\Debug\net8.0-windows\Cell_di2bg4f0_wpftmp.GeneratedMSBuildEditorConfig.editorconfig", "Properties", 0, 0, 0, 0, 21, 0, 1, 22
"c:\Users\chris\source\repos\Cell\Cell\obj\Debug\net8.0-windows\Cell_di2bg4f0_wpftmp.GlobalUsings.g.cs", "C#", 5, 0, 0, 0, 0, 1, 1, 7
"c:\Users\chris\source\repos\Cell\Cell\obj\Debug\net8.0-windows\Cell_di2bg4f0_wpftmp.sourcelink.json", "JSON", 0, 0, 0, 1, 0, 0, 0, 1
"c:\Users\chris\source\repos\Cell\Cell\obj\Debug\net8.0-windows\Cell_dj31b51m_wpftmp.AssemblyInfo.cs", "C#", 11, 0, 0, 0, 0, 10, 5, 26
"c:\Users\chris\source\repos\Cell\Cell\obj\Debug\net8.0-windows\Cell_dj31b51m_wpftmp.GeneratedMSBuildEditorConfig.editorconfig", "Properties", 0, 0, 0, 0, 21, 0, 1, 22
"c:\Users\chris\source\repos\Cell\Cell\obj\Debug\net8.0-windows\Cell_dj31b51m_wpftmp.GlobalUsings.g.cs", "C#", 5, 0, 0, 0, 0, 1, 1, 7
"c:\Users\chris\source\repos\Cell\Cell\obj\Debug\net8.0-windows\Cell_dj31b51m_wpftmp.sourcelink.json", "JSON", 0, 0, 0, 1, 0, 0, 0, 1
"c:\Users\chris\source\repos\Cell\Cell\obj\Debug\net8.0-windows\Cell_dj4vr1xh_wpftmp.AssemblyInfo.cs", "C#", 11, 0, 0, 0, 0, 10, 5, 26
"c:\Users\chris\source\repos\Cell\Cell\obj\Debug\net8.0-windows\Cell_dj4vr1xh_wpftmp.GeneratedMSBuildEditorConfig.editorconfig", "Properties", 0, 0, 0, 0, 21, 0, 1, 22
"c:\Users\chris\source\repos\Cell\Cell\obj\Debug\net8.0-windows\Cell_dj4vr1xh_wpftmp.GlobalUsings.g.cs", "C#", 5, 0, 0, 0, 0, 1, 1, 7
"c:\Users\chris\source\repos\Cell\Cell\obj\Debug\net8.0-windows\Cell_dj4vr1xh_wpftmp.sourcelink.json", "JSON", 0, 0, 0, 1, 0, 0, 0, 1
"c:\Users\chris\source\repos\Cell\Cell\obj\Debug\net8.0-windows\Cell_dj554sng_wpftmp.AssemblyInfo.cs", "C#", 11, 0, 0, 0, 0, 10, 5, 26
"c:\Users\chris\source\repos\Cell\Cell\obj\Debug\net8.0-windows\Cell_dj554sng_wpftmp.GeneratedMSBuildEditorConfig.editorconfig", "Properties", 0, 0, 0, 0, 21, 0, 1, 22
"c:\Users\chris\source\repos\Cell\Cell\obj\Debug\net8.0-windows\Cell_dj554sng_wpftmp.GlobalUsings.g.cs", "C#", 5, 0, 0, 0, 0, 1, 1, 7
"c:\Users\chris\source\repos\Cell\Cell\obj\Debug\net8.0-windows\Cell_dj554sng_wpftmp.sourcelink.json", "JSON", 0, 0, 0, 1, 0, 0, 0, 1
"c:\Users\chris\source\repos\Cell\Cell\obj\Debug\net8.0-windows\Cell_djgnhwee_wpftmp.AssemblyInfo.cs", "C#", 11, 0, 0, 0, 0, 10, 5, 26
"c:\Users\chris\source\repos\Cell\Cell\obj\Debug\net8.0-windows\Cell_djgnhwee_wpftmp.GeneratedMSBuildEditorConfig.editorconfig", "Properties", 0, 0, 0, 0, 21, 0, 1, 22
"c:\Users\chris\source\repos\Cell\Cell\obj\Debug\net8.0-windows\Cell_djgnhwee_wpftmp.GlobalUsings.g.cs", "C#", 5, 0, 0, 0, 0, 1, 1, 7
"c:\Users\chris\source\repos\Cell\Cell\obj\Debug\net8.0-windows\Cell_djgnhwee_wpftmp.sourcelink.json", "JSON", 0, 0, 0, 1, 0, 0, 0, 1
"c:\Users\chris\source\repos\Cell\Cell\obj\Debug\net8.0-windows\Cell_dkxmtult_wpftmp.AssemblyInfo.cs", "C#", 11, 0, 0, 0, 0, 10, 5, 26
"c:\Users\chris\source\repos\Cell\Cell\obj\Debug\net8.0-windows\Cell_dkxmtult_wpftmp.GeneratedMSBuildEditorConfig.editorconfig", "Properties", 0, 0, 0, 0, 13, 0, 1, 14
"c:\Users\chris\source\repos\Cell\Cell\obj\Debug\net8.0-windows\Cell_dkxmtult_wpftmp.GlobalUsings.g.cs", "C#", 5, 0, 0, 0, 0, 1, 1, 7
"c:\Users\chris\source\repos\Cell\Cell\obj\Debug\net8.0-windows\Cell_dluebbhz_wpftmp.AssemblyInfo.cs", "C#", 11, 0, 0, 0, 0, 10, 5, 26
"c:\Users\chris\source\repos\Cell\Cell\obj\Debug\net8.0-windows\Cell_dluebbhz_wpftmp.GeneratedMSBuildEditorConfig.editorconfig", "Properties", 0, 0, 0, 0, 21, 0, 1, 22
"c:\Users\chris\source\repos\Cell\Cell\obj\Debug\net8.0-windows\Cell_dluebbhz_wpftmp.GlobalUsings.g.cs", "C#", 5, 0, 0, 0, 0, 1, 1, 7
"c:\Users\chris\source\repos\Cell\Cell\obj\Debug\net8.0-windows\Cell_dluebbhz_wpftmp.sourcelink.json", "JSON", 0, 0, 0, 1, 0, 0, 0, 1
"c:\Users\chris\source\repos\Cell\Cell\obj\Debug\net8.0-windows\Cell_dmildolh_wpftmp.AssemblyInfo.cs", "C#", 11, 0, 0, 0, 0, 10, 5, 26
"c:\Users\chris\source\repos\Cell\Cell\obj\Debug\net8.0-windows\Cell_dmildolh_wpftmp.GeneratedMSBuildEditorConfig.editorconfig", "Properties", 0, 0, 0, 0, 21, 0, 1, 22
"c:\Users\chris\source\repos\Cell\Cell\obj\Debug\net8.0-windows\Cell_dmildolh_wpftmp.GlobalUsings.g.cs", "C#", 5, 0, 0, 0, 0, 1, 1, 7
"c:\Users\chris\source\repos\Cell\Cell\obj\Debug\net8.0-windows\Cell_dmpt4wew_wpftmp.AssemblyInfo.cs", "C#", 11, 0, 0, 0, 0, 10, 5, 26
"c:\Users\chris\source\repos\Cell\Cell\obj\Debug\net8.0-windows\Cell_dmpt4wew_wpftmp.GeneratedMSBuildEditorConfig.editorconfig", "Properties", 0, 0, 0, 0, 21, 0, 1, 22
"c:\Users\chris\source\repos\Cell\Cell\obj\Debug\net8.0-windows\Cell_dmpt4wew_wpftmp.GlobalUsings.g.cs", "C#", 5, 0, 0, 0, 0, 1, 1, 7
"c:\Users\chris\source\repos\Cell\Cell\obj\Debug\net8.0-windows\Cell_dmpt4wew_wpftmp.sourcelink.json", "JSON", 0, 0, 0, 1, 0, 0, 0, 1
"c:\Users\chris\source\repos\Cell\Cell\obj\Debug\net8.0-windows\Cell_dmv3kouh_wpftmp.AssemblyInfo.cs", "C#", 11, 0, 0, 0, 0, 10, 5, 26
"c:\Users\chris\source\repos\Cell\Cell\obj\Debug\net8.0-windows\Cell_dmv3kouh_wpftmp.GeneratedMSBuildEditorConfig.editorconfig", "Properties", 0, 0, 0, 0, 21, 0, 1, 22
"c:\Users\chris\source\repos\Cell\Cell\obj\Debug\net8.0-windows\Cell_dmv3kouh_wpftmp.GlobalUsings.g.cs", "C#", 5, 0, 0, 0, 0, 1, 1, 7
"c:\Users\chris\source\repos\Cell\Cell\obj\Debug\net8.0-windows\Cell_dmv3kouh_wpftmp.sourcelink.json", "JSON", 0, 0, 0, 1, 0, 0, 0, 1
"c:\Users\chris\source\repos\Cell\Cell\obj\Debug\net8.0-windows\Cell_dnhiakuf_wpftmp.AssemblyInfo.cs", "C#", 11, 0, 0, 0, 0, 10, 5, 26
"c:\Users\chris\source\repos\Cell\Cell\obj\Debug\net8.0-windows\Cell_dnhiakuf_wpftmp.GeneratedMSBuildEditorConfig.editorconfig", "Properties", 0, 0, 0, 0, 21, 0, 1, 22
"c:\Users\chris\source\repos\Cell\Cell\obj\Debug\net8.0-windows\Cell_dnhiakuf_wpftmp.GlobalUsings.g.cs", "C#", 5, 0, 0, 0, 0, 1, 1, 7
"c:\Users\chris\source\repos\Cell\Cell\obj\Debug\net8.0-windows\Cell_dnhiakuf_wpftmp.sourcelink.json", "JSON", 0, 0, 0, 1, 0, 0, 0, 1
"c:\Users\chris\source\repos\Cell\Cell\obj\Debug\net8.0-windows\Cell_dnm4vfif_wpftmp.AssemblyInfo.cs", "C#", 11, 0, 0, 0, 0, 10, 5, 26
"c:\Users\chris\source\repos\Cell\Cell\obj\Debug\net8.0-windows\Cell_dnm4vfif_wpftmp.GeneratedMSBuildEditorConfig.editorconfig", "Properties", 0, 0, 0, 0, 21, 0, 1, 22
"c:\Users\chris\source\repos\Cell\Cell\obj\Debug\net8.0-windows\Cell_dnm4vfif_wpftmp.GlobalUsings.g.cs", "C#", 5, 0, 0, 0, 0, 1, 1, 7
"c:\Users\chris\source\repos\Cell\Cell\obj\Debug\net8.0-windows\Cell_dnm4vfif_wpftmp.sourcelink.json", "JSON", 0, 0, 0, 1, 0, 0, 0, 1
"c:\Users\chris\source\repos\Cell\Cell\obj\Debug\net8.0-windows\Cell_dpwemtiy_wpftmp.AssemblyInfo.cs", "C#", 11, 0, 0, 0, 0, 10, 5, 26
"c:\Users\chris\source\repos\Cell\Cell\obj\Debug\net8.0-windows\Cell_dpwemtiy_wpftmp.GeneratedMSBuildEditorConfig.editorconfig", "Properties", 0, 0, 0, 0, 13, 0, 1, 14
"c:\Users\chris\source\repos\Cell\Cell\obj\Debug\net8.0-windows\Cell_dpwemtiy_wpftmp.GlobalUsings.g.cs", "C#", 5, 0, 0, 0, 0, 1, 1, 7
"c:\Users\chris\source\repos\Cell\Cell\obj\Debug\net8.0-windows\Cell_dpzwozlj_wpftmp.AssemblyInfo.cs", "C#", 11, 0, 0, 0, 0, 10, 5, 26
"c:\Users\chris\source\repos\Cell\Cell\obj\Debug\net8.0-windows\Cell_dpzwozlj_wpftmp.GeneratedMSBuildEditorConfig.editorconfig", "Properties", 0, 0, 0, 0, 21, 0, 1, 22
"c:\Users\chris\source\repos\Cell\Cell\obj\Debug\net8.0-windows\Cell_dpzwozlj_wpftmp.GlobalUsings.g.cs", "C#", 5, 0, 0, 0, 0, 1, 1, 7
"c:\Users\chris\source\repos\Cell\Cell\obj\Debug\net8.0-windows\Cell_dpzwozlj_wpftmp.sourcelink.json", "JSON", 0, 0, 0, 1, 0, 0, 0, 1
"c:\Users\chris\source\repos\Cell\Cell\obj\Debug\net8.0-windows\Cell_dsgfc22d_wpftmp.AssemblyInfo.cs", "C#", 11, 0, 0, 0, 0, 10, 5, 26
"c:\Users\chris\source\repos\Cell\Cell\obj\Debug\net8.0-windows\Cell_dsgfc22d_wpftmp.GeneratedMSBuildEditorConfig.editorconfig", "Properties", 0, 0, 0, 0, 21, 0, 1, 22
"c:\Users\chris\source\repos\Cell\Cell\obj\Debug\net8.0-windows\Cell_dsgfc22d_wpftmp.GlobalUsings.g.cs", "C#", 5, 0, 0, 0, 0, 1, 1, 7
"c:\Users\chris\source\repos\Cell\Cell\obj\Debug\net8.0-windows\Cell_dsgfc22d_wpftmp.sourcelink.json", "JSON", 0, 0, 0, 1, 0, 0, 0, 1
"c:\Users\chris\source\repos\Cell\Cell\obj\Debug\net8.0-windows\Cell_dsgzzvoj_wpftmp.AssemblyInfo.cs", "C#", 11, 0, 0, 0, 0, 10, 5, 26
"c:\Users\chris\source\repos\Cell\Cell\obj\Debug\net8.0-windows\Cell_dsgzzvoj_wpftmp.GeneratedMSBuildEditorConfig.editorconfig", "Properties", 0, 0, 0, 0, 13, 0, 1, 14
"c:\Users\chris\source\repos\Cell\Cell\obj\Debug\net8.0-windows\Cell_dsgzzvoj_wpftmp.GlobalUsings.g.cs", "C#", 5, 0, 0, 0, 0, 1, 1, 7
"c:\Users\chris\source\repos\Cell\Cell\obj\Debug\net8.0-windows\Cell_dsmuj4x2_wpftmp.AssemblyInfo.cs", "C#", 11, 0, 0, 0, 0, 10, 5, 26
"c:\Users\chris\source\repos\Cell\Cell\obj\Debug\net8.0-windows\Cell_dsmuj4x2_wpftmp.GeneratedMSBuildEditorConfig.editorconfig", "Properties", 0, 0, 0, 0, 21, 0, 1, 22
"c:\Users\chris\source\repos\Cell\Cell\obj\Debug\net8.0-windows\Cell_dsmuj4x2_wpftmp.GlobalUsings.g.cs", "C#", 5, 0, 0, 0, 0, 1, 1, 7
"c:\Users\chris\source\repos\Cell\Cell\obj\Debug\net8.0-windows\Cell_dsmuj4x2_wpftmp.sourcelink.json", "JSON", 0, 0, 0, 1, 0, 0, 0, 1
"c:\Users\chris\source\repos\Cell\Cell\obj\Debug\net8.0-windows\Cell_duzz1taz_wpftmp.AssemblyInfo.cs", "C#", 11, 0, 0, 0, 0, 10, 5, 26
"c:\Users\chris\source\repos\Cell\Cell\obj\Debug\net8.0-windows\Cell_duzz1taz_wpftmp.GeneratedMSBuildEditorConfig.editorconfig", "Properties", 0, 0, 0, 0, 21, 0, 1, 22
"c:\Users\chris\source\repos\Cell\Cell\obj\Debug\net8.0-windows\Cell_duzz1taz_wpftmp.GlobalUsings.g.cs", "C#", 5, 0, 0, 0, 0, 1, 1, 7
"c:\Users\chris\source\repos\Cell\Cell\obj\Debug\net8.0-windows\Cell_duzz1taz_wpftmp.sourcelink.json", "JSON", 0, 0, 0, 1, 0, 0, 0, 1
"c:\Users\chris\source\repos\Cell\Cell\obj\Debug\net8.0-windows\Cell_dvza3fjp_wpftmp.AssemblyInfo.cs", "C#", 11, 0, 0, 0, 0, 10, 5, 26
"c:\Users\chris\source\repos\Cell\Cell\obj\Debug\net8.0-windows\Cell_dvza3fjp_wpftmp.GeneratedMSBuildEditorConfig.editorconfig", "Properties", 0, 0, 0, 0, 13, 0, 1, 14
"c:\Users\chris\source\repos\Cell\Cell\obj\Debug\net8.0-windows\Cell_dvza3fjp_wpftmp.GlobalUsings.g.cs", "C#", 5, 0, 0, 0, 0, 1, 1, 7
"c:\Users\chris\source\repos\Cell\Cell\obj\Debug\net8.0-windows\Cell_dwm0ypyn_wpftmp.AssemblyInfo.cs", "C#", 11, 0, 0, 0, 0, 10, 5, 26
"c:\Users\chris\source\repos\Cell\Cell\obj\Debug\net8.0-windows\Cell_dwm0ypyn_wpftmp.GeneratedMSBuildEditorConfig.editorconfig", "Properties", 0, 0, 0, 0, 21, 0, 1, 22
"c:\Users\chris\source\repos\Cell\Cell\obj\Debug\net8.0-windows\Cell_dwm0ypyn_wpftmp.GlobalUsings.g.cs", "C#", 5, 0, 0, 0, 0, 1, 1, 7
"c:\Users\chris\source\repos\Cell\Cell\obj\Debug\net8.0-windows\Cell_dwm0ypyn_wpftmp.sourcelink.json", "JSON", 0, 0, 0, 1, 0, 0, 0, 1
"c:\Users\chris\source\repos\Cell\Cell\obj\Debug\net8.0-windows\Cell_dxuqs0ix_wpftmp.AssemblyInfo.cs", "C#", 11, 0, 0, 0, 0, 10, 5, 26
"c:\Users\chris\source\repos\Cell\Cell\obj\Debug\net8.0-windows\Cell_dxuqs0ix_wpftmp.GeneratedMSBuildEditorConfig.editorconfig", "Properties", 0, 0, 0, 0, 21, 0, 1, 22
"c:\Users\chris\source\repos\Cell\Cell\obj\Debug\net8.0-windows\Cell_dxuqs0ix_wpftmp.GlobalUsings.g.cs", "C#", 5, 0, 0, 0, 0, 1, 1, 7
"c:\Users\chris\source\repos\Cell\Cell\obj\Debug\net8.0-windows\Cell_dxuqs0ix_wpftmp.sourcelink.json", "JSON", 0, 0, 0, 1, 0, 0, 0, 1
"c:\Users\chris\source\repos\Cell\Cell\obj\Debug\net8.0-windows\Cell_dy1fnwak_wpftmp.AssemblyInfo.cs", "C#", 11, 0, 0, 0, 0, 10, 5, 26
"c:\Users\chris\source\repos\Cell\Cell\obj\Debug\net8.0-windows\Cell_dy1fnwak_wpftmp.GeneratedMSBuildEditorConfig.editorconfig", "Properties", 0, 0, 0, 0, 13, 0, 1, 14
"c:\Users\chris\source\repos\Cell\Cell\obj\Debug\net8.0-windows\Cell_dy1fnwak_wpftmp.GlobalUsings.g.cs", "C#", 5, 0, 0, 0, 0, 1, 1, 7
"c:\Users\chris\source\repos\Cell\Cell\obj\Debug\net8.0-windows\Cell_dy5akh0r_wpftmp.AssemblyInfo.cs", "C#", 11, 0, 0, 0, 0, 10, 5, 26
"c:\Users\chris\source\repos\Cell\Cell\obj\Debug\net8.0-windows\Cell_dy5akh0r_wpftmp.GeneratedMSBuildEditorConfig.editorconfig", "Properties", 0, 0, 0, 0, 21, 0, 1, 22
"c:\Users\chris\source\repos\Cell\Cell\obj\Debug\net8.0-windows\Cell_dy5akh0r_wpftmp.GlobalUsings.g.cs", "C#", 5, 0, 0, 0, 0, 1, 1, 7
"c:\Users\chris\source\repos\Cell\Cell\obj\Debug\net8.0-windows\Cell_dy5akh0r_wpftmp.sourcelink.json", "JSON", 0, 0, 0, 1, 0, 0, 0, 1
"c:\Users\chris\source\repos\Cell\Cell\obj\Debug\net8.0-windows\Cell_dy5mqma2_wpftmp.AssemblyInfo.cs", "C#", 11, 0, 0, 0, 0, 10, 5, 26
"c:\Users\chris\source\repos\Cell\Cell\obj\Debug\net8.0-windows\Cell_dy5mqma2_wpftmp.GeneratedMSBuildEditorConfig.editorconfig", "Properties", 0, 0, 0, 0, 21, 0, 1, 22
"c:\Users\chris\source\repos\Cell\Cell\obj\Debug\net8.0-windows\Cell_dy5mqma2_wpftmp.GlobalUsings.g.cs", "C#", 5, 0, 0, 0, 0, 1, 1, 7
"c:\Users\chris\source\repos\Cell\Cell\obj\Debug\net8.0-windows\Cell_dy5mqma2_wpftmp.sourcelink.json", "JSON", 0, 0, 0, 1, 0, 0, 0, 1
"c:\Users\chris\source\repos\Cell\Cell\obj\Debug\net8.0-windows\Cell_dyaasoc4_wpftmp.AssemblyInfo.cs", "C#", 11, 0, 0, 0, 0, 10, 5, 26
"c:\Users\chris\source\repos\Cell\Cell\obj\Debug\net8.0-windows\Cell_dyaasoc4_wpftmp.GeneratedMSBuildEditorConfig.editorconfig", "Properties", 0, 0, 0, 0, 21, 0, 1, 22
"c:\Users\chris\source\repos\Cell\Cell\obj\Debug\net8.0-windows\Cell_dyaasoc4_wpftmp.GlobalUsings.g.cs", "C#", 5, 0, 0, 0, 0, 1, 1, 7
"c:\Users\chris\source\repos\Cell\Cell\obj\Debug\net8.0-windows\Cell_dyaasoc4_wpftmp.sourcelink.json", "JSON", 0, 0, 0, 1, 0, 0, 0, 1
"c:\Users\chris\source\repos\Cell\Cell\obj\Debug\net8.0-windows\Cell_dyglifi2_wpftmp.AssemblyInfo.cs", "C#", 11, 0, 0, 0, 0, 10, 5, 26
"c:\Users\chris\source\repos\Cell\Cell\obj\Debug\net8.0-windows\Cell_dyglifi2_wpftmp.GeneratedMSBuildEditorConfig.editorconfig", "Properties", 0, 0, 0, 0, 21, 0, 1, 22
"c:\Users\chris\source\repos\Cell\Cell\obj\Debug\net8.0-windows\Cell_dyglifi2_wpftmp.GlobalUsings.g.cs", "C#", 5, 0, 0, 0, 0, 1, 1, 7
"c:\Users\chris\source\repos\Cell\Cell\obj\Debug\net8.0-windows\Cell_dyglifi2_wpftmp.sourcelink.json", "JSON", 0, 0, 0, 1, 0, 0, 0, 1
"c:\Users\chris\source\repos\Cell\Cell\obj\Debug\net8.0-windows\Cell_dymlmeai_wpftmp.AssemblyInfo.cs", "C#", 11, 0, 0, 0, 0, 10, 5, 26
"c:\Users\chris\source\repos\Cell\Cell\obj\Debug\net8.0-windows\Cell_dymlmeai_wpftmp.GeneratedMSBuildEditorConfig.editorconfig", "Properties", 0, 0, 0, 0, 21, 0, 1, 22
"c:\Users\chris\source\repos\Cell\Cell\obj\Debug\net8.0-windows\Cell_dymlmeai_wpftmp.GlobalUsings.g.cs", "C#", 5, 0, 0, 0, 0, 1, 1, 7
"c:\Users\chris\source\repos\Cell\Cell\obj\Debug\net8.0-windows\Cell_dymlmeai_wpftmp.sourcelink.json", "JSON", 0, 0, 0, 1, 0, 0, 0, 1
"c:\Users\chris\source\repos\Cell\Cell\obj\Debug\net8.0-windows\Cell_dz50ur2n_wpftmp.AssemblyInfo.cs", "C#", 11, 0, 0, 0, 0, 10, 5, 26
"c:\Users\chris\source\repos\Cell\Cell\obj\Debug\net8.0-windows\Cell_dz50ur2n_wpftmp.GeneratedMSBuildEditorConfig.editorconfig", "Properties", 0, 0, 0, 0, 21, 0, 1, 22
"c:\Users\chris\source\repos\Cell\Cell\obj\Debug\net8.0-windows\Cell_dz50ur2n_wpftmp.GlobalUsings.g.cs", "C#", 5, 0, 0, 0, 0, 1, 1, 7
"c:\Users\chris\source\repos\Cell\Cell\obj\Debug\net8.0-windows\Cell_dz50ur2n_wpftmp.sourcelink.json", "JSON", 0, 0, 0, 1, 0, 0, 0, 1
"c:\Users\chris\source\repos\Cell\Cell\obj\Debug\net8.0-windows\Cell_dzwomx2f_wpftmp.AssemblyInfo.cs", "C#", 11, 0, 0, 0, 0, 10, 5, 26
"c:\Users\chris\source\repos\Cell\Cell\obj\Debug\net8.0-windows\Cell_dzwomx2f_wpftmp.GeneratedMSBuildEditorConfig.editorconfig", "Properties", 0, 0, 0, 0, 21, 0, 1, 22
"c:\Users\chris\source\repos\Cell\Cell\obj\Debug\net8.0-windows\Cell_dzwomx2f_wpftmp.GlobalUsings.g.cs", "C#", 5, 0, 0, 0, 0, 1, 1, 7
"c:\Users\chris\source\repos\Cell\Cell\obj\Debug\net8.0-windows\Cell_dzwomx2f_wpftmp.sourcelink.json", "JSON", 0, 0, 0, 1, 0, 0, 0, 1
"c:\Users\chris\source\repos\Cell\Cell\obj\Debug\net8.0-windows\Cell_e04qwf2d_wpftmp.AssemblyInfo.cs", "C#", 11, 0, 0, 0, 0, 10, 5, 26
"c:\Users\chris\source\repos\Cell\Cell\obj\Debug\net8.0-windows\Cell_e04qwf2d_wpftmp.GeneratedMSBuildEditorConfig.editorconfig", "Properties", 0, 0, 0, 0, 21, 0, 1, 22
"c:\Users\chris\source\repos\Cell\Cell\obj\Debug\net8.0-windows\Cell_e04qwf2d_wpftmp.GlobalUsings.g.cs", "C#", 5, 0, 0, 0, 0, 1, 1, 7
"c:\Users\chris\source\repos\Cell\Cell\obj\Debug\net8.0-windows\Cell_e04qwf2d_wpftmp.sourcelink.json", "JSON", 0, 0, 0, 1, 0, 0, 0, 1
"c:\Users\chris\source\repos\Cell\Cell\obj\Debug\net8.0-windows\Cell_e1l3f1rp_wpftmp.AssemblyInfo.cs", "C#", 11, 0, 0, 0, 0, 10, 5, 26
"c:\Users\chris\source\repos\Cell\Cell\obj\Debug\net8.0-windows\Cell_e1l3f1rp_wpftmp.GeneratedMSBuildEditorConfig.editorconfig", "Properties", 0, 0, 0, 0, 21, 0, 1, 22
"c:\Users\chris\source\repos\Cell\Cell\obj\Debug\net8.0-windows\Cell_e1l3f1rp_wpftmp.GlobalUsings.g.cs", "C#", 5, 0, 0, 0, 0, 1, 1, 7
"c:\Users\chris\source\repos\Cell\Cell\obj\Debug\net8.0-windows\Cell_e1l3f1rp_wpftmp.sourcelink.json", "JSON", 0, 0, 0, 1, 0, 0, 0, 1
"c:\Users\chris\source\repos\Cell\Cell\obj\Debug\net8.0-windows\Cell_e1ziteig_wpftmp.AssemblyInfo.cs", "C#", 11, 0, 0, 0, 0, 10, 5, 26
"c:\Users\chris\source\repos\Cell\Cell\obj\Debug\net8.0-windows\Cell_e1ziteig_wpftmp.GeneratedMSBuildEditorConfig.editorconfig", "Properties", 0, 0, 0, 0, 21, 0, 1, 22
"c:\Users\chris\source\repos\Cell\Cell\obj\Debug\net8.0-windows\Cell_e1ziteig_wpftmp.GlobalUsings.g.cs", "C#", 5, 0, 0, 0, 0, 1, 1, 7
"c:\Users\chris\source\repos\Cell\Cell\obj\Debug\net8.0-windows\Cell_e1ziteig_wpftmp.sourcelink.json", "JSON", 0, 0, 0, 1, 0, 0, 0, 1
"c:\Users\chris\source\repos\Cell\Cell\obj\Debug\net8.0-windows\Cell_e2fcobqw_wpftmp.AssemblyInfo.cs", "C#", 11, 0, 0, 0, 0, 10, 5, 26
"c:\Users\chris\source\repos\Cell\Cell\obj\Debug\net8.0-windows\Cell_e2fcobqw_wpftmp.GeneratedMSBuildEditorConfig.editorconfig", "Properties", 0, 0, 0, 0, 21, 0, 1, 22
"c:\Users\chris\source\repos\Cell\Cell\obj\Debug\net8.0-windows\Cell_e2fcobqw_wpftmp.GlobalUsings.g.cs", "C#", 5, 0, 0, 0, 0, 1, 1, 7
"c:\Users\chris\source\repos\Cell\Cell\obj\Debug\net8.0-windows\Cell_e2fcobqw_wpftmp.sourcelink.json", "JSON", 0, 0, 0, 1, 0, 0, 0, 1
"c:\Users\chris\source\repos\Cell\Cell\obj\Debug\net8.0-windows\Cell_e2ixtjov_wpftmp.AssemblyInfo.cs", "C#", 11, 0, 0, 0, 0, 10, 5, 26
"c:\Users\chris\source\repos\Cell\Cell\obj\Debug\net8.0-windows\Cell_e2ixtjov_wpftmp.GeneratedMSBuildEditorConfig.editorconfig", "Properties", 0, 0, 0, 0, 21, 0, 1, 22
"c:\Users\chris\source\repos\Cell\Cell\obj\Debug\net8.0-windows\Cell_e2ixtjov_wpftmp.GlobalUsings.g.cs", "C#", 5, 0, 0, 0, 0, 1, 1, 7
"c:\Users\chris\source\repos\Cell\Cell\obj\Debug\net8.0-windows\Cell_e2ixtjov_wpftmp.sourcelink.json", "JSON", 0, 0, 0, 1, 0, 0, 0, 1
"c:\Users\chris\source\repos\Cell\Cell\obj\Debug\net8.0-windows\Cell_e3blxpd4_wpftmp.AssemblyInfo.cs", "C#", 11, 0, 0, 0, 0, 10, 5, 26
"c:\Users\chris\source\repos\Cell\Cell\obj\Debug\net8.0-windows\Cell_e3blxpd4_wpftmp.GeneratedMSBuildEditorConfig.editorconfig", "Properties", 0, 0, 0, 0, 21, 0, 1, 22
"c:\Users\chris\source\repos\Cell\Cell\obj\Debug\net8.0-windows\Cell_e3blxpd4_wpftmp.GlobalUsings.g.cs", "C#", 5, 0, 0, 0, 0, 1, 1, 7
"c:\Users\chris\source\repos\Cell\Cell\obj\Debug\net8.0-windows\Cell_e3blxpd4_wpftmp.sourcelink.json", "JSON", 0, 0, 0, 1, 0, 0, 0, 1
"c:\Users\chris\source\repos\Cell\Cell\obj\Debug\net8.0-windows\Cell_e3ksrbhp_wpftmp.AssemblyInfo.cs", "C#", 11, 0, 0, 0, 0, 10, 5, 26
"c:\Users\chris\source\repos\Cell\Cell\obj\Debug\net8.0-windows\Cell_e3ksrbhp_wpftmp.GeneratedMSBuildEditorConfig.editorconfig", "Properties", 0, 0, 0, 0, 21, 0, 1, 22
"c:\Users\chris\source\repos\Cell\Cell\obj\Debug\net8.0-windows\Cell_e3ksrbhp_wpftmp.GlobalUsings.g.cs", "C#", 5, 0, 0, 0, 0, 1, 1, 7
"c:\Users\chris\source\repos\Cell\Cell\obj\Debug\net8.0-windows\Cell_e3ksrbhp_wpftmp.sourcelink.json", "JSON", 0, 0, 0, 1, 0, 0, 0, 1
"c:\Users\chris\source\repos\Cell\Cell\obj\Debug\net8.0-windows\Cell_e4bdo50b_wpftmp.AssemblyInfo.cs", "C#", 11, 0, 0, 0, 0, 10, 5, 26
"c:\Users\chris\source\repos\Cell\Cell\obj\Debug\net8.0-windows\Cell_e4bdo50b_wpftmp.GeneratedMSBuildEditorConfig.editorconfig", "Properties", 0, 0, 0, 0, 13, 0, 1, 14
"c:\Users\chris\source\repos\Cell\Cell\obj\Debug\net8.0-windows\Cell_e4bdo50b_wpftmp.GlobalUsings.g.cs", "C#", 5, 0, 0, 0, 0, 1, 1, 7
"c:\Users\chris\source\repos\Cell\Cell\obj\Debug\net8.0-windows\Cell_e4s5mu24_wpftmp.AssemblyInfo.cs", "C#", 11, 0, 0, 0, 0, 10, 5, 26
"c:\Users\chris\source\repos\Cell\Cell\obj\Debug\net8.0-windows\Cell_e4s5mu24_wpftmp.GeneratedMSBuildEditorConfig.editorconfig", "Properties", 0, 0, 0, 0, 13, 0, 1, 14
"c:\Users\chris\source\repos\Cell\Cell\obj\Debug\net8.0-windows\Cell_e4s5mu24_wpftmp.GlobalUsings.g.cs", "C#", 5, 0, 0, 0, 0, 1, 1, 7
"c:\Users\chris\source\repos\Cell\Cell\obj\Debug\net8.0-windows\Cell_e4zcizt1_wpftmp.AssemblyInfo.cs", "C#", 11, 0, 0, 0, 0, 10, 5, 26
"c:\Users\chris\source\repos\Cell\Cell\obj\Debug\net8.0-windows\Cell_e4zcizt1_wpftmp.GeneratedMSBuildEditorConfig.editorconfig", "Properties", 0, 0, 0, 0, 21, 0, 1, 22
"c:\Users\chris\source\repos\Cell\Cell\obj\Debug\net8.0-windows\Cell_e4zcizt1_wpftmp.GlobalUsings.g.cs", "C#", 5, 0, 0, 0, 0, 1, 1, 7
"c:\Users\chris\source\repos\Cell\Cell\obj\Debug\net8.0-windows\Cell_e4zcizt1_wpftmp.sourcelink.json", "JSON", 0, 0, 0, 1, 0, 0, 0, 1
"c:\Users\chris\source\repos\Cell\Cell\obj\Debug\net8.0-windows\Cell_e54hdrn4_wpftmp.AssemblyInfo.cs", "C#", 11, 0, 0, 0, 0, 10, 5, 26
"c:\Users\chris\source\repos\Cell\Cell\obj\Debug\net8.0-windows\Cell_e54hdrn4_wpftmp.GeneratedMSBuildEditorConfig.editorconfig", "Properties", 0, 0, 0, 0, 21, 0, 1, 22
"c:\Users\chris\source\repos\Cell\Cell\obj\Debug\net8.0-windows\Cell_e54hdrn4_wpftmp.GlobalUsings.g.cs", "C#", 5, 0, 0, 0, 0, 1, 1, 7
"c:\Users\chris\source\repos\Cell\Cell\obj\Debug\net8.0-windows\Cell_e54hdrn4_wpftmp.sourcelink.json", "JSON", 0, 0, 0, 1, 0, 0, 0, 1
"c:\Users\chris\source\repos\Cell\Cell\obj\Debug\net8.0-windows\Cell_eareezgk_wpftmp.AssemblyInfo.cs", "C#", 11, 0, 0, 0, 0, 10, 5, 26
"c:\Users\chris\source\repos\Cell\Cell\obj\Debug\net8.0-windows\Cell_eareezgk_wpftmp.GeneratedMSBuildEditorConfig.editorconfig", "Properties", 0, 0, 0, 0, 21, 0, 1, 22
"c:\Users\chris\source\repos\Cell\Cell\obj\Debug\net8.0-windows\Cell_eareezgk_wpftmp.GlobalUsings.g.cs", "C#", 5, 0, 0, 0, 0, 1, 1, 7
"c:\Users\chris\source\repos\Cell\Cell\obj\Debug\net8.0-windows\Cell_eareezgk_wpftmp.sourcelink.json", "JSON", 0, 0, 0, 1, 0, 0, 0, 1
"c:\Users\chris\source\repos\Cell\Cell\obj\Debug\net8.0-windows\Cell_eb2nunep_wpftmp.AssemblyInfo.cs", "C#", 11, 0, 0, 0, 0, 10, 5, 26
"c:\Users\chris\source\repos\Cell\Cell\obj\Debug\net8.0-windows\Cell_eb2nunep_wpftmp.GeneratedMSBuildEditorConfig.editorconfig", "Properties", 0, 0, 0, 0, 21, 0, 1, 22
"c:\Users\chris\source\repos\Cell\Cell\obj\Debug\net8.0-windows\Cell_eb2nunep_wpftmp.GlobalUsings.g.cs", "C#", 5, 0, 0, 0, 0, 1, 1, 7
"c:\Users\chris\source\repos\Cell\Cell\obj\Debug\net8.0-windows\Cell_eb2nunep_wpftmp.sourcelink.json", "JSON", 0, 0, 0, 1, 0, 0, 0, 1
"c:\Users\chris\source\repos\Cell\Cell\obj\Debug\net8.0-windows\Cell_eb5bnby3_wpftmp.AssemblyInfo.cs", "C#", 11, 0, 0, 0, 0, 10, 5, 26
"c:\Users\chris\source\repos\Cell\Cell\obj\Debug\net8.0-windows\Cell_eb5bnby3_wpftmp.GeneratedMSBuildEditorConfig.editorconfig", "Properties", 0, 0, 0, 0, 13, 0, 1, 14
"c:\Users\chris\source\repos\Cell\Cell\obj\Debug\net8.0-windows\Cell_eb5bnby3_wpftmp.GlobalUsings.g.cs", "C#", 5, 0, 0, 0, 0, 1, 1, 7
"c:\Users\chris\source\repos\Cell\Cell\obj\Debug\net8.0-windows\Cell_ecpi3cbc_wpftmp.AssemblyInfo.cs", "C#", 11, 0, 0, 0, 0, 10, 5, 26
"c:\Users\chris\source\repos\Cell\Cell\obj\Debug\net8.0-windows\Cell_ecpi3cbc_wpftmp.GeneratedMSBuildEditorConfig.editorconfig", "Properties", 0, 0, 0, 0, 21, 0, 1, 22
"c:\Users\chris\source\repos\Cell\Cell\obj\Debug\net8.0-windows\Cell_ecpi3cbc_wpftmp.GlobalUsings.g.cs", "C#", 5, 0, 0, 0, 0, 1, 1, 7
"c:\Users\chris\source\repos\Cell\Cell\obj\Debug\net8.0-windows\Cell_ecpi3cbc_wpftmp.sourcelink.json", "JSON", 0, 0, 0, 1, 0, 0, 0, 1
"c:\Users\chris\source\repos\Cell\Cell\obj\Debug\net8.0-windows\Cell_ed3fzlxa_wpftmp.AssemblyInfo.cs", "C#", 11, 0, 0, 0, 0, 10, 5, 26
"c:\Users\chris\source\repos\Cell\Cell\obj\Debug\net8.0-windows\Cell_ed3fzlxa_wpftmp.GeneratedMSBuildEditorConfig.editorconfig", "Properties", 0, 0, 0, 0, 21, 0, 1, 22
"c:\Users\chris\source\repos\Cell\Cell\obj\Debug\net8.0-windows\Cell_ed3fzlxa_wpftmp.GlobalUsings.g.cs", "C#", 5, 0, 0, 0, 0, 1, 1, 7
"c:\Users\chris\source\repos\Cell\Cell\obj\Debug\net8.0-windows\Cell_ed3fzlxa_wpftmp.sourcelink.json", "JSON", 0, 0, 0, 1, 0, 0, 0, 1
"c:\Users\chris\source\repos\Cell\Cell\obj\Debug\net8.0-windows\Cell_edehkmwk_wpftmp.AssemblyInfo.cs", "C#", 11, 0, 0, 0, 0, 10, 5, 26
"c:\Users\chris\source\repos\Cell\Cell\obj\Debug\net8.0-windows\Cell_edehkmwk_wpftmp.GeneratedMSBuildEditorConfig.editorconfig", "Properties", 0, 0, 0, 0, 21, 0, 1, 22
"c:\Users\chris\source\repos\Cell\Cell\obj\Debug\net8.0-windows\Cell_edehkmwk_wpftmp.GlobalUsings.g.cs", "C#", 5, 0, 0, 0, 0, 1, 1, 7
"c:\Users\chris\source\repos\Cell\Cell\obj\Debug\net8.0-windows\Cell_edehkmwk_wpftmp.sourcelink.json", "JSON", 0, 0, 0, 1, 0, 0, 0, 1
"c:\Users\chris\source\repos\Cell\Cell\obj\Debug\net8.0-windows\Cell_edobswbt_wpftmp.AssemblyInfo.cs", "C#", 11, 0, 0, 0, 0, 10, 5, 26
"c:\Users\chris\source\repos\Cell\Cell\obj\Debug\net8.0-windows\Cell_edobswbt_wpftmp.GeneratedMSBuildEditorConfig.editorconfig", "Properties", 0, 0, 0, 0, 21, 0, 1, 22
"c:\Users\chris\source\repos\Cell\Cell\obj\Debug\net8.0-windows\Cell_edobswbt_wpftmp.GlobalUsings.g.cs", "C#", 5, 0, 0, 0, 0, 1, 1, 7
"c:\Users\chris\source\repos\Cell\Cell\obj\Debug\net8.0-windows\Cell_edobswbt_wpftmp.sourcelink.json", "JSON", 0, 0, 0, 1, 0, 0, 0, 1
"c:\Users\chris\source\repos\Cell\Cell\obj\Debug\net8.0-windows\Cell_edqggb41_wpftmp.AssemblyInfo.cs", "C#", 11, 0, 0, 0, 0, 10, 5, 26
"c:\Users\chris\source\repos\Cell\Cell\obj\Debug\net8.0-windows\Cell_edqggb41_wpftmp.GeneratedMSBuildEditorConfig.editorconfig", "Properties", 0, 0, 0, 0, 21, 0, 1, 22
"c:\Users\chris\source\repos\Cell\Cell\obj\Debug\net8.0-windows\Cell_edqggb41_wpftmp.GlobalUsings.g.cs", "C#", 5, 0, 0, 0, 0, 1, 1, 7
"c:\Users\chris\source\repos\Cell\Cell\obj\Debug\net8.0-windows\Cell_edqggb41_wpftmp.sourcelink.json", "JSON", 0, 0, 0, 1, 0, 0, 0, 1
"c:\Users\chris\source\repos\Cell\Cell\obj\Debug\net8.0-windows\Cell_ee1iharf_wpftmp.AssemblyInfo.cs", "C#", 11, 0, 0, 0, 0, 10, 5, 26
"c:\Users\chris\source\repos\Cell\Cell\obj\Debug\net8.0-windows\Cell_ee1iharf_wpftmp.GeneratedMSBuildEditorConfig.editorconfig", "Properties", 0, 0, 0, 0, 21, 0, 1, 22
"c:\Users\chris\source\repos\Cell\Cell\obj\Debug\net8.0-windows\Cell_ee1iharf_wpftmp.GlobalUsings.g.cs", "C#", 5, 0, 0, 0, 0, 1, 1, 7
"c:\Users\chris\source\repos\Cell\Cell\obj\Debug\net8.0-windows\Cell_ee1iharf_wpftmp.sourcelink.json", "JSON", 0, 0, 0, 1, 0, 0, 0, 1
"c:\Users\chris\source\repos\Cell\Cell\obj\Debug\net8.0-windows\Cell_ee2yfxay_wpftmp.AssemblyInfo.cs", "C#", 11, 0, 0, 0, 0, 10, 5, 26
"c:\Users\chris\source\repos\Cell\Cell\obj\Debug\net8.0-windows\Cell_ee2yfxay_wpftmp.GeneratedMSBuildEditorConfig.editorconfig", "Properties", 0, 0, 0, 0, 21, 0, 1, 22
"c:\Users\chris\source\repos\Cell\Cell\obj\Debug\net8.0-windows\Cell_ee2yfxay_wpftmp.GlobalUsings.g.cs", "C#", 5, 0, 0, 0, 0, 1, 1, 7
"c:\Users\chris\source\repos\Cell\Cell\obj\Debug\net8.0-windows\Cell_ee2yfxay_wpftmp.sourcelink.json", "JSON", 0, 0, 0, 1, 0, 0, 0, 1
"c:\Users\chris\source\repos\Cell\Cell\obj\Debug\net8.0-windows\Cell_eeicdhbg_wpftmp.AssemblyInfo.cs", "C#", 11, 0, 0, 0, 0, 10, 5, 26
"c:\Users\chris\source\repos\Cell\Cell\obj\Debug\net8.0-windows\Cell_eeicdhbg_wpftmp.GeneratedMSBuildEditorConfig.editorconfig", "Properties", 0, 0, 0, 0, 13, 0, 1, 14
"c:\Users\chris\source\repos\Cell\Cell\obj\Debug\net8.0-windows\Cell_eeicdhbg_wpftmp.GlobalUsings.g.cs", "C#", 5, 0, 0, 0, 0, 1, 1, 7
"c:\Users\chris\source\repos\Cell\Cell\obj\Debug\net8.0-windows\Cell_ef3pduto_wpftmp.AssemblyInfo.cs", "C#", 11, 0, 0, 0, 0, 10, 5, 26
"c:\Users\chris\source\repos\Cell\Cell\obj\Debug\net8.0-windows\Cell_ef3pduto_wpftmp.GeneratedMSBuildEditorConfig.editorconfig", "Properties", 0, 0, 0, 0, 21, 0, 1, 22
"c:\Users\chris\source\repos\Cell\Cell\obj\Debug\net8.0-windows\Cell_ef3pduto_wpftmp.GlobalUsings.g.cs", "C#", 5, 0, 0, 0, 0, 1, 1, 7
"c:\Users\chris\source\repos\Cell\Cell\obj\Debug\net8.0-windows\Cell_ef3pduto_wpftmp.sourcelink.json", "JSON", 0, 0, 0, 1, 0, 0, 0, 1
"c:\Users\chris\source\repos\Cell\Cell\obj\Debug\net8.0-windows\Cell_efbvyiup_wpftmp.AssemblyInfo.cs", "C#", 11, 0, 0, 0, 0, 10, 5, 26
"c:\Users\chris\source\repos\Cell\Cell\obj\Debug\net8.0-windows\Cell_efbvyiup_wpftmp.GeneratedMSBuildEditorConfig.editorconfig", "Properties", 0, 0, 0, 0, 21, 0, 1, 22
"c:\Users\chris\source\repos\Cell\Cell\obj\Debug\net8.0-windows\Cell_efbvyiup_wpftmp.GlobalUsings.g.cs", "C#", 5, 0, 0, 0, 0, 1, 1, 7
"c:\Users\chris\source\repos\Cell\Cell\obj\Debug\net8.0-windows\Cell_efbvyiup_wpftmp.sourcelink.json", "JSON", 0, 0, 0, 1, 0, 0, 0, 1
"c:\Users\chris\source\repos\Cell\Cell\obj\Debug\net8.0-windows\Cell_efjmxe5n_wpftmp.AssemblyInfo.cs", "C#", 11, 0, 0, 0, 0, 10, 5, 26
"c:\Users\chris\source\repos\Cell\Cell\obj\Debug\net8.0-windows\Cell_efjmxe5n_wpftmp.GeneratedMSBuildEditorConfig.editorconfig", "Properties", 0, 0, 0, 0, 21, 0, 1, 22
"c:\Users\chris\source\repos\Cell\Cell\obj\Debug\net8.0-windows\Cell_efjmxe5n_wpftmp.GlobalUsings.g.cs", "C#", 5, 0, 0, 0, 0, 1, 1, 7
"c:\Users\chris\source\repos\Cell\Cell\obj\Debug\net8.0-windows\Cell_efjmxe5n_wpftmp.sourcelink.json", "JSON", 0, 0, 0, 1, 0, 0, 0, 1
"c:\Users\chris\source\repos\Cell\Cell\obj\Debug\net8.0-windows\Cell_eg4tt3cu_wpftmp.AssemblyInfo.cs", "C#", 11, 0, 0, 0, 0, 10, 5, 26
"c:\Users\chris\source\repos\Cell\Cell\obj\Debug\net8.0-windows\Cell_eg4tt3cu_wpftmp.GeneratedMSBuildEditorConfig.editorconfig", "Properties", 0, 0, 0, 0, 21, 0, 1, 22
"c:\Users\chris\source\repos\Cell\Cell\obj\Debug\net8.0-windows\Cell_eg4tt3cu_wpftmp.GlobalUsings.g.cs", "C#", 5, 0, 0, 0, 0, 1, 1, 7
"c:\Users\chris\source\repos\Cell\Cell\obj\Debug\net8.0-windows\Cell_eg4tt3cu_wpftmp.sourcelink.json", "JSON", 0, 0, 0, 1, 0, 0, 0, 1
"c:\Users\chris\source\repos\Cell\Cell\obj\Debug\net8.0-windows\Cell_eiazn3p2_wpftmp.AssemblyInfo.cs", "C#", 11, 0, 0, 0, 0, 10, 5, 26
"c:\Users\chris\source\repos\Cell\Cell\obj\Debug\net8.0-windows\Cell_eiazn3p2_wpftmp.GeneratedMSBuildEditorConfig.editorconfig", "Properties", 0, 0, 0, 0, 21, 0, 1, 22
"c:\Users\chris\source\repos\Cell\Cell\obj\Debug\net8.0-windows\Cell_eiazn3p2_wpftmp.GlobalUsings.g.cs", "C#", 5, 0, 0, 0, 0, 1, 1, 7
"c:\Users\chris\source\repos\Cell\Cell\obj\Debug\net8.0-windows\Cell_eiazn3p2_wpftmp.sourcelink.json", "JSON", 0, 0, 0, 1, 0, 0, 0, 1
"c:\Users\chris\source\repos\Cell\Cell\obj\Debug\net8.0-windows\Cell_eilmvckx_wpftmp.AssemblyInfo.cs", "C#", 11, 0, 0, 0, 0, 10, 5, 26
"c:\Users\chris\source\repos\Cell\Cell\obj\Debug\net8.0-windows\Cell_eilmvckx_wpftmp.GeneratedMSBuildEditorConfig.editorconfig", "Properties", 0, 0, 0, 0, 21, 0, 1, 22
"c:\Users\chris\source\repos\Cell\Cell\obj\Debug\net8.0-windows\Cell_eilmvckx_wpftmp.GlobalUsings.g.cs", "C#", 5, 0, 0, 0, 0, 1, 1, 7
"c:\Users\chris\source\repos\Cell\Cell\obj\Debug\net8.0-windows\Cell_eilmvckx_wpftmp.sourcelink.json", "JSON", 0, 0, 0, 1, 0, 0, 0, 1
"c:\Users\chris\source\repos\Cell\Cell\obj\Debug\net8.0-windows\Cell_ejfhzjou_wpftmp.AssemblyInfo.cs", "C#", 11, 0, 0, 0, 0, 10, 5, 26
"c:\Users\chris\source\repos\Cell\Cell\obj\Debug\net8.0-windows\Cell_ejfhzjou_wpftmp.GeneratedMSBuildEditorConfig.editorconfig", "Properties", 0, 0, 0, 0, 21, 0, 1, 22
"c:\Users\chris\source\repos\Cell\Cell\obj\Debug\net8.0-windows\Cell_ejfhzjou_wpftmp.GlobalUsings.g.cs", "C#", 5, 0, 0, 0, 0, 1, 1, 7
"c:\Users\chris\source\repos\Cell\Cell\obj\Debug\net8.0-windows\Cell_ejfhzjou_wpftmp.sourcelink.json", "JSON", 0, 0, 0, 1, 0, 0, 0, 1
"c:\Users\chris\source\repos\Cell\Cell\obj\Debug\net8.0-windows\Cell_ejijqn4k_wpftmp.AssemblyInfo.cs", "C#", 11, 0, 0, 0, 0, 10, 5, 26
"c:\Users\chris\source\repos\Cell\Cell\obj\Debug\net8.0-windows\Cell_ejijqn4k_wpftmp.GeneratedMSBuildEditorConfig.editorconfig", "Properties", 0, 0, 0, 0, 21, 0, 1, 22
"c:\Users\chris\source\repos\Cell\Cell\obj\Debug\net8.0-windows\Cell_ejijqn4k_wpftmp.GlobalUsings.g.cs", "C#", 5, 0, 0, 0, 0, 1, 1, 7
"c:\Users\chris\source\repos\Cell\Cell\obj\Debug\net8.0-windows\Cell_ejijqn4k_wpftmp.sourcelink.json", "JSON", 0, 0, 0, 1, 0, 0, 0, 1
"c:\Users\chris\source\repos\Cell\Cell\obj\Debug\net8.0-windows\Cell_enifazlc_wpftmp.AssemblyInfo.cs", "C#", 11, 0, 0, 0, 0, 10, 5, 26
"c:\Users\chris\source\repos\Cell\Cell\obj\Debug\net8.0-windows\Cell_enifazlc_wpftmp.GeneratedMSBuildEditorConfig.editorconfig", "Properties", 0, 0, 0, 0, 21, 0, 1, 22
"c:\Users\chris\source\repos\Cell\Cell\obj\Debug\net8.0-windows\Cell_enifazlc_wpftmp.GlobalUsings.g.cs", "C#", 5, 0, 0, 0, 0, 1, 1, 7
"c:\Users\chris\source\repos\Cell\Cell\obj\Debug\net8.0-windows\Cell_enifazlc_wpftmp.sourcelink.json", "JSON", 0, 0, 0, 1, 0, 0, 0, 1
"c:\Users\chris\source\repos\Cell\Cell\obj\Debug\net8.0-windows\Cell_eoc45iak_wpftmp.AssemblyInfo.cs", "C#", 11, 0, 0, 0, 0, 10, 5, 26
"c:\Users\chris\source\repos\Cell\Cell\obj\Debug\net8.0-windows\Cell_eoc45iak_wpftmp.GeneratedMSBuildEditorConfig.editorconfig", "Properties", 0, 0, 0, 0, 21, 0, 1, 22
"c:\Users\chris\source\repos\Cell\Cell\obj\Debug\net8.0-windows\Cell_eoc45iak_wpftmp.GlobalUsings.g.cs", "C#", 5, 0, 0, 0, 0, 1, 1, 7
"c:\Users\chris\source\repos\Cell\Cell\obj\Debug\net8.0-windows\Cell_eoc45iak_wpftmp.sourcelink.json", "JSON", 0, 0, 0, 1, 0, 0, 0, 1
"c:\Users\chris\source\repos\Cell\Cell\obj\Debug\net8.0-windows\Cell_eph1ypyk_wpftmp.AssemblyInfo.cs", "C#", 11, 0, 0, 0, 0, 10, 5, 26
"c:\Users\chris\source\repos\Cell\Cell\obj\Debug\net8.0-windows\Cell_eph1ypyk_wpftmp.GeneratedMSBuildEditorConfig.editorconfig", "Properties", 0, 0, 0, 0, 21, 0, 1, 22
"c:\Users\chris\source\repos\Cell\Cell\obj\Debug\net8.0-windows\Cell_eph1ypyk_wpftmp.GlobalUsings.g.cs", "C#", 5, 0, 0, 0, 0, 1, 1, 7
"c:\Users\chris\source\repos\Cell\Cell\obj\Debug\net8.0-windows\Cell_eph1ypyk_wpftmp.sourcelink.json", "JSON", 0, 0, 0, 1, 0, 0, 0, 1
"c:\Users\chris\source\repos\Cell\Cell\obj\Debug\net8.0-windows\Cell_etombwe2_wpftmp.AssemblyInfo.cs", "C#", 11, 0, 0, 0, 0, 10, 5, 26
"c:\Users\chris\source\repos\Cell\Cell\obj\Debug\net8.0-windows\Cell_etombwe2_wpftmp.GeneratedMSBuildEditorConfig.editorconfig", "Properties", 0, 0, 0, 0, 21, 0, 1, 22
"c:\Users\chris\source\repos\Cell\Cell\obj\Debug\net8.0-windows\Cell_etombwe2_wpftmp.GlobalUsings.g.cs", "C#", 5, 0, 0, 0, 0, 1, 1, 7
"c:\Users\chris\source\repos\Cell\Cell\obj\Debug\net8.0-windows\Cell_etombwe2_wpftmp.sourcelink.json", "JSON", 0, 0, 0, 1, 0, 0, 0, 1
"c:\Users\chris\source\repos\Cell\Cell\obj\Debug\net8.0-windows\Cell_eu0xwvjs_wpftmp.AssemblyInfo.cs", "C#", 11, 0, 0, 0, 0, 10, 5, 26
"c:\Users\chris\source\repos\Cell\Cell\obj\Debug\net8.0-windows\Cell_eu0xwvjs_wpftmp.GeneratedMSBuildEditorConfig.editorconfig", "Properties", 0, 0, 0, 0, 21, 0, 1, 22
"c:\Users\chris\source\repos\Cell\Cell\obj\Debug\net8.0-windows\Cell_eu0xwvjs_wpftmp.GlobalUsings.g.cs", "C#", 5, 0, 0, 0, 0, 1, 1, 7
"c:\Users\chris\source\repos\Cell\Cell\obj\Debug\net8.0-windows\Cell_eu0xwvjs_wpftmp.sourcelink.json", "JSON", 0, 0, 0, 1, 0, 0, 0, 1
"c:\Users\chris\source\repos\Cell\Cell\obj\Debug\net8.0-windows\Cell_eu11hy1l_wpftmp.AssemblyInfo.cs", "C#", 11, 0, 0, 0, 0, 10, 5, 26
"c:\Users\chris\source\repos\Cell\Cell\obj\Debug\net8.0-windows\Cell_eu11hy1l_wpftmp.GeneratedMSBuildEditorConfig.editorconfig", "Properties", 0, 0, 0, 0, 21, 0, 1, 22
"c:\Users\chris\source\repos\Cell\Cell\obj\Debug\net8.0-windows\Cell_eu11hy1l_wpftmp.GlobalUsings.g.cs", "C#", 5, 0, 0, 0, 0, 1, 1, 7
"c:\Users\chris\source\repos\Cell\Cell\obj\Debug\net8.0-windows\Cell_eu11hy1l_wpftmp.sourcelink.json", "JSON", 0, 0, 0, 1, 0, 0, 0, 1
"c:\Users\chris\source\repos\Cell\Cell\obj\Debug\net8.0-windows\Cell_eu1babbg_wpftmp.AssemblyInfo.cs", "C#", 11, 0, 0, 0, 0, 10, 5, 26
"c:\Users\chris\source\repos\Cell\Cell\obj\Debug\net8.0-windows\Cell_eu1babbg_wpftmp.GeneratedMSBuildEditorConfig.editorconfig", "Properties", 0, 0, 0, 0, 21, 0, 1, 22
"c:\Users\chris\source\repos\Cell\Cell\obj\Debug\net8.0-windows\Cell_eu1babbg_wpftmp.GlobalUsings.g.cs", "C#", 5, 0, 0, 0, 0, 1, 1, 7
"c:\Users\chris\source\repos\Cell\Cell\obj\Debug\net8.0-windows\Cell_eu1babbg_wpftmp.sourcelink.json", "JSON", 0, 0, 0, 1, 0, 0, 0, 1
"c:\Users\chris\source\repos\Cell\Cell\obj\Debug\net8.0-windows\Cell_euuevrbc_wpftmp.AssemblyInfo.cs", "C#", 11, 0, 0, 0, 0, 10, 5, 26
"c:\Users\chris\source\repos\Cell\Cell\obj\Debug\net8.0-windows\Cell_euuevrbc_wpftmp.GeneratedMSBuildEditorConfig.editorconfig", "Properties", 0, 0, 0, 0, 21, 0, 1, 22
"c:\Users\chris\source\repos\Cell\Cell\obj\Debug\net8.0-windows\Cell_euuevrbc_wpftmp.GlobalUsings.g.cs", "C#", 5, 0, 0, 0, 0, 1, 1, 7
"c:\Users\chris\source\repos\Cell\Cell\obj\Debug\net8.0-windows\Cell_euuevrbc_wpftmp.sourcelink.json", "JSON", 0, 0, 0, 1, 0, 0, 0, 1
"c:\Users\chris\source\repos\Cell\Cell\obj\Debug\net8.0-windows\Cell_eux4mm3u_wpftmp.AssemblyInfo.cs", "C#", 11, 0, 0, 0, 0, 10, 5, 26
"c:\Users\chris\source\repos\Cell\Cell\obj\Debug\net8.0-windows\Cell_eux4mm3u_wpftmp.GeneratedMSBuildEditorConfig.editorconfig", "Properties", 0, 0, 0, 0, 21, 0, 1, 22
"c:\Users\chris\source\repos\Cell\Cell\obj\Debug\net8.0-windows\Cell_eux4mm3u_wpftmp.GlobalUsings.g.cs", "C#", 5, 0, 0, 0, 0, 1, 1, 7
"c:\Users\chris\source\repos\Cell\Cell\obj\Debug\net8.0-windows\Cell_eux4mm3u_wpftmp.sourcelink.json", "JSON", 0, 0, 0, 1, 0, 0, 0, 1
"c:\Users\chris\source\repos\Cell\Cell\obj\Debug\net8.0-windows\Cell_ewhecdrb_wpftmp.AssemblyInfo.cs", "C#", 11, 0, 0, 0, 0, 10, 5, 26
"c:\Users\chris\source\repos\Cell\Cell\obj\Debug\net8.0-windows\Cell_ewhecdrb_wpftmp.GeneratedMSBuildEditorConfig.editorconfig", "Properties", 0, 0, 0, 0, 13, 0, 1, 14
"c:\Users\chris\source\repos\Cell\Cell\obj\Debug\net8.0-windows\Cell_ewhecdrb_wpftmp.GlobalUsings.g.cs", "C#", 5, 0, 0, 0, 0, 1, 1, 7
"c:\Users\chris\source\repos\Cell\Cell\obj\Debug\net8.0-windows\Cell_exq2swh4_wpftmp.AssemblyInfo.cs", "C#", 11, 0, 0, 0, 0, 10, 5, 26
"c:\Users\chris\source\repos\Cell\Cell\obj\Debug\net8.0-windows\Cell_exq2swh4_wpftmp.GeneratedMSBuildEditorConfig.editorconfig", "Properties", 0, 0, 0, 0, 13, 0, 1, 14
"c:\Users\chris\source\repos\Cell\Cell\obj\Debug\net8.0-windows\Cell_exq2swh4_wpftmp.GlobalUsings.g.cs", "C#", 5, 0, 0, 0, 0, 1, 1, 7
"c:\Users\chris\source\repos\Cell\Cell\obj\Debug\net8.0-windows\Cell_exxaguq1_wpftmp.AssemblyInfo.cs", "C#", 11, 0, 0, 0, 0, 10, 5, 26
"c:\Users\chris\source\repos\Cell\Cell\obj\Debug\net8.0-windows\Cell_exxaguq1_wpftmp.GeneratedMSBuildEditorConfig.editorconfig", "Properties", 0, 0, 0, 0, 13, 0, 1, 14
"c:\Users\chris\source\repos\Cell\Cell\obj\Debug\net8.0-windows\Cell_exxaguq1_wpftmp.GlobalUsings.g.cs", "C#", 5, 0, 0, 0, 0, 1, 1, 7
"c:\Users\chris\source\repos\Cell\Cell\obj\Debug\net8.0-windows\Cell_ey3n2unq_wpftmp.AssemblyInfo.cs", "C#", 11, 0, 0, 0, 0, 10, 5, 26
"c:\Users\chris\source\repos\Cell\Cell\obj\Debug\net8.0-windows\Cell_ey3n2unq_wpftmp.GeneratedMSBuildEditorConfig.editorconfig", "Properties", 0, 0, 0, 0, 21, 0, 1, 22
"c:\Users\chris\source\repos\Cell\Cell\obj\Debug\net8.0-windows\Cell_ey3n2unq_wpftmp.GlobalUsings.g.cs", "C#", 5, 0, 0, 0, 0, 1, 1, 7
"c:\Users\chris\source\repos\Cell\Cell\obj\Debug\net8.0-windows\Cell_ey3n2unq_wpftmp.sourcelink.json", "JSON", 0, 0, 0, 1, 0, 0, 0, 1
"c:\Users\chris\source\repos\Cell\Cell\obj\Debug\net8.0-windows\Cell_eyfjsmui_wpftmp.AssemblyInfo.cs", "C#", 11, 0, 0, 0, 0, 10, 5, 26
"c:\Users\chris\source\repos\Cell\Cell\obj\Debug\net8.0-windows\Cell_eyfjsmui_wpftmp.GeneratedMSBuildEditorConfig.editorconfig", "Properties", 0, 0, 0, 0, 21, 0, 1, 22
"c:\Users\chris\source\repos\Cell\Cell\obj\Debug\net8.0-windows\Cell_eyfjsmui_wpftmp.GlobalUsings.g.cs", "C#", 5, 0, 0, 0, 0, 1, 1, 7
"c:\Users\chris\source\repos\Cell\Cell\obj\Debug\net8.0-windows\Cell_eyfjsmui_wpftmp.sourcelink.json", "JSON", 0, 0, 0, 1, 0, 0, 0, 1
"c:\Users\chris\source\repos\Cell\Cell\obj\Debug\net8.0-windows\Cell_eykuvhcz_wpftmp.AssemblyInfo.cs", "C#", 11, 0, 0, 0, 0, 10, 5, 26
"c:\Users\chris\source\repos\Cell\Cell\obj\Debug\net8.0-windows\Cell_eykuvhcz_wpftmp.GeneratedMSBuildEditorConfig.editorconfig", "Properties", 0, 0, 0, 0, 21, 0, 1, 22
"c:\Users\chris\source\repos\Cell\Cell\obj\Debug\net8.0-windows\Cell_eykuvhcz_wpftmp.GlobalUsings.g.cs", "C#", 5, 0, 0, 0, 0, 1, 1, 7
"c:\Users\chris\source\repos\Cell\Cell\obj\Debug\net8.0-windows\Cell_eykuvhcz_wpftmp.sourcelink.json", "JSON", 0, 0, 0, 1, 0, 0, 0, 1
"c:\Users\chris\source\repos\Cell\Cell\obj\Debug\net8.0-windows\Cell_ezgokmg2_wpftmp.AssemblyInfo.cs", "C#", 11, 0, 0, 0, 0, 10, 5, 26
"c:\Users\chris\source\repos\Cell\Cell\obj\Debug\net8.0-windows\Cell_ezgokmg2_wpftmp.GeneratedMSBuildEditorConfig.editorconfig", "Properties", 0, 0, 0, 0, 21, 0, 1, 22
"c:\Users\chris\source\repos\Cell\Cell\obj\Debug\net8.0-windows\Cell_ezgokmg2_wpftmp.GlobalUsings.g.cs", "C#", 5, 0, 0, 0, 0, 1, 1, 7
"c:\Users\chris\source\repos\Cell\Cell\obj\Debug\net8.0-windows\Cell_ezgokmg2_wpftmp.sourcelink.json", "JSON", 0, 0, 0, 1, 0, 0, 0, 1
"c:\Users\chris\source\repos\Cell\Cell\obj\Debug\net8.0-windows\Cell_f01lorih_wpftmp.AssemblyInfo.cs", "C#", 11, 0, 0, 0, 0, 10, 5, 26
"c:\Users\chris\source\repos\Cell\Cell\obj\Debug\net8.0-windows\Cell_f01lorih_wpftmp.GeneratedMSBuildEditorConfig.editorconfig", "Properties", 0, 0, 0, 0, 21, 0, 1, 22
"c:\Users\chris\source\repos\Cell\Cell\obj\Debug\net8.0-windows\Cell_f01lorih_wpftmp.GlobalUsings.g.cs", "C#", 5, 0, 0, 0, 0, 1, 1, 7
"c:\Users\chris\source\repos\Cell\Cell\obj\Debug\net8.0-windows\Cell_f01lorih_wpftmp.sourcelink.json", "JSON", 0, 0, 0, 1, 0, 0, 0, 1
"c:\Users\chris\source\repos\Cell\Cell\obj\Debug\net8.0-windows\Cell_f0gzi3fv_wpftmp.AssemblyInfo.cs", "C#", 11, 0, 0, 0, 0, 10, 5, 26
"c:\Users\chris\source\repos\Cell\Cell\obj\Debug\net8.0-windows\Cell_f0gzi3fv_wpftmp.GeneratedMSBuildEditorConfig.editorconfig", "Properties", 0, 0, 0, 0, 13, 0, 1, 14
"c:\Users\chris\source\repos\Cell\Cell\obj\Debug\net8.0-windows\Cell_f0gzi3fv_wpftmp.GlobalUsings.g.cs", "C#", 5, 0, 0, 0, 0, 1, 1, 7
"c:\Users\chris\source\repos\Cell\Cell\obj\Debug\net8.0-windows\Cell_f1kbr1qz_wpftmp.AssemblyInfo.cs", "C#", 11, 0, 0, 0, 0, 10, 5, 26
"c:\Users\chris\source\repos\Cell\Cell\obj\Debug\net8.0-windows\Cell_f1kbr1qz_wpftmp.GeneratedMSBuildEditorConfig.editorconfig", "Properties", 0, 0, 0, 0, 21, 0, 1, 22
"c:\Users\chris\source\repos\Cell\Cell\obj\Debug\net8.0-windows\Cell_f1kbr1qz_wpftmp.GlobalUsings.g.cs", "C#", 5, 0, 0, 0, 0, 1, 1, 7
"c:\Users\chris\source\repos\Cell\Cell\obj\Debug\net8.0-windows\Cell_f1kbr1qz_wpftmp.sourcelink.json", "JSON", 0, 0, 0, 1, 0, 0, 0, 1
"c:\Users\chris\source\repos\Cell\Cell\obj\Debug\net8.0-windows\Cell_f21jyhkx_wpftmp.AssemblyInfo.cs", "C#", 11, 0, 0, 0, 0, 10, 5, 26
"c:\Users\chris\source\repos\Cell\Cell\obj\Debug\net8.0-windows\Cell_f21jyhkx_wpftmp.GeneratedMSBuildEditorConfig.editorconfig", "Properties", 0, 0, 0, 0, 21, 0, 1, 22
"c:\Users\chris\source\repos\Cell\Cell\obj\Debug\net8.0-windows\Cell_f21jyhkx_wpftmp.GlobalUsings.g.cs", "C#", 5, 0, 0, 0, 0, 1, 1, 7
"c:\Users\chris\source\repos\Cell\Cell\obj\Debug\net8.0-windows\Cell_f21jyhkx_wpftmp.sourcelink.json", "JSON", 0, 0, 0, 1, 0, 0, 0, 1
"c:\Users\chris\source\repos\Cell\Cell\obj\Debug\net8.0-windows\Cell_f2pwwdug_wpftmp.AssemblyInfo.cs", "C#", 11, 0, 0, 0, 0, 10, 5, 26
"c:\Users\chris\source\repos\Cell\Cell\obj\Debug\net8.0-windows\Cell_f2pwwdug_wpftmp.GeneratedMSBuildEditorConfig.editorconfig", "Properties", 0, 0, 0, 0, 21, 0, 1, 22
"c:\Users\chris\source\repos\Cell\Cell\obj\Debug\net8.0-windows\Cell_f2pwwdug_wpftmp.GlobalUsings.g.cs", "C#", 5, 0, 0, 0, 0, 1, 1, 7
"c:\Users\chris\source\repos\Cell\Cell\obj\Debug\net8.0-windows\Cell_f2pwwdug_wpftmp.sourcelink.json", "JSON", 0, 0, 0, 1, 0, 0, 0, 1
"c:\Users\chris\source\repos\Cell\Cell\obj\Debug\net8.0-windows\Cell_f3hmlpbk_wpftmp.AssemblyInfo.cs", "C#", 11, 0, 0, 0, 0, 10, 5, 26
"c:\Users\chris\source\repos\Cell\Cell\obj\Debug\net8.0-windows\Cell_f3hmlpbk_wpftmp.GeneratedMSBuildEditorConfig.editorconfig", "Properties", 0, 0, 0, 0, 21, 0, 1, 22
"c:\Users\chris\source\repos\Cell\Cell\obj\Debug\net8.0-windows\Cell_f3hmlpbk_wpftmp.GlobalUsings.g.cs", "C#", 5, 0, 0, 0, 0, 1, 1, 7
"c:\Users\chris\source\repos\Cell\Cell\obj\Debug\net8.0-windows\Cell_f3hmlpbk_wpftmp.sourcelink.json", "JSON", 0, 0, 0, 1, 0, 0, 0, 1
"c:\Users\chris\source\repos\Cell\Cell\obj\Debug\net8.0-windows\Cell_f5ee5rya_wpftmp.AssemblyInfo.cs", "C#", 11, 0, 0, 0, 0, 10, 5, 26
"c:\Users\chris\source\repos\Cell\Cell\obj\Debug\net8.0-windows\Cell_f5ee5rya_wpftmp.GeneratedMSBuildEditorConfig.editorconfig", "Properties", 0, 0, 0, 0, 21, 0, 1, 22
"c:\Users\chris\source\repos\Cell\Cell\obj\Debug\net8.0-windows\Cell_f5ee5rya_wpftmp.GlobalUsings.g.cs", "C#", 5, 0, 0, 0, 0, 1, 1, 7
"c:\Users\chris\source\repos\Cell\Cell\obj\Debug\net8.0-windows\Cell_f5ee5rya_wpftmp.sourcelink.json", "JSON", 0, 0, 0, 1, 0, 0, 0, 1
"c:\Users\chris\source\repos\Cell\Cell\obj\Debug\net8.0-windows\Cell_f5opnfyy_wpftmp.AssemblyInfo.cs", "C#", 11, 0, 0, 0, 0, 10, 5, 26
"c:\Users\chris\source\repos\Cell\Cell\obj\Debug\net8.0-windows\Cell_f5opnfyy_wpftmp.GeneratedMSBuildEditorConfig.editorconfig", "Properties", 0, 0, 0, 0, 13, 0, 1, 14
"c:\Users\chris\source\repos\Cell\Cell\obj\Debug\net8.0-windows\Cell_f5opnfyy_wpftmp.GlobalUsings.g.cs", "C#", 5, 0, 0, 0, 0, 1, 1, 7
"c:\Users\chris\source\repos\Cell\Cell\obj\Debug\net8.0-windows\Cell_f5vhjak5_wpftmp.AssemblyInfo.cs", "C#", 11, 0, 0, 0, 0, 10, 5, 26
"c:\Users\chris\source\repos\Cell\Cell\obj\Debug\net8.0-windows\Cell_f5vhjak5_wpftmp.GeneratedMSBuildEditorConfig.editorconfig", "Properties", 0, 0, 0, 0, 13, 0, 1, 14
"c:\Users\chris\source\repos\Cell\Cell\obj\Debug\net8.0-windows\Cell_f5vhjak5_wpftmp.GlobalUsings.g.cs", "C#", 5, 0, 0, 0, 0, 1, 1, 7
"c:\Users\chris\source\repos\Cell\Cell\obj\Debug\net8.0-windows\Cell_f5ydyi5j_wpftmp.AssemblyInfo.cs", "C#", 11, 0, 0, 0, 0, 10, 5, 26
"c:\Users\chris\source\repos\Cell\Cell\obj\Debug\net8.0-windows\Cell_f5ydyi5j_wpftmp.GeneratedMSBuildEditorConfig.editorconfig", "Properties", 0, 0, 0, 0, 21, 0, 1, 22
"c:\Users\chris\source\repos\Cell\Cell\obj\Debug\net8.0-windows\Cell_f5ydyi5j_wpftmp.GlobalUsings.g.cs", "C#", 5, 0, 0, 0, 0, 1, 1, 7
"c:\Users\chris\source\repos\Cell\Cell\obj\Debug\net8.0-windows\Cell_f5ydyi5j_wpftmp.sourcelink.json", "JSON", 0, 0, 0, 1, 0, 0, 0, 1
"c:\Users\chris\source\repos\Cell\Cell\obj\Debug\net8.0-windows\Cell_faam5a0a_wpftmp.AssemblyInfo.cs", "C#", 11, 0, 0, 0, 0, 10, 5, 26
"c:\Users\chris\source\repos\Cell\Cell\obj\Debug\net8.0-windows\Cell_faam5a0a_wpftmp.GeneratedMSBuildEditorConfig.editorconfig", "Properties", 0, 0, 0, 0, 21, 0, 1, 22
"c:\Users\chris\source\repos\Cell\Cell\obj\Debug\net8.0-windows\Cell_faam5a0a_wpftmp.GlobalUsings.g.cs", "C#", 5, 0, 0, 0, 0, 1, 1, 7
"c:\Users\chris\source\repos\Cell\Cell\obj\Debug\net8.0-windows\Cell_faam5a0a_wpftmp.sourcelink.json", "JSON", 0, 0, 0, 1, 0, 0, 0, 1
"c:\Users\chris\source\repos\Cell\Cell\obj\Debug\net8.0-windows\Cell_fbp3bib1_wpftmp.AssemblyInfo.cs", "C#", 11, 0, 0, 0, 0, 10, 5, 26
"c:\Users\chris\source\repos\Cell\Cell\obj\Debug\net8.0-windows\Cell_fbp3bib1_wpftmp.GeneratedMSBuildEditorConfig.editorconfig", "Properties", 0, 0, 0, 0, 21, 0, 1, 22
"c:\Users\chris\source\repos\Cell\Cell\obj\Debug\net8.0-windows\Cell_fbp3bib1_wpftmp.GlobalUsings.g.cs", "C#", 5, 0, 0, 0, 0, 1, 1, 7
"c:\Users\chris\source\repos\Cell\Cell\obj\Debug\net8.0-windows\Cell_fbp3bib1_wpftmp.sourcelink.json", "JSON", 0, 0, 0, 1, 0, 0, 0, 1
"c:\Users\chris\source\repos\Cell\Cell\obj\Debug\net8.0-windows\Cell_fd4cbcce_wpftmp.AssemblyInfo.cs", "C#", 11, 0, 0, 0, 0, 10, 5, 26
"c:\Users\chris\source\repos\Cell\Cell\obj\Debug\net8.0-windows\Cell_fd4cbcce_wpftmp.GeneratedMSBuildEditorConfig.editorconfig", "Properties", 0, 0, 0, 0, 21, 0, 1, 22
"c:\Users\chris\source\repos\Cell\Cell\obj\Debug\net8.0-windows\Cell_fd4cbcce_wpftmp.GlobalUsings.g.cs", "C#", 5, 0, 0, 0, 0, 1, 1, 7
"c:\Users\chris\source\repos\Cell\Cell\obj\Debug\net8.0-windows\Cell_fd4cbcce_wpftmp.sourcelink.json", "JSON", 0, 0, 0, 1, 0, 0, 0, 1
"c:\Users\chris\source\repos\Cell\Cell\obj\Debug\net8.0-windows\Cell_fd5lamqx_wpftmp.AssemblyInfo.cs", "C#", 11, 0, 0, 0, 0, 10, 5, 26
"c:\Users\chris\source\repos\Cell\Cell\obj\Debug\net8.0-windows\Cell_fd5lamqx_wpftmp.GeneratedMSBuildEditorConfig.editorconfig", "Properties", 0, 0, 0, 0, 13, 0, 1, 14
"c:\Users\chris\source\repos\Cell\Cell\obj\Debug\net8.0-windows\Cell_fd5lamqx_wpftmp.GlobalUsings.g.cs", "C#", 5, 0, 0, 0, 0, 1, 1, 7
"c:\Users\chris\source\repos\Cell\Cell\obj\Debug\net8.0-windows\Cell_fegdupbc_wpftmp.AssemblyInfo.cs", "C#", 11, 0, 0, 0, 0, 10, 5, 26
"c:\Users\chris\source\repos\Cell\Cell\obj\Debug\net8.0-windows\Cell_fegdupbc_wpftmp.GeneratedMSBuildEditorConfig.editorconfig", "Properties", 0, 0, 0, 0, 21, 0, 1, 22
"c:\Users\chris\source\repos\Cell\Cell\obj\Debug\net8.0-windows\Cell_fegdupbc_wpftmp.GlobalUsings.g.cs", "C#", 5, 0, 0, 0, 0, 1, 1, 7
"c:\Users\chris\source\repos\Cell\Cell\obj\Debug\net8.0-windows\Cell_fegdupbc_wpftmp.sourcelink.json", "JSON", 0, 0, 0, 1, 0, 0, 0, 1
"c:\Users\chris\source\repos\Cell\Cell\obj\Debug\net8.0-windows\Cell_ffuabrcf_wpftmp.AssemblyInfo.cs", "C#", 11, 0, 0, 0, 0, 10, 5, 26
"c:\Users\chris\source\repos\Cell\Cell\obj\Debug\net8.0-windows\Cell_ffuabrcf_wpftmp.GeneratedMSBuildEditorConfig.editorconfig", "Properties", 0, 0, 0, 0, 21, 0, 1, 22
"c:\Users\chris\source\repos\Cell\Cell\obj\Debug\net8.0-windows\Cell_ffuabrcf_wpftmp.GlobalUsings.g.cs", "C#", 5, 0, 0, 0, 0, 1, 1, 7
"c:\Users\chris\source\repos\Cell\Cell\obj\Debug\net8.0-windows\Cell_ffuabrcf_wpftmp.sourcelink.json", "JSON", 0, 0, 0, 1, 0, 0, 0, 1
"c:\Users\chris\source\repos\Cell\Cell\obj\Debug\net8.0-windows\Cell_ffvu5pqg_wpftmp.AssemblyInfo.cs", "C#", 11, 0, 0, 0, 0, 10, 5, 26
"c:\Users\chris\source\repos\Cell\Cell\obj\Debug\net8.0-windows\Cell_ffvu5pqg_wpftmp.GeneratedMSBuildEditorConfig.editorconfig", "Properties", 0, 0, 0, 0, 21, 0, 1, 22
"c:\Users\chris\source\repos\Cell\Cell\obj\Debug\net8.0-windows\Cell_ffvu5pqg_wpftmp.GlobalUsings.g.cs", "C#", 5, 0, 0, 0, 0, 1, 1, 7
"c:\Users\chris\source\repos\Cell\Cell\obj\Debug\net8.0-windows\Cell_ffvu5pqg_wpftmp.sourcelink.json", "JSON", 0, 0, 0, 1, 0, 0, 0, 1
"c:\Users\chris\source\repos\Cell\Cell\obj\Debug\net8.0-windows\Cell_fhdmwmdz_wpftmp.AssemblyInfo.cs", "C#", 11, 0, 0, 0, 0, 10, 5, 26
"c:\Users\chris\source\repos\Cell\Cell\obj\Debug\net8.0-windows\Cell_fhdmwmdz_wpftmp.GeneratedMSBuildEditorConfig.editorconfig", "Properties", 0, 0, 0, 0, 21, 0, 1, 22
"c:\Users\chris\source\repos\Cell\Cell\obj\Debug\net8.0-windows\Cell_fhdmwmdz_wpftmp.GlobalUsings.g.cs", "C#", 5, 0, 0, 0, 0, 1, 1, 7
"c:\Users\chris\source\repos\Cell\Cell\obj\Debug\net8.0-windows\Cell_fhdmwmdz_wpftmp.sourcelink.json", "JSON", 0, 0, 0, 1, 0, 0, 0, 1
"c:\Users\chris\source\repos\Cell\Cell\obj\Debug\net8.0-windows\Cell_fi0qbk15_wpftmp.AssemblyInfo.cs", "C#", 11, 0, 0, 0, 0, 10, 5, 26
"c:\Users\chris\source\repos\Cell\Cell\obj\Debug\net8.0-windows\Cell_fi0qbk15_wpftmp.GeneratedMSBuildEditorConfig.editorconfig", "Properties", 0, 0, 0, 0, 21, 0, 1, 22
"c:\Users\chris\source\repos\Cell\Cell\obj\Debug\net8.0-windows\Cell_fi0qbk15_wpftmp.GlobalUsings.g.cs", "C#", 5, 0, 0, 0, 0, 1, 1, 7
"c:\Users\chris\source\repos\Cell\Cell\obj\Debug\net8.0-windows\Cell_fi0qbk15_wpftmp.sourcelink.json", "JSON", 0, 0, 0, 1, 0, 0, 0, 1
"c:\Users\chris\source\repos\Cell\Cell\obj\Debug\net8.0-windows\Cell_fi4gqplr_wpftmp.AssemblyInfo.cs", "C#", 11, 0, 0, 0, 0, 10, 5, 26
"c:\Users\chris\source\repos\Cell\Cell\obj\Debug\net8.0-windows\Cell_fi4gqplr_wpftmp.GeneratedMSBuildEditorConfig.editorconfig", "Properties", 0, 0, 0, 0, 21, 0, 1, 22
"c:\Users\chris\source\repos\Cell\Cell\obj\Debug\net8.0-windows\Cell_fi4gqplr_wpftmp.GlobalUsings.g.cs", "C#", 5, 0, 0, 0, 0, 1, 1, 7
"c:\Users\chris\source\repos\Cell\Cell\obj\Debug\net8.0-windows\Cell_fi4gqplr_wpftmp.sourcelink.json", "JSON", 0, 0, 0, 1, 0, 0, 0, 1
"c:\Users\chris\source\repos\Cell\Cell\obj\Debug\net8.0-windows\Cell_fj4rnyob_wpftmp.AssemblyInfo.cs", "C#", 11, 0, 0, 0, 0, 10, 5, 26
"c:\Users\chris\source\repos\Cell\Cell\obj\Debug\net8.0-windows\Cell_fj4rnyob_wpftmp.GeneratedMSBuildEditorConfig.editorconfig", "Properties", 0, 0, 0, 0, 21, 0, 1, 22
"c:\Users\chris\source\repos\Cell\Cell\obj\Debug\net8.0-windows\Cell_fj4rnyob_wpftmp.GlobalUsings.g.cs", "C#", 5, 0, 0, 0, 0, 1, 1, 7
"c:\Users\chris\source\repos\Cell\Cell\obj\Debug\net8.0-windows\Cell_fj4rnyob_wpftmp.sourcelink.json", "JSON", 0, 0, 0, 1, 0, 0, 0, 1
"c:\Users\chris\source\repos\Cell\Cell\obj\Debug\net8.0-windows\Cell_fjwx1jvi_wpftmp.AssemblyInfo.cs", "C#", 11, 0, 0, 0, 0, 10, 5, 26
"c:\Users\chris\source\repos\Cell\Cell\obj\Debug\net8.0-windows\Cell_fjwx1jvi_wpftmp.GeneratedMSBuildEditorConfig.editorconfig", "Properties", 0, 0, 0, 0, 13, 0, 1, 14
"c:\Users\chris\source\repos\Cell\Cell\obj\Debug\net8.0-windows\Cell_fjwx1jvi_wpftmp.GlobalUsings.g.cs", "C#", 5, 0, 0, 0, 0, 1, 1, 7
"c:\Users\chris\source\repos\Cell\Cell\obj\Debug\net8.0-windows\Cell_fjzvssrm_wpftmp.AssemblyInfo.cs", "C#", 11, 0, 0, 0, 0, 10, 5, 26
"c:\Users\chris\source\repos\Cell\Cell\obj\Debug\net8.0-windows\Cell_fjzvssrm_wpftmp.GeneratedMSBuildEditorConfig.editorconfig", "Properties", 0, 0, 0, 0, 21, 0, 1, 22
"c:\Users\chris\source\repos\Cell\Cell\obj\Debug\net8.0-windows\Cell_fjzvssrm_wpftmp.GlobalUsings.g.cs", "C#", 5, 0, 0, 0, 0, 1, 1, 7
"c:\Users\chris\source\repos\Cell\Cell\obj\Debug\net8.0-windows\Cell_fjzvssrm_wpftmp.sourcelink.json", "JSON", 0, 0, 0, 1, 0, 0, 0, 1
"c:\Users\chris\source\repos\Cell\Cell\obj\Debug\net8.0-windows\Cell_fkga53fk_wpftmp.AssemblyInfo.cs", "C#", 11, 0, 0, 0, 0, 10, 5, 26
"c:\Users\chris\source\repos\Cell\Cell\obj\Debug\net8.0-windows\Cell_fkga53fk_wpftmp.GeneratedMSBuildEditorConfig.editorconfig", "Properties", 0, 0, 0, 0, 21, 0, 1, 22
"c:\Users\chris\source\repos\Cell\Cell\obj\Debug\net8.0-windows\Cell_fkga53fk_wpftmp.GlobalUsings.g.cs", "C#", 5, 0, 0, 0, 0, 1, 1, 7
"c:\Users\chris\source\repos\Cell\Cell\obj\Debug\net8.0-windows\Cell_fkga53fk_wpftmp.sourcelink.json", "JSON", 0, 0, 0, 1, 0, 0, 0, 1
"c:\Users\chris\source\repos\Cell\Cell\obj\Debug\net8.0-windows\Cell_fkgabjmg_wpftmp.AssemblyInfo.cs", "C#", 11, 0, 0, 0, 0, 10, 5, 26
"c:\Users\chris\source\repos\Cell\Cell\obj\Debug\net8.0-windows\Cell_fkgabjmg_wpftmp.GeneratedMSBuildEditorConfig.editorconfig", "Properties", 0, 0, 0, 0, 21, 0, 1, 22
"c:\Users\chris\source\repos\Cell\Cell\obj\Debug\net8.0-windows\Cell_fkgabjmg_wpftmp.GlobalUsings.g.cs", "C#", 5, 0, 0, 0, 0, 1, 1, 7
"c:\Users\chris\source\repos\Cell\Cell\obj\Debug\net8.0-windows\Cell_fkgabjmg_wpftmp.sourcelink.json", "JSON", 0, 0, 0, 1, 0, 0, 0, 1
"c:\Users\chris\source\repos\Cell\Cell\obj\Debug\net8.0-windows\Cell_fl4tvwf4_wpftmp.AssemblyInfo.cs", "C#", 11, 0, 0, 0, 0, 10, 5, 26
"c:\Users\chris\source\repos\Cell\Cell\obj\Debug\net8.0-windows\Cell_fl4tvwf4_wpftmp.GeneratedMSBuildEditorConfig.editorconfig", "Properties", 0, 0, 0, 0, 21, 0, 1, 22
"c:\Users\chris\source\repos\Cell\Cell\obj\Debug\net8.0-windows\Cell_fl4tvwf4_wpftmp.GlobalUsings.g.cs", "C#", 5, 0, 0, 0, 0, 1, 1, 7
"c:\Users\chris\source\repos\Cell\Cell\obj\Debug\net8.0-windows\Cell_fl4tvwf4_wpftmp.sourcelink.json", "JSON", 0, 0, 0, 1, 0, 0, 0, 1
"c:\Users\chris\source\repos\Cell\Cell\obj\Debug\net8.0-windows\Cell_fli2lell_wpftmp.AssemblyInfo.cs", "C#", 11, 0, 0, 0, 0, 10, 5, 26
"c:\Users\chris\source\repos\Cell\Cell\obj\Debug\net8.0-windows\Cell_fli2lell_wpftmp.GeneratedMSBuildEditorConfig.editorconfig", "Properties", 0, 0, 0, 0, 21, 0, 1, 22
"c:\Users\chris\source\repos\Cell\Cell\obj\Debug\net8.0-windows\Cell_fli2lell_wpftmp.GlobalUsings.g.cs", "C#", 5, 0, 0, 0, 0, 1, 1, 7
"c:\Users\chris\source\repos\Cell\Cell\obj\Debug\net8.0-windows\Cell_fli2lell_wpftmp.sourcelink.json", "JSON", 0, 0, 0, 1, 0, 0, 0, 1
"c:\Users\chris\source\repos\Cell\Cell\obj\Debug\net8.0-windows\Cell_fm25cnus_wpftmp.AssemblyInfo.cs", "C#", 11, 0, 0, 0, 0, 10, 5, 26
"c:\Users\chris\source\repos\Cell\Cell\obj\Debug\net8.0-windows\Cell_fm25cnus_wpftmp.GeneratedMSBuildEditorConfig.editorconfig", "Properties", 0, 0, 0, 0, 21, 0, 1, 22
"c:\Users\chris\source\repos\Cell\Cell\obj\Debug\net8.0-windows\Cell_fm25cnus_wpftmp.GlobalUsings.g.cs", "C#", 5, 0, 0, 0, 0, 1, 1, 7
"c:\Users\chris\source\repos\Cell\Cell\obj\Debug\net8.0-windows\Cell_fm25cnus_wpftmp.sourcelink.json", "JSON", 0, 0, 0, 1, 0, 0, 0, 1
"c:\Users\chris\source\repos\Cell\Cell\obj\Debug\net8.0-windows\Cell_fmu0vskl_wpftmp.AssemblyInfo.cs", "C#", 11, 0, 0, 0, 0, 10, 5, 26
"c:\Users\chris\source\repos\Cell\Cell\obj\Debug\net8.0-windows\Cell_fmu0vskl_wpftmp.GeneratedMSBuildEditorConfig.editorconfig", "Properties", 0, 0, 0, 0, 21, 0, 1, 22
"c:\Users\chris\source\repos\Cell\Cell\obj\Debug\net8.0-windows\Cell_fmu0vskl_wpftmp.GlobalUsings.g.cs", "C#", 5, 0, 0, 0, 0, 1, 1, 7
"c:\Users\chris\source\repos\Cell\Cell\obj\Debug\net8.0-windows\Cell_fmu0vskl_wpftmp.sourcelink.json", "JSON", 0, 0, 0, 1, 0, 0, 0, 1
"c:\Users\chris\source\repos\Cell\Cell\obj\Debug\net8.0-windows\Cell_fpbqxzaf_wpftmp.AssemblyInfo.cs", "C#", 11, 0, 0, 0, 0, 10, 5, 26
"c:\Users\chris\source\repos\Cell\Cell\obj\Debug\net8.0-windows\Cell_fpbqxzaf_wpftmp.GeneratedMSBuildEditorConfig.editorconfig", "Properties", 0, 0, 0, 0, 21, 0, 1, 22
"c:\Users\chris\source\repos\Cell\Cell\obj\Debug\net8.0-windows\Cell_fpbqxzaf_wpftmp.GlobalUsings.g.cs", "C#", 5, 0, 0, 0, 0, 1, 1, 7
"c:\Users\chris\source\repos\Cell\Cell\obj\Debug\net8.0-windows\Cell_fpbqxzaf_wpftmp.sourcelink.json", "JSON", 0, 0, 0, 1, 0, 0, 0, 1
"c:\Users\chris\source\repos\Cell\Cell\obj\Debug\net8.0-windows\Cell_fppo3vnj_wpftmp.AssemblyInfo.cs", "C#", 11, 0, 0, 0, 0, 10, 5, 26
"c:\Users\chris\source\repos\Cell\Cell\obj\Debug\net8.0-windows\Cell_fppo3vnj_wpftmp.GeneratedMSBuildEditorConfig.editorconfig", "Properties", 0, 0, 0, 0, 21, 0, 1, 22
"c:\Users\chris\source\repos\Cell\Cell\obj\Debug\net8.0-windows\Cell_fppo3vnj_wpftmp.GlobalUsings.g.cs", "C#", 5, 0, 0, 0, 0, 1, 1, 7
"c:\Users\chris\source\repos\Cell\Cell\obj\Debug\net8.0-windows\Cell_fppo3vnj_wpftmp.sourcelink.json", "JSON", 0, 0, 0, 1, 0, 0, 0, 1
"c:\Users\chris\source\repos\Cell\Cell\obj\Debug\net8.0-windows\Cell_fpub4abp_wpftmp.AssemblyInfo.cs", "C#", 11, 0, 0, 0, 0, 10, 5, 26
"c:\Users\chris\source\repos\Cell\Cell\obj\Debug\net8.0-windows\Cell_fpub4abp_wpftmp.GeneratedMSBuildEditorConfig.editorconfig", "Properties", 0, 0, 0, 0, 13, 0, 1, 14
"c:\Users\chris\source\repos\Cell\Cell\obj\Debug\net8.0-windows\Cell_fpub4abp_wpftmp.GlobalUsings.g.cs", "C#", 5, 0, 0, 0, 0, 1, 1, 7
"c:\Users\chris\source\repos\Cell\Cell\obj\Debug\net8.0-windows\Cell_fru3uikj_wpftmp.AssemblyInfo.cs", "C#", 11, 0, 0, 0, 0, 10, 5, 26
"c:\Users\chris\source\repos\Cell\Cell\obj\Debug\net8.0-windows\Cell_fru3uikj_wpftmp.GeneratedMSBuildEditorConfig.editorconfig", "Properties", 0, 0, 0, 0, 21, 0, 1, 22
"c:\Users\chris\source\repos\Cell\Cell\obj\Debug\net8.0-windows\Cell_fru3uikj_wpftmp.GlobalUsings.g.cs", "C#", 5, 0, 0, 0, 0, 1, 1, 7
"c:\Users\chris\source\repos\Cell\Cell\obj\Debug\net8.0-windows\Cell_fru3uikj_wpftmp.sourcelink.json", "JSON", 0, 0, 0, 1, 0, 0, 0, 1
"c:\Users\chris\source\repos\Cell\Cell\obj\Debug\net8.0-windows\Cell_frvkeg4v_wpftmp.AssemblyInfo.cs", "C#", 11, 0, 0, 0, 0, 10, 5, 26
"c:\Users\chris\source\repos\Cell\Cell\obj\Debug\net8.0-windows\Cell_frvkeg4v_wpftmp.GeneratedMSBuildEditorConfig.editorconfig", "Properties", 0, 0, 0, 0, 21, 0, 1, 22
"c:\Users\chris\source\repos\Cell\Cell\obj\Debug\net8.0-windows\Cell_frvkeg4v_wpftmp.GlobalUsings.g.cs", "C#", 5, 0, 0, 0, 0, 1, 1, 7
"c:\Users\chris\source\repos\Cell\Cell\obj\Debug\net8.0-windows\Cell_frvkeg4v_wpftmp.sourcelink.json", "JSON", 0, 0, 0, 1, 0, 0, 0, 1
"c:\Users\chris\source\repos\Cell\Cell\obj\Debug\net8.0-windows\Cell_ft3dfewy_wpftmp.AssemblyInfo.cs", "C#", 11, 0, 0, 0, 0, 10, 5, 26
"c:\Users\chris\source\repos\Cell\Cell\obj\Debug\net8.0-windows\Cell_ft3dfewy_wpftmp.GeneratedMSBuildEditorConfig.editorconfig", "Properties", 0, 0, 0, 0, 21, 0, 1, 22
"c:\Users\chris\source\repos\Cell\Cell\obj\Debug\net8.0-windows\Cell_ft3dfewy_wpftmp.GlobalUsings.g.cs", "C#", 5, 0, 0, 0, 0, 1, 1, 7
"c:\Users\chris\source\repos\Cell\Cell\obj\Debug\net8.0-windows\Cell_ft3dfewy_wpftmp.sourcelink.json", "JSON", 0, 0, 0, 1, 0, 0, 0, 1
"c:\Users\chris\source\repos\Cell\Cell\obj\Debug\net8.0-windows\Cell_ftgjaccu_wpftmp.AssemblyInfo.cs", "C#", 11, 0, 0, 0, 0, 10, 5, 26
"c:\Users\chris\source\repos\Cell\Cell\obj\Debug\net8.0-windows\Cell_ftgjaccu_wpftmp.GeneratedMSBuildEditorConfig.editorconfig", "Properties", 0, 0, 0, 0, 21, 0, 1, 22
"c:\Users\chris\source\repos\Cell\Cell\obj\Debug\net8.0-windows\Cell_ftgjaccu_wpftmp.GlobalUsings.g.cs", "C#", 5, 0, 0, 0, 0, 1, 1, 7
"c:\Users\chris\source\repos\Cell\Cell\obj\Debug\net8.0-windows\Cell_ftgjaccu_wpftmp.sourcelink.json", "JSON", 0, 0, 0, 1, 0, 0, 0, 1
"c:\Users\chris\source\repos\Cell\Cell\obj\Debug\net8.0-windows\Cell_fu0nclxd_wpftmp.AssemblyInfo.cs", "C#", 11, 0, 0, 0, 0, 10, 5, 26
"c:\Users\chris\source\repos\Cell\Cell\obj\Debug\net8.0-windows\Cell_fu0nclxd_wpftmp.GeneratedMSBuildEditorConfig.editorconfig", "Properties", 0, 0, 0, 0, 13, 0, 1, 14
"c:\Users\chris\source\repos\Cell\Cell\obj\Debug\net8.0-windows\Cell_fu0nclxd_wpftmp.GlobalUsings.g.cs", "C#", 5, 0, 0, 0, 0, 1, 1, 7
"c:\Users\chris\source\repos\Cell\Cell\obj\Debug\net8.0-windows\Cell_fu3st4gb_wpftmp.AssemblyInfo.cs", "C#", 11, 0, 0, 0, 0, 10, 5, 26
"c:\Users\chris\source\repos\Cell\Cell\obj\Debug\net8.0-windows\Cell_fu3st4gb_wpftmp.GeneratedMSBuildEditorConfig.editorconfig", "Properties", 0, 0, 0, 0, 21, 0, 1, 22
"c:\Users\chris\source\repos\Cell\Cell\obj\Debug\net8.0-windows\Cell_fu3st4gb_wpftmp.GlobalUsings.g.cs", "C#", 5, 0, 0, 0, 0, 1, 1, 7
"c:\Users\chris\source\repos\Cell\Cell\obj\Debug\net8.0-windows\Cell_fu3st4gb_wpftmp.sourcelink.json", "JSON", 0, 0, 0, 1, 0, 0, 0, 1
"c:\Users\chris\source\repos\Cell\Cell\obj\Debug\net8.0-windows\Cell_fulusebq_wpftmp.AssemblyInfo.cs", "C#", 11, 0, 0, 0, 0, 10, 5, 26
"c:\Users\chris\source\repos\Cell\Cell\obj\Debug\net8.0-windows\Cell_fulusebq_wpftmp.GeneratedMSBuildEditorConfig.editorconfig", "Properties", 0, 0, 0, 0, 21, 0, 1, 22
"c:\Users\chris\source\repos\Cell\Cell\obj\Debug\net8.0-windows\Cell_fulusebq_wpftmp.GlobalUsings.g.cs", "C#", 5, 0, 0, 0, 0, 1, 1, 7
"c:\Users\chris\source\repos\Cell\Cell\obj\Debug\net8.0-windows\Cell_fulusebq_wpftmp.sourcelink.json", "JSON", 0, 0, 0, 1, 0, 0, 0, 1
"c:\Users\chris\source\repos\Cell\Cell\obj\Debug\net8.0-windows\Cell_fup2fljv_wpftmp.AssemblyInfo.cs", "C#", 11, 0, 0, 0, 0, 10, 5, 26
"c:\Users\chris\source\repos\Cell\Cell\obj\Debug\net8.0-windows\Cell_fup2fljv_wpftmp.GeneratedMSBuildEditorConfig.editorconfig", "Properties", 0, 0, 0, 0, 13, 0, 1, 14
"c:\Users\chris\source\repos\Cell\Cell\obj\Debug\net8.0-windows\Cell_fup2fljv_wpftmp.GlobalUsings.g.cs", "C#", 5, 0, 0, 0, 0, 1, 1, 7
"c:\Users\chris\source\repos\Cell\Cell\obj\Debug\net8.0-windows\Cell_fvsmh2zs_wpftmp.AssemblyInfo.cs", "C#", 11, 0, 0, 0, 0, 10, 5, 26
"c:\Users\chris\source\repos\Cell\Cell\obj\Debug\net8.0-windows\Cell_fvsmh2zs_wpftmp.GeneratedMSBuildEditorConfig.editorconfig", "Properties", 0, 0, 0, 0, 21, 0, 1, 22
"c:\Users\chris\source\repos\Cell\Cell\obj\Debug\net8.0-windows\Cell_fvsmh2zs_wpftmp.GlobalUsings.g.cs", "C#", 5, 0, 0, 0, 0, 1, 1, 7
"c:\Users\chris\source\repos\Cell\Cell\obj\Debug\net8.0-windows\Cell_fvsmh2zs_wpftmp.sourcelink.json", "JSON", 0, 0, 0, 1, 0, 0, 0, 1
"c:\Users\chris\source\repos\Cell\Cell\obj\Debug\net8.0-windows\Cell_fwzs3ts4_wpftmp.AssemblyInfo.cs", "C#", 11, 0, 0, 0, 0, 10, 5, 26
"c:\Users\chris\source\repos\Cell\Cell\obj\Debug\net8.0-windows\Cell_fwzs3ts4_wpftmp.GeneratedMSBuildEditorConfig.editorconfig", "Properties", 0, 0, 0, 0, 21, 0, 1, 22
"c:\Users\chris\source\repos\Cell\Cell\obj\Debug\net8.0-windows\Cell_fwzs3ts4_wpftmp.GlobalUsings.g.cs", "C#", 5, 0, 0, 0, 0, 1, 1, 7
"c:\Users\chris\source\repos\Cell\Cell\obj\Debug\net8.0-windows\Cell_fwzs3ts4_wpftmp.sourcelink.json", "JSON", 0, 0, 0, 1, 0, 0, 0, 1
"c:\Users\chris\source\repos\Cell\Cell\obj\Debug\net8.0-windows\Cell_fym0j2w4_wpftmp.AssemblyInfo.cs", "C#", 11, 0, 0, 0, 0, 10, 5, 26
"c:\Users\chris\source\repos\Cell\Cell\obj\Debug\net8.0-windows\Cell_fym0j2w4_wpftmp.GeneratedMSBuildEditorConfig.editorconfig", "Properties", 0, 0, 0, 0, 21, 0, 1, 22
"c:\Users\chris\source\repos\Cell\Cell\obj\Debug\net8.0-windows\Cell_fym0j2w4_wpftmp.GlobalUsings.g.cs", "C#", 5, 0, 0, 0, 0, 1, 1, 7
"c:\Users\chris\source\repos\Cell\Cell\obj\Debug\net8.0-windows\Cell_fym0j2w4_wpftmp.sourcelink.json", "JSON", 0, 0, 0, 1, 0, 0, 0, 1
"c:\Users\chris\source\repos\Cell\Cell\obj\Debug\net8.0-windows\Cell_fzxxorxl_wpftmp.AssemblyInfo.cs", "C#", 11, 0, 0, 0, 0, 10, 5, 26
"c:\Users\chris\source\repos\Cell\Cell\obj\Debug\net8.0-windows\Cell_fzxxorxl_wpftmp.GeneratedMSBuildEditorConfig.editorconfig", "Properties", 0, 0, 0, 0, 21, 0, 1, 22
"c:\Users\chris\source\repos\Cell\Cell\obj\Debug\net8.0-windows\Cell_fzxxorxl_wpftmp.GlobalUsings.g.cs", "C#", 5, 0, 0, 0, 0, 1, 1, 7
"c:\Users\chris\source\repos\Cell\Cell\obj\Debug\net8.0-windows\Cell_fzxxorxl_wpftmp.sourcelink.json", "JSON", 0, 0, 0, 1, 0, 0, 0, 1
"c:\Users\chris\source\repos\Cell\Cell\obj\Debug\net8.0-windows\Cell_g01z3fbb_wpftmp.AssemblyInfo.cs", "C#", 11, 0, 0, 0, 0, 10, 5, 26
"c:\Users\chris\source\repos\Cell\Cell\obj\Debug\net8.0-windows\Cell_g01z3fbb_wpftmp.GeneratedMSBuildEditorConfig.editorconfig", "Properties", 0, 0, 0, 0, 21, 0, 1, 22
"c:\Users\chris\source\repos\Cell\Cell\obj\Debug\net8.0-windows\Cell_g01z3fbb_wpftmp.GlobalUsings.g.cs", "C#", 5, 0, 0, 0, 0, 1, 1, 7
"c:\Users\chris\source\repos\Cell\Cell\obj\Debug\net8.0-windows\Cell_g01z3fbb_wpftmp.sourcelink.json", "JSON", 0, 0, 0, 1, 0, 0, 0, 1
"c:\Users\chris\source\repos\Cell\Cell\obj\Debug\net8.0-windows\Cell_g0rhql2h_wpftmp.AssemblyInfo.cs", "C#", 11, 0, 0, 0, 0, 10, 5, 26
"c:\Users\chris\source\repos\Cell\Cell\obj\Debug\net8.0-windows\Cell_g0rhql2h_wpftmp.GeneratedMSBuildEditorConfig.editorconfig", "Properties", 0, 0, 0, 0, 13, 0, 1, 14
"c:\Users\chris\source\repos\Cell\Cell\obj\Debug\net8.0-windows\Cell_g0rhql2h_wpftmp.GlobalUsings.g.cs", "C#", 5, 0, 0, 0, 0, 1, 1, 7
"c:\Users\chris\source\repos\Cell\Cell\obj\Debug\net8.0-windows\Cell_g25ejwgs_wpftmp.AssemblyInfo.cs", "C#", 11, 0, 0, 0, 0, 10, 5, 26
"c:\Users\chris\source\repos\Cell\Cell\obj\Debug\net8.0-windows\Cell_g25ejwgs_wpftmp.GeneratedMSBuildEditorConfig.editorconfig", "Properties", 0, 0, 0, 0, 21, 0, 1, 22
"c:\Users\chris\source\repos\Cell\Cell\obj\Debug\net8.0-windows\Cell_g25ejwgs_wpftmp.GlobalUsings.g.cs", "C#", 5, 0, 0, 0, 0, 1, 1, 7
"c:\Users\chris\source\repos\Cell\Cell\obj\Debug\net8.0-windows\Cell_g25ejwgs_wpftmp.sourcelink.json", "JSON", 0, 0, 0, 1, 0, 0, 0, 1
"c:\Users\chris\source\repos\Cell\Cell\obj\Debug\net8.0-windows\Cell_g344dzb5_wpftmp.AssemblyInfo.cs", "C#", 11, 0, 0, 0, 0, 10, 5, 26
"c:\Users\chris\source\repos\Cell\Cell\obj\Debug\net8.0-windows\Cell_g344dzb5_wpftmp.GeneratedMSBuildEditorConfig.editorconfig", "Properties", 0, 0, 0, 0, 21, 0, 1, 22
"c:\Users\chris\source\repos\Cell\Cell\obj\Debug\net8.0-windows\Cell_g344dzb5_wpftmp.GlobalUsings.g.cs", "C#", 5, 0, 0, 0, 0, 1, 1, 7
"c:\Users\chris\source\repos\Cell\Cell\obj\Debug\net8.0-windows\Cell_g344dzb5_wpftmp.sourcelink.json", "JSON", 0, 0, 0, 1, 0, 0, 0, 1
"c:\Users\chris\source\repos\Cell\Cell\obj\Debug\net8.0-windows\Cell_g3d1j2ml_wpftmp.AssemblyInfo.cs", "C#", 11, 0, 0, 0, 0, 10, 5, 26
"c:\Users\chris\source\repos\Cell\Cell\obj\Debug\net8.0-windows\Cell_g3d1j2ml_wpftmp.GeneratedMSBuildEditorConfig.editorconfig", "Properties", 0, 0, 0, 0, 21, 0, 1, 22
"c:\Users\chris\source\repos\Cell\Cell\obj\Debug\net8.0-windows\Cell_g3d1j2ml_wpftmp.GlobalUsings.g.cs", "C#", 5, 0, 0, 0, 0, 1, 1, 7
"c:\Users\chris\source\repos\Cell\Cell\obj\Debug\net8.0-windows\Cell_g3d1j2ml_wpftmp.sourcelink.json", "JSON", 0, 0, 0, 1, 0, 0, 0, 1
"c:\Users\chris\source\repos\Cell\Cell\obj\Debug\net8.0-windows\Cell_g3zdaq11_wpftmp.AssemblyInfo.cs", "C#", 11, 0, 0, 0, 0, 10, 5, 26
"c:\Users\chris\source\repos\Cell\Cell\obj\Debug\net8.0-windows\Cell_g3zdaq11_wpftmp.GeneratedMSBuildEditorConfig.editorconfig", "Properties", 0, 0, 0, 0, 13, 0, 1, 14
"c:\Users\chris\source\repos\Cell\Cell\obj\Debug\net8.0-windows\Cell_g3zdaq11_wpftmp.GlobalUsings.g.cs", "C#", 5, 0, 0, 0, 0, 1, 1, 7
"c:\Users\chris\source\repos\Cell\Cell\obj\Debug\net8.0-windows\Cell_g4aeayc3_wpftmp.AssemblyInfo.cs", "C#", 11, 0, 0, 0, 0, 10, 5, 26
"c:\Users\chris\source\repos\Cell\Cell\obj\Debug\net8.0-windows\Cell_g4aeayc3_wpftmp.GeneratedMSBuildEditorConfig.editorconfig", "Properties", 0, 0, 0, 0, 21, 0, 1, 22
"c:\Users\chris\source\repos\Cell\Cell\obj\Debug\net8.0-windows\Cell_g4aeayc3_wpftmp.GlobalUsings.g.cs", "C#", 5, 0, 0, 0, 0, 1, 1, 7
"c:\Users\chris\source\repos\Cell\Cell\obj\Debug\net8.0-windows\Cell_g4aeayc3_wpftmp.sourcelink.json", "JSON", 0, 0, 0, 1, 0, 0, 0, 1
"c:\Users\chris\source\repos\Cell\Cell\obj\Debug\net8.0-windows\Cell_g4tjlluy_wpftmp.AssemblyInfo.cs", "C#", 11, 0, 0, 0, 0, 10, 5, 26
"c:\Users\chris\source\repos\Cell\Cell\obj\Debug\net8.0-windows\Cell_g4tjlluy_wpftmp.GeneratedMSBuildEditorConfig.editorconfig", "Properties", 0, 0, 0, 0, 21, 0, 1, 22
"c:\Users\chris\source\repos\Cell\Cell\obj\Debug\net8.0-windows\Cell_g4tjlluy_wpftmp.GlobalUsings.g.cs", "C#", 5, 0, 0, 0, 0, 1, 1, 7
"c:\Users\chris\source\repos\Cell\Cell\obj\Debug\net8.0-windows\Cell_g4tjlluy_wpftmp.sourcelink.json", "JSON", 0, 0, 0, 1, 0, 0, 0, 1
"c:\Users\chris\source\repos\Cell\Cell\obj\Debug\net8.0-windows\Cell_g5pkn0zx_wpftmp.AssemblyInfo.cs", "C#", 11, 0, 0, 0, 0, 10, 5, 26
"c:\Users\chris\source\repos\Cell\Cell\obj\Debug\net8.0-windows\Cell_g5pkn0zx_wpftmp.GeneratedMSBuildEditorConfig.editorconfig", "Properties", 0, 0, 0, 0, 21, 0, 1, 22
"c:\Users\chris\source\repos\Cell\Cell\obj\Debug\net8.0-windows\Cell_g5pkn0zx_wpftmp.GlobalUsings.g.cs", "C#", 5, 0, 0, 0, 0, 1, 1, 7
"c:\Users\chris\source\repos\Cell\Cell\obj\Debug\net8.0-windows\Cell_g5pkn0zx_wpftmp.sourcelink.json", "JSON", 0, 0, 0, 1, 0, 0, 0, 1
"c:\Users\chris\source\repos\Cell\Cell\obj\Debug\net8.0-windows\Cell_gaejwkks_wpftmp.AssemblyInfo.cs", "C#", 11, 0, 0, 0, 0, 10, 5, 26
"c:\Users\chris\source\repos\Cell\Cell\obj\Debug\net8.0-windows\Cell_gaejwkks_wpftmp.GeneratedMSBuildEditorConfig.editorconfig", "Properties", 0, 0, 0, 0, 21, 0, 1, 22
"c:\Users\chris\source\repos\Cell\Cell\obj\Debug\net8.0-windows\Cell_gaejwkks_wpftmp.GlobalUsings.g.cs", "C#", 5, 0, 0, 0, 0, 1, 1, 7
"c:\Users\chris\source\repos\Cell\Cell\obj\Debug\net8.0-windows\Cell_gaejwkks_wpftmp.sourcelink.json", "JSON", 0, 0, 0, 1, 0, 0, 0, 1
"c:\Users\chris\source\repos\Cell\Cell\obj\Debug\net8.0-windows\Cell_gb13nwei_wpftmp.AssemblyInfo.cs", "C#", 11, 0, 0, 0, 0, 10, 5, 26
"c:\Users\chris\source\repos\Cell\Cell\obj\Debug\net8.0-windows\Cell_gb13nwei_wpftmp.GeneratedMSBuildEditorConfig.editorconfig", "Properties", 0, 0, 0, 0, 21, 0, 1, 22
"c:\Users\chris\source\repos\Cell\Cell\obj\Debug\net8.0-windows\Cell_gb13nwei_wpftmp.GlobalUsings.g.cs", "C#", 5, 0, 0, 0, 0, 1, 1, 7
"c:\Users\chris\source\repos\Cell\Cell\obj\Debug\net8.0-windows\Cell_gb13nwei_wpftmp.sourcelink.json", "JSON", 0, 0, 0, 1, 0, 0, 0, 1
"c:\Users\chris\source\repos\Cell\Cell\obj\Debug\net8.0-windows\Cell_gb1qjqcd_wpftmp.AssemblyInfo.cs", "C#", 11, 0, 0, 0, 0, 10, 5, 26
"c:\Users\chris\source\repos\Cell\Cell\obj\Debug\net8.0-windows\Cell_gb1qjqcd_wpftmp.GeneratedMSBuildEditorConfig.editorconfig", "Properties", 0, 0, 0, 0, 21, 0, 1, 22
"c:\Users\chris\source\repos\Cell\Cell\obj\Debug\net8.0-windows\Cell_gb1qjqcd_wpftmp.GlobalUsings.g.cs", "C#", 5, 0, 0, 0, 0, 1, 1, 7
"c:\Users\chris\source\repos\Cell\Cell\obj\Debug\net8.0-windows\Cell_gb1qjqcd_wpftmp.sourcelink.json", "JSON", 0, 0, 0, 1, 0, 0, 0, 1
"c:\Users\chris\source\repos\Cell\Cell\obj\Debug\net8.0-windows\Cell_gbwnwky3_wpftmp.AssemblyInfo.cs", "C#", 11, 0, 0, 0, 0, 10, 5, 26
"c:\Users\chris\source\repos\Cell\Cell\obj\Debug\net8.0-windows\Cell_gbwnwky3_wpftmp.GeneratedMSBuildEditorConfig.editorconfig", "Properties", 0, 0, 0, 0, 21, 0, 1, 22
"c:\Users\chris\source\repos\Cell\Cell\obj\Debug\net8.0-windows\Cell_gbwnwky3_wpftmp.GlobalUsings.g.cs", "C#", 5, 0, 0, 0, 0, 1, 1, 7
"c:\Users\chris\source\repos\Cell\Cell\obj\Debug\net8.0-windows\Cell_gbwnwky3_wpftmp.sourcelink.json", "JSON", 0, 0, 0, 1, 0, 0, 0, 1
"c:\Users\chris\source\repos\Cell\Cell\obj\Debug\net8.0-windows\Cell_gcfldccc_wpftmp.AssemblyInfo.cs", "C#", 11, 0, 0, 0, 0, 10, 5, 26
"c:\Users\chris\source\repos\Cell\Cell\obj\Debug\net8.0-windows\Cell_gcfldccc_wpftmp.GeneratedMSBuildEditorConfig.editorconfig", "Properties", 0, 0, 0, 0, 21, 0, 1, 22
"c:\Users\chris\source\repos\Cell\Cell\obj\Debug\net8.0-windows\Cell_gcfldccc_wpftmp.GlobalUsings.g.cs", "C#", 5, 0, 0, 0, 0, 1, 1, 7
"c:\Users\chris\source\repos\Cell\Cell\obj\Debug\net8.0-windows\Cell_gcfldccc_wpftmp.sourcelink.json", "JSON", 0, 0, 0, 1, 0, 0, 0, 1
"c:\Users\chris\source\repos\Cell\Cell\obj\Debug\net8.0-windows\Cell_gcvwxvc2_wpftmp.AssemblyInfo.cs", "C#", 11, 0, 0, 0, 0, 10, 5, 26
"c:\Users\chris\source\repos\Cell\Cell\obj\Debug\net8.0-windows\Cell_gcvwxvc2_wpftmp.GeneratedMSBuildEditorConfig.editorconfig", "Properties", 0, 0, 0, 0, 21, 0, 1, 22
"c:\Users\chris\source\repos\Cell\Cell\obj\Debug\net8.0-windows\Cell_gcvwxvc2_wpftmp.GlobalUsings.g.cs", "C#", 5, 0, 0, 0, 0, 1, 1, 7
"c:\Users\chris\source\repos\Cell\Cell\obj\Debug\net8.0-windows\Cell_gcvwxvc2_wpftmp.sourcelink.json", "JSON", 0, 0, 0, 1, 0, 0, 0, 1
"c:\Users\chris\source\repos\Cell\Cell\obj\Debug\net8.0-windows\Cell_gcxr154y_wpftmp.AssemblyInfo.cs", "C#", 11, 0, 0, 0, 0, 10, 5, 26
"c:\Users\chris\source\repos\Cell\Cell\obj\Debug\net8.0-windows\Cell_gcxr154y_wpftmp.GeneratedMSBuildEditorConfig.editorconfig", "Properties", 0, 0, 0, 0, 21, 0, 1, 22
"c:\Users\chris\source\repos\Cell\Cell\obj\Debug\net8.0-windows\Cell_gcxr154y_wpftmp.GlobalUsings.g.cs", "C#", 5, 0, 0, 0, 0, 1, 1, 7
"c:\Users\chris\source\repos\Cell\Cell\obj\Debug\net8.0-windows\Cell_gcxr154y_wpftmp.sourcelink.json", "JSON", 0, 0, 0, 1, 0, 0, 0, 1
"c:\Users\chris\source\repos\Cell\Cell\obj\Debug\net8.0-windows\Cell_ge2xm4ol_wpftmp.AssemblyInfo.cs", "C#", 11, 0, 0, 0, 0, 10, 5, 26
"c:\Users\chris\source\repos\Cell\Cell\obj\Debug\net8.0-windows\Cell_ge2xm4ol_wpftmp.GeneratedMSBuildEditorConfig.editorconfig", "Properties", 0, 0, 0, 0, 21, 0, 1, 22
"c:\Users\chris\source\repos\Cell\Cell\obj\Debug\net8.0-windows\Cell_ge2xm4ol_wpftmp.GlobalUsings.g.cs", "C#", 5, 0, 0, 0, 0, 1, 1, 7
"c:\Users\chris\source\repos\Cell\Cell\obj\Debug\net8.0-windows\Cell_ge2xm4ol_wpftmp.sourcelink.json", "JSON", 0, 0, 0, 1, 0, 0, 0, 1
"c:\Users\chris\source\repos\Cell\Cell\obj\Debug\net8.0-windows\Cell_gfcq2z2e_wpftmp.AssemblyInfo.cs", "C#", 11, 0, 0, 0, 0, 10, 5, 26
"c:\Users\chris\source\repos\Cell\Cell\obj\Debug\net8.0-windows\Cell_gfcq2z2e_wpftmp.GeneratedMSBuildEditorConfig.editorconfig", "Properties", 0, 0, 0, 0, 13, 0, 1, 14
"c:\Users\chris\source\repos\Cell\Cell\obj\Debug\net8.0-windows\Cell_gfcq2z2e_wpftmp.GlobalUsings.g.cs", "C#", 5, 0, 0, 0, 0, 1, 1, 7
"c:\Users\chris\source\repos\Cell\Cell\obj\Debug\net8.0-windows\Cell_gfidiejz_wpftmp.AssemblyInfo.cs", "C#", 11, 0, 0, 0, 0, 10, 5, 26
"c:\Users\chris\source\repos\Cell\Cell\obj\Debug\net8.0-windows\Cell_gfidiejz_wpftmp.GeneratedMSBuildEditorConfig.editorconfig", "Properties", 0, 0, 0, 0, 13, 0, 1, 14
"c:\Users\chris\source\repos\Cell\Cell\obj\Debug\net8.0-windows\Cell_gfidiejz_wpftmp.GlobalUsings.g.cs", "C#", 5, 0, 0, 0, 0, 1, 1, 7
"c:\Users\chris\source\repos\Cell\Cell\obj\Debug\net8.0-windows\Cell_gg2ocy0a_wpftmp.AssemblyInfo.cs", "C#", 11, 0, 0, 0, 0, 10, 5, 26
"c:\Users\chris\source\repos\Cell\Cell\obj\Debug\net8.0-windows\Cell_gg2ocy0a_wpftmp.GeneratedMSBuildEditorConfig.editorconfig", "Properties", 0, 0, 0, 0, 21, 0, 1, 22
"c:\Users\chris\source\repos\Cell\Cell\obj\Debug\net8.0-windows\Cell_gg2ocy0a_wpftmp.GlobalUsings.g.cs", "C#", 5, 0, 0, 0, 0, 1, 1, 7
"c:\Users\chris\source\repos\Cell\Cell\obj\Debug\net8.0-windows\Cell_gg2ocy0a_wpftmp.sourcelink.json", "JSON", 0, 0, 0, 1, 0, 0, 0, 1
"c:\Users\chris\source\repos\Cell\Cell\obj\Debug\net8.0-windows\Cell_ghobczpv_wpftmp.AssemblyInfo.cs", "C#", 11, 0, 0, 0, 0, 10, 5, 26
"c:\Users\chris\source\repos\Cell\Cell\obj\Debug\net8.0-windows\Cell_ghobczpv_wpftmp.GeneratedMSBuildEditorConfig.editorconfig", "Properties", 0, 0, 0, 0, 21, 0, 1, 22
"c:\Users\chris\source\repos\Cell\Cell\obj\Debug\net8.0-windows\Cell_ghobczpv_wpftmp.GlobalUsings.g.cs", "C#", 5, 0, 0, 0, 0, 1, 1, 7
"c:\Users\chris\source\repos\Cell\Cell\obj\Debug\net8.0-windows\Cell_ghobczpv_wpftmp.sourcelink.json", "JSON", 0, 0, 0, 1, 0, 0, 0, 1
"c:\Users\chris\source\repos\Cell\Cell\obj\Debug\net8.0-windows\Cell_giehj0vx_wpftmp.AssemblyInfo.cs", "C#", 11, 0, 0, 0, 0, 10, 5, 26
"c:\Users\chris\source\repos\Cell\Cell\obj\Debug\net8.0-windows\Cell_giehj0vx_wpftmp.GeneratedMSBuildEditorConfig.editorconfig", "Properties", 0, 0, 0, 0, 13, 0, 1, 14
"c:\Users\chris\source\repos\Cell\Cell\obj\Debug\net8.0-windows\Cell_giehj0vx_wpftmp.GlobalUsings.g.cs", "C#", 5, 0, 0, 0, 0, 1, 1, 7
"c:\Users\chris\source\repos\Cell\Cell\obj\Debug\net8.0-windows\Cell_gini22mh_wpftmp.AssemblyInfo.cs", "C#", 11, 0, 0, 0, 0, 10, 5, 26
"c:\Users\chris\source\repos\Cell\Cell\obj\Debug\net8.0-windows\Cell_gini22mh_wpftmp.GeneratedMSBuildEditorConfig.editorconfig", "Properties", 0, 0, 0, 0, 21, 0, 1, 22
"c:\Users\chris\source\repos\Cell\Cell\obj\Debug\net8.0-windows\Cell_gini22mh_wpftmp.GlobalUsings.g.cs", "C#", 5, 0, 0, 0, 0, 1, 1, 7
"c:\Users\chris\source\repos\Cell\Cell\obj\Debug\net8.0-windows\Cell_gini22mh_wpftmp.sourcelink.json", "JSON", 0, 0, 0, 1, 0, 0, 0, 1
"c:\Users\chris\source\repos\Cell\Cell\obj\Debug\net8.0-windows\Cell_ginooalo_wpftmp.AssemblyInfo.cs", "C#", 11, 0, 0, 0, 0, 10, 5, 26
"c:\Users\chris\source\repos\Cell\Cell\obj\Debug\net8.0-windows\Cell_ginooalo_wpftmp.GeneratedMSBuildEditorConfig.editorconfig", "Properties", 0, 0, 0, 0, 21, 0, 1, 22
"c:\Users\chris\source\repos\Cell\Cell\obj\Debug\net8.0-windows\Cell_ginooalo_wpftmp.GlobalUsings.g.cs", "C#", 5, 0, 0, 0, 0, 1, 1, 7
"c:\Users\chris\source\repos\Cell\Cell\obj\Debug\net8.0-windows\Cell_ginooalo_wpftmp.sourcelink.json", "JSON", 0, 0, 0, 1, 0, 0, 0, 1
"c:\Users\chris\source\repos\Cell\Cell\obj\Debug\net8.0-windows\Cell_girgz005_wpftmp.AssemblyInfo.cs", "C#", 11, 0, 0, 0, 0, 10, 5, 26
"c:\Users\chris\source\repos\Cell\Cell\obj\Debug\net8.0-windows\Cell_girgz005_wpftmp.GeneratedMSBuildEditorConfig.editorconfig", "Properties", 0, 0, 0, 0, 13, 0, 1, 14
"c:\Users\chris\source\repos\Cell\Cell\obj\Debug\net8.0-windows\Cell_girgz005_wpftmp.GlobalUsings.g.cs", "C#", 5, 0, 0, 0, 0, 1, 1, 7
"c:\Users\chris\source\repos\Cell\Cell\obj\Debug\net8.0-windows\Cell_gkkjnt5f_wpftmp.AssemblyInfo.cs", "C#", 11, 0, 0, 0, 0, 10, 5, 26
"c:\Users\chris\source\repos\Cell\Cell\obj\Debug\net8.0-windows\Cell_gkkjnt5f_wpftmp.GeneratedMSBuildEditorConfig.editorconfig", "Properties", 0, 0, 0, 0, 21, 0, 1, 22
"c:\Users\chris\source\repos\Cell\Cell\obj\Debug\net8.0-windows\Cell_gkkjnt5f_wpftmp.GlobalUsings.g.cs", "C#", 5, 0, 0, 0, 0, 1, 1, 7
"c:\Users\chris\source\repos\Cell\Cell\obj\Debug\net8.0-windows\Cell_gkkjnt5f_wpftmp.sourcelink.json", "JSON", 0, 0, 0, 1, 0, 0, 0, 1
"c:\Users\chris\source\repos\Cell\Cell\obj\Debug\net8.0-windows\Cell_glxke43s_wpftmp.AssemblyInfo.cs", "C#", 11, 0, 0, 0, 0, 10, 5, 26
"c:\Users\chris\source\repos\Cell\Cell\obj\Debug\net8.0-windows\Cell_glxke43s_wpftmp.GeneratedMSBuildEditorConfig.editorconfig", "Properties", 0, 0, 0, 0, 21, 0, 1, 22
"c:\Users\chris\source\repos\Cell\Cell\obj\Debug\net8.0-windows\Cell_glxke43s_wpftmp.GlobalUsings.g.cs", "C#", 5, 0, 0, 0, 0, 1, 1, 7
"c:\Users\chris\source\repos\Cell\Cell\obj\Debug\net8.0-windows\Cell_glxke43s_wpftmp.sourcelink.json", "JSON", 0, 0, 0, 1, 0, 0, 0, 1
"c:\Users\chris\source\repos\Cell\Cell\obj\Debug\net8.0-windows\Cell_gnc1twvb_wpftmp.AssemblyInfo.cs", "C#", 11, 0, 0, 0, 0, 10, 5, 26
"c:\Users\chris\source\repos\Cell\Cell\obj\Debug\net8.0-windows\Cell_gnc1twvb_wpftmp.GeneratedMSBuildEditorConfig.editorconfig", "Properties", 0, 0, 0, 0, 21, 0, 1, 22
"c:\Users\chris\source\repos\Cell\Cell\obj\Debug\net8.0-windows\Cell_gnc1twvb_wpftmp.GlobalUsings.g.cs", "C#", 5, 0, 0, 0, 0, 1, 1, 7
"c:\Users\chris\source\repos\Cell\Cell\obj\Debug\net8.0-windows\Cell_gnc1twvb_wpftmp.sourcelink.json", "JSON", 0, 0, 0, 1, 0, 0, 0, 1
"c:\Users\chris\source\repos\Cell\Cell\obj\Debug\net8.0-windows\Cell_gosyynx2_wpftmp.AssemblyInfo.cs", "C#", 11, 0, 0, 0, 0, 10, 5, 26
"c:\Users\chris\source\repos\Cell\Cell\obj\Debug\net8.0-windows\Cell_gosyynx2_wpftmp.GeneratedMSBuildEditorConfig.editorconfig", "Properties", 0, 0, 0, 0, 21, 0, 1, 22
"c:\Users\chris\source\repos\Cell\Cell\obj\Debug\net8.0-windows\Cell_gosyynx2_wpftmp.GlobalUsings.g.cs", "C#", 5, 0, 0, 0, 0, 1, 1, 7
"c:\Users\chris\source\repos\Cell\Cell\obj\Debug\net8.0-windows\Cell_gosyynx2_wpftmp.sourcelink.json", "JSON", 0, 0, 0, 1, 0, 0, 0, 1
"c:\Users\chris\source\repos\Cell\Cell\obj\Debug\net8.0-windows\Cell_grfmxwyz_wpftmp.AssemblyInfo.cs", "C#", 11, 0, 0, 0, 0, 10, 5, 26
"c:\Users\chris\source\repos\Cell\Cell\obj\Debug\net8.0-windows\Cell_grfmxwyz_wpftmp.GeneratedMSBuildEditorConfig.editorconfig", "Properties", 0, 0, 0, 0, 21, 0, 1, 22
"c:\Users\chris\source\repos\Cell\Cell\obj\Debug\net8.0-windows\Cell_grfmxwyz_wpftmp.GlobalUsings.g.cs", "C#", 5, 0, 0, 0, 0, 1, 1, 7
"c:\Users\chris\source\repos\Cell\Cell\obj\Debug\net8.0-windows\Cell_grfmxwyz_wpftmp.sourcelink.json", "JSON", 0, 0, 0, 1, 0, 0, 0, 1
"c:\Users\chris\source\repos\Cell\Cell\obj\Debug\net8.0-windows\Cell_gsvq3rqs_wpftmp.AssemblyInfo.cs", "C#", 11, 0, 0, 0, 0, 10, 5, 26
"c:\Users\chris\source\repos\Cell\Cell\obj\Debug\net8.0-windows\Cell_gsvq3rqs_wpftmp.GeneratedMSBuildEditorConfig.editorconfig", "Properties", 0, 0, 0, 0, 21, 0, 1, 22
"c:\Users\chris\source\repos\Cell\Cell\obj\Debug\net8.0-windows\Cell_gsvq3rqs_wpftmp.GlobalUsings.g.cs", "C#", 5, 0, 0, 0, 0, 1, 1, 7
"c:\Users\chris\source\repos\Cell\Cell\obj\Debug\net8.0-windows\Cell_gsvq3rqs_wpftmp.sourcelink.json", "JSON", 0, 0, 0, 1, 0, 0, 0, 1
"c:\Users\chris\source\repos\Cell\Cell\obj\Debug\net8.0-windows\Cell_gt1omt2q_wpftmp.AssemblyInfo.cs", "C#", 11, 0, 0, 0, 0, 10, 5, 26
"c:\Users\chris\source\repos\Cell\Cell\obj\Debug\net8.0-windows\Cell_gt1omt2q_wpftmp.GeneratedMSBuildEditorConfig.editorconfig", "Properties", 0, 0, 0, 0, 21, 0, 1, 22
"c:\Users\chris\source\repos\Cell\Cell\obj\Debug\net8.0-windows\Cell_gt1omt2q_wpftmp.GlobalUsings.g.cs", "C#", 5, 0, 0, 0, 0, 1, 1, 7
"c:\Users\chris\source\repos\Cell\Cell\obj\Debug\net8.0-windows\Cell_gt1omt2q_wpftmp.sourcelink.json", "JSON", 0, 0, 0, 1, 0, 0, 0, 1
"c:\Users\chris\source\repos\Cell\Cell\obj\Debug\net8.0-windows\Cell_gtcxlp01_wpftmp.AssemblyInfo.cs", "C#", 11, 0, 0, 0, 0, 10, 5, 26
"c:\Users\chris\source\repos\Cell\Cell\obj\Debug\net8.0-windows\Cell_gtcxlp01_wpftmp.GeneratedMSBuildEditorConfig.editorconfig", "Properties", 0, 0, 0, 0, 21, 0, 1, 22
"c:\Users\chris\source\repos\Cell\Cell\obj\Debug\net8.0-windows\Cell_gtcxlp01_wpftmp.GlobalUsings.g.cs", "C#", 5, 0, 0, 0, 0, 1, 1, 7
"c:\Users\chris\source\repos\Cell\Cell\obj\Debug\net8.0-windows\Cell_gtcxlp01_wpftmp.sourcelink.json", "JSON", 0, 0, 0, 1, 0, 0, 0, 1
"c:\Users\chris\source\repos\Cell\Cell\obj\Debug\net8.0-windows\Cell_gux2f5ks_wpftmp.AssemblyInfo.cs", "C#", 11, 0, 0, 0, 0, 10, 5, 26
"c:\Users\chris\source\repos\Cell\Cell\obj\Debug\net8.0-windows\Cell_gux2f5ks_wpftmp.GeneratedMSBuildEditorConfig.editorconfig", "Properties", 0, 0, 0, 0, 21, 0, 1, 22
"c:\Users\chris\source\repos\Cell\Cell\obj\Debug\net8.0-windows\Cell_gux2f5ks_wpftmp.GlobalUsings.g.cs", "C#", 5, 0, 0, 0, 0, 1, 1, 7
"c:\Users\chris\source\repos\Cell\Cell\obj\Debug\net8.0-windows\Cell_gux2f5ks_wpftmp.sourcelink.json", "JSON", 0, 0, 0, 1, 0, 0, 0, 1
"c:\Users\chris\source\repos\Cell\Cell\obj\Debug\net8.0-windows\Cell_gvzzz21k_wpftmp.AssemblyInfo.cs", "C#", 11, 0, 0, 0, 0, 10, 5, 26
"c:\Users\chris\source\repos\Cell\Cell\obj\Debug\net8.0-windows\Cell_gvzzz21k_wpftmp.GeneratedMSBuildEditorConfig.editorconfig", "Properties", 0, 0, 0, 0, 21, 0, 1, 22
"c:\Users\chris\source\repos\Cell\Cell\obj\Debug\net8.0-windows\Cell_gvzzz21k_wpftmp.GlobalUsings.g.cs", "C#", 5, 0, 0, 0, 0, 1, 1, 7
"c:\Users\chris\source\repos\Cell\Cell\obj\Debug\net8.0-windows\Cell_gvzzz21k_wpftmp.sourcelink.json", "JSON", 0, 0, 0, 1, 0, 0, 0, 1
"c:\Users\chris\source\repos\Cell\Cell\obj\Debug\net8.0-windows\Cell_gw3wwbrw_wpftmp.AssemblyInfo.cs", "C#", 11, 0, 0, 0, 0, 10, 5, 26
"c:\Users\chris\source\repos\Cell\Cell\obj\Debug\net8.0-windows\Cell_gw3wwbrw_wpftmp.GeneratedMSBuildEditorConfig.editorconfig", "Properties", 0, 0, 0, 0, 21, 0, 1, 22
"c:\Users\chris\source\repos\Cell\Cell\obj\Debug\net8.0-windows\Cell_gw3wwbrw_wpftmp.GlobalUsings.g.cs", "C#", 5, 0, 0, 0, 0, 1, 1, 7
"c:\Users\chris\source\repos\Cell\Cell\obj\Debug\net8.0-windows\Cell_gw3wwbrw_wpftmp.sourcelink.json", "JSON", 0, 0, 0, 1, 0, 0, 0, 1
"c:\Users\chris\source\repos\Cell\Cell\obj\Debug\net8.0-windows\Cell_gy1yglkd_wpftmp.AssemblyInfo.cs", "C#", 11, 0, 0, 0, 0, 10, 5, 26
"c:\Users\chris\source\repos\Cell\Cell\obj\Debug\net8.0-windows\Cell_gy1yglkd_wpftmp.GeneratedMSBuildEditorConfig.editorconfig", "Properties", 0, 0, 0, 0, 21, 0, 1, 22
"c:\Users\chris\source\repos\Cell\Cell\obj\Debug\net8.0-windows\Cell_gy1yglkd_wpftmp.GlobalUsings.g.cs", "C#", 5, 0, 0, 0, 0, 1, 1, 7
"c:\Users\chris\source\repos\Cell\Cell\obj\Debug\net8.0-windows\Cell_gy1yglkd_wpftmp.sourcelink.json", "JSON", 0, 0, 0, 1, 0, 0, 0, 1
"c:\Users\chris\source\repos\Cell\Cell\obj\Debug\net8.0-windows\Cell_gyyjzdxy_wpftmp.AssemblyInfo.cs", "C#", 11, 0, 0, 0, 0, 10, 5, 26
"c:\Users\chris\source\repos\Cell\Cell\obj\Debug\net8.0-windows\Cell_gyyjzdxy_wpftmp.GeneratedMSBuildEditorConfig.editorconfig", "Properties", 0, 0, 0, 0, 21, 0, 1, 22
"c:\Users\chris\source\repos\Cell\Cell\obj\Debug\net8.0-windows\Cell_gyyjzdxy_wpftmp.GlobalUsings.g.cs", "C#", 5, 0, 0, 0, 0, 1, 1, 7
"c:\Users\chris\source\repos\Cell\Cell\obj\Debug\net8.0-windows\Cell_gyyjzdxy_wpftmp.sourcelink.json", "JSON", 0, 0, 0, 1, 0, 0, 0, 1
"c:\Users\chris\source\repos\Cell\Cell\obj\Debug\net8.0-windows\Cell_gz3l5cp4_wpftmp.AssemblyInfo.cs", "C#", 11, 0, 0, 0, 0, 10, 5, 26
"c:\Users\chris\source\repos\Cell\Cell\obj\Debug\net8.0-windows\Cell_gz3l5cp4_wpftmp.GeneratedMSBuildEditorConfig.editorconfig", "Properties", 0, 0, 0, 0, 21, 0, 1, 22
"c:\Users\chris\source\repos\Cell\Cell\obj\Debug\net8.0-windows\Cell_gz3l5cp4_wpftmp.GlobalUsings.g.cs", "C#", 5, 0, 0, 0, 0, 1, 1, 7
"c:\Users\chris\source\repos\Cell\Cell\obj\Debug\net8.0-windows\Cell_gz3l5cp4_wpftmp.sourcelink.json", "JSON", 0, 0, 0, 1, 0, 0, 0, 1
"c:\Users\chris\source\repos\Cell\Cell\obj\Debug\net8.0-windows\Cell_h100tvni_wpftmp.AssemblyInfo.cs", "C#", 11, 0, 0, 0, 0, 10, 5, 26
"c:\Users\chris\source\repos\Cell\Cell\obj\Debug\net8.0-windows\Cell_h100tvni_wpftmp.GeneratedMSBuildEditorConfig.editorconfig", "Properties", 0, 0, 0, 0, 21, 0, 1, 22
"c:\Users\chris\source\repos\Cell\Cell\obj\Debug\net8.0-windows\Cell_h100tvni_wpftmp.GlobalUsings.g.cs", "C#", 5, 0, 0, 0, 0, 1, 1, 7
"c:\Users\chris\source\repos\Cell\Cell\obj\Debug\net8.0-windows\Cell_h100tvni_wpftmp.sourcelink.json", "JSON", 0, 0, 0, 1, 0, 0, 0, 1
"c:\Users\chris\source\repos\Cell\Cell\obj\Debug\net8.0-windows\Cell_h12hhyqa_wpftmp.AssemblyInfo.cs", "C#", 11, 0, 0, 0, 0, 10, 5, 26
"c:\Users\chris\source\repos\Cell\Cell\obj\Debug\net8.0-windows\Cell_h12hhyqa_wpftmp.GeneratedMSBuildEditorConfig.editorconfig", "Properties", 0, 0, 0, 0, 21, 0, 1, 22
"c:\Users\chris\source\repos\Cell\Cell\obj\Debug\net8.0-windows\Cell_h12hhyqa_wpftmp.GlobalUsings.g.cs", "C#", 5, 0, 0, 0, 0, 1, 1, 7
"c:\Users\chris\source\repos\Cell\Cell\obj\Debug\net8.0-windows\Cell_h12hhyqa_wpftmp.sourcelink.json", "JSON", 0, 0, 0, 1, 0, 0, 0, 1
"c:\Users\chris\source\repos\Cell\Cell\obj\Debug\net8.0-windows\Cell_h15zhdat_wpftmp.AssemblyInfo.cs", "C#", 11, 0, 0, 0, 0, 10, 5, 26
"c:\Users\chris\source\repos\Cell\Cell\obj\Debug\net8.0-windows\Cell_h15zhdat_wpftmp.GeneratedMSBuildEditorConfig.editorconfig", "Properties", 0, 0, 0, 0, 21, 0, 1, 22
"c:\Users\chris\source\repos\Cell\Cell\obj\Debug\net8.0-windows\Cell_h15zhdat_wpftmp.GlobalUsings.g.cs", "C#", 5, 0, 0, 0, 0, 1, 1, 7
"c:\Users\chris\source\repos\Cell\Cell\obj\Debug\net8.0-windows\Cell_h15zhdat_wpftmp.sourcelink.json", "JSON", 0, 0, 0, 1, 0, 0, 0, 1
"c:\Users\chris\source\repos\Cell\Cell\obj\Debug\net8.0-windows\Cell_h1hpemxc_wpftmp.AssemblyInfo.cs", "C#", 11, 0, 0, 0, 0, 10, 5, 26
"c:\Users\chris\source\repos\Cell\Cell\obj\Debug\net8.0-windows\Cell_h1hpemxc_wpftmp.GeneratedMSBuildEditorConfig.editorconfig", "Properties", 0, 0, 0, 0, 21, 0, 1, 22
"c:\Users\chris\source\repos\Cell\Cell\obj\Debug\net8.0-windows\Cell_h1hpemxc_wpftmp.GlobalUsings.g.cs", "C#", 5, 0, 0, 0, 0, 1, 1, 7
"c:\Users\chris\source\repos\Cell\Cell\obj\Debug\net8.0-windows\Cell_h1hpemxc_wpftmp.sourcelink.json", "JSON", 0, 0, 0, 1, 0, 0, 0, 1
"c:\Users\chris\source\repos\Cell\Cell\obj\Debug\net8.0-windows\Cell_h20fz5o0_wpftmp.AssemblyInfo.cs", "C#", 11, 0, 0, 0, 0, 10, 5, 26
"c:\Users\chris\source\repos\Cell\Cell\obj\Debug\net8.0-windows\Cell_h20fz5o0_wpftmp.GeneratedMSBuildEditorConfig.editorconfig", "Properties", 0, 0, 0, 0, 21, 0, 1, 22
"c:\Users\chris\source\repos\Cell\Cell\obj\Debug\net8.0-windows\Cell_h20fz5o0_wpftmp.GlobalUsings.g.cs", "C#", 5, 0, 0, 0, 0, 1, 1, 7
"c:\Users\chris\source\repos\Cell\Cell\obj\Debug\net8.0-windows\Cell_h20fz5o0_wpftmp.sourcelink.json", "JSON", 0, 0, 0, 1, 0, 0, 0, 1
"c:\Users\chris\source\repos\Cell\Cell\obj\Debug\net8.0-windows\Cell_h2a4cogs_wpftmp.AssemblyInfo.cs", "C#", 11, 0, 0, 0, 0, 10, 5, 26
"c:\Users\chris\source\repos\Cell\Cell\obj\Debug\net8.0-windows\Cell_h2a4cogs_wpftmp.GeneratedMSBuildEditorConfig.editorconfig", "Properties", 0, 0, 0, 0, 21, 0, 1, 22
"c:\Users\chris\source\repos\Cell\Cell\obj\Debug\net8.0-windows\Cell_h2a4cogs_wpftmp.GlobalUsings.g.cs", "C#", 5, 0, 0, 0, 0, 1, 1, 7
"c:\Users\chris\source\repos\Cell\Cell\obj\Debug\net8.0-windows\Cell_h2a4cogs_wpftmp.sourcelink.json", "JSON", 0, 0, 0, 1, 0, 0, 0, 1
"c:\Users\chris\source\repos\Cell\Cell\obj\Debug\net8.0-windows\Cell_h3juszib_wpftmp.AssemblyInfo.cs", "C#", 11, 0, 0, 0, 0, 10, 5, 26
"c:\Users\chris\source\repos\Cell\Cell\obj\Debug\net8.0-windows\Cell_h3juszib_wpftmp.GeneratedMSBuildEditorConfig.editorconfig", "Properties", 0, 0, 0, 0, 21, 0, 1, 22
"c:\Users\chris\source\repos\Cell\Cell\obj\Debug\net8.0-windows\Cell_h3juszib_wpftmp.GlobalUsings.g.cs", "C#", 5, 0, 0, 0, 0, 1, 1, 7
"c:\Users\chris\source\repos\Cell\Cell\obj\Debug\net8.0-windows\Cell_h3juszib_wpftmp.sourcelink.json", "JSON", 0, 0, 0, 1, 0, 0, 0, 1
"c:\Users\chris\source\repos\Cell\Cell\obj\Debug\net8.0-windows\Cell_ham2yrwe_wpftmp.AssemblyInfo.cs", "C#", 11, 0, 0, 0, 0, 10, 5, 26
"c:\Users\chris\source\repos\Cell\Cell\obj\Debug\net8.0-windows\Cell_ham2yrwe_wpftmp.GeneratedMSBuildEditorConfig.editorconfig", "Properties", 0, 0, 0, 0, 13, 0, 1, 14
"c:\Users\chris\source\repos\Cell\Cell\obj\Debug\net8.0-windows\Cell_ham2yrwe_wpftmp.GlobalUsings.g.cs", "C#", 5, 0, 0, 0, 0, 1, 1, 7
"c:\Users\chris\source\repos\Cell\Cell\obj\Debug\net8.0-windows\Cell_hbkfb2ek_wpftmp.AssemblyInfo.cs", "C#", 11, 0, 0, 0, 0, 10, 5, 26
"c:\Users\chris\source\repos\Cell\Cell\obj\Debug\net8.0-windows\Cell_hbkfb2ek_wpftmp.GeneratedMSBuildEditorConfig.editorconfig", "Properties", 0, 0, 0, 0, 21, 0, 1, 22
"c:\Users\chris\source\repos\Cell\Cell\obj\Debug\net8.0-windows\Cell_hbkfb2ek_wpftmp.GlobalUsings.g.cs", "C#", 5, 0, 0, 0, 0, 1, 1, 7
"c:\Users\chris\source\repos\Cell\Cell\obj\Debug\net8.0-windows\Cell_hbkfb2ek_wpftmp.sourcelink.json", "JSON", 0, 0, 0, 1, 0, 0, 0, 1
"c:\Users\chris\source\repos\Cell\Cell\obj\Debug\net8.0-windows\Cell_hdwfkz0b_wpftmp.AssemblyInfo.cs", "C#", 11, 0, 0, 0, 0, 10, 5, 26
"c:\Users\chris\source\repos\Cell\Cell\obj\Debug\net8.0-windows\Cell_hdwfkz0b_wpftmp.GeneratedMSBuildEditorConfig.editorconfig", "Properties", 0, 0, 0, 0, 21, 0, 1, 22
"c:\Users\chris\source\repos\Cell\Cell\obj\Debug\net8.0-windows\Cell_hdwfkz0b_wpftmp.GlobalUsings.g.cs", "C#", 5, 0, 0, 0, 0, 1, 1, 7
"c:\Users\chris\source\repos\Cell\Cell\obj\Debug\net8.0-windows\Cell_hdwfkz0b_wpftmp.sourcelink.json", "JSON", 0, 0, 0, 1, 0, 0, 0, 1
"c:\Users\chris\source\repos\Cell\Cell\obj\Debug\net8.0-windows\Cell_he1sfrzb_wpftmp.AssemblyInfo.cs", "C#", 11, 0, 0, 0, 0, 10, 5, 26
"c:\Users\chris\source\repos\Cell\Cell\obj\Debug\net8.0-windows\Cell_he1sfrzb_wpftmp.GeneratedMSBuildEditorConfig.editorconfig", "Properties", 0, 0, 0, 0, 13, 0, 1, 14
"c:\Users\chris\source\repos\Cell\Cell\obj\Debug\net8.0-windows\Cell_he1sfrzb_wpftmp.GlobalUsings.g.cs", "C#", 5, 0, 0, 0, 0, 1, 1, 7
"c:\Users\chris\source\repos\Cell\Cell\obj\Debug\net8.0-windows\Cell_hfczz4ke_wpftmp.AssemblyInfo.cs", "C#", 11, 0, 0, 0, 0, 10, 5, 26
"c:\Users\chris\source\repos\Cell\Cell\obj\Debug\net8.0-windows\Cell_hfczz4ke_wpftmp.GeneratedMSBuildEditorConfig.editorconfig", "Properties", 0, 0, 0, 0, 21, 0, 1, 22
"c:\Users\chris\source\repos\Cell\Cell\obj\Debug\net8.0-windows\Cell_hfczz4ke_wpftmp.GlobalUsings.g.cs", "C#", 5, 0, 0, 0, 0, 1, 1, 7
"c:\Users\chris\source\repos\Cell\Cell\obj\Debug\net8.0-windows\Cell_hfczz4ke_wpftmp.sourcelink.json", "JSON", 0, 0, 0, 1, 0, 0, 0, 1
"c:\Users\chris\source\repos\Cell\Cell\obj\Debug\net8.0-windows\Cell_hfpq5frs_wpftmp.AssemblyInfo.cs", "C#", 11, 0, 0, 0, 0, 10, 5, 26
"c:\Users\chris\source\repos\Cell\Cell\obj\Debug\net8.0-windows\Cell_hfpq5frs_wpftmp.GeneratedMSBuildEditorConfig.editorconfig", "Properties", 0, 0, 0, 0, 21, 0, 1, 22
"c:\Users\chris\source\repos\Cell\Cell\obj\Debug\net8.0-windows\Cell_hfpq5frs_wpftmp.GlobalUsings.g.cs", "C#", 5, 0, 0, 0, 0, 1, 1, 7
"c:\Users\chris\source\repos\Cell\Cell\obj\Debug\net8.0-windows\Cell_hfpq5frs_wpftmp.sourcelink.json", "JSON", 0, 0, 0, 1, 0, 0, 0, 1
"c:\Users\chris\source\repos\Cell\Cell\obj\Debug\net8.0-windows\Cell_hg4rjwb2_wpftmp.AssemblyInfo.cs", "C#", 11, 0, 0, 0, 0, 10, 5, 26
"c:\Users\chris\source\repos\Cell\Cell\obj\Debug\net8.0-windows\Cell_hg4rjwb2_wpftmp.GeneratedMSBuildEditorConfig.editorconfig", "Properties", 0, 0, 0, 0, 21, 0, 1, 22
"c:\Users\chris\source\repos\Cell\Cell\obj\Debug\net8.0-windows\Cell_hg4rjwb2_wpftmp.GlobalUsings.g.cs", "C#", 5, 0, 0, 0, 0, 1, 1, 7
"c:\Users\chris\source\repos\Cell\Cell\obj\Debug\net8.0-windows\Cell_hg4rjwb2_wpftmp.sourcelink.json", "JSON", 0, 0, 0, 1, 0, 0, 0, 1
"c:\Users\chris\source\repos\Cell\Cell\obj\Debug\net8.0-windows\Cell_hglqtd50_wpftmp.AssemblyInfo.cs", "C#", 11, 0, 0, 0, 0, 10, 5, 26
"c:\Users\chris\source\repos\Cell\Cell\obj\Debug\net8.0-windows\Cell_hglqtd50_wpftmp.GeneratedMSBuildEditorConfig.editorconfig", "Properties", 0, 0, 0, 0, 21, 0, 1, 22
"c:\Users\chris\source\repos\Cell\Cell\obj\Debug\net8.0-windows\Cell_hglqtd50_wpftmp.GlobalUsings.g.cs", "C#", 5, 0, 0, 0, 0, 1, 1, 7
"c:\Users\chris\source\repos\Cell\Cell\obj\Debug\net8.0-windows\Cell_hglqtd50_wpftmp.sourcelink.json", "JSON", 0, 0, 0, 1, 0, 0, 0, 1
"c:\Users\chris\source\repos\Cell\Cell\obj\Debug\net8.0-windows\Cell_hh3p3vgc_wpftmp.AssemblyInfo.cs", "C#", 11, 0, 0, 0, 0, 10, 5, 26
"c:\Users\chris\source\repos\Cell\Cell\obj\Debug\net8.0-windows\Cell_hh3p3vgc_wpftmp.GeneratedMSBuildEditorConfig.editorconfig", "Properties", 0, 0, 0, 0, 21, 0, 1, 22
"c:\Users\chris\source\repos\Cell\Cell\obj\Debug\net8.0-windows\Cell_hh3p3vgc_wpftmp.GlobalUsings.g.cs", "C#", 5, 0, 0, 0, 0, 1, 1, 7
"c:\Users\chris\source\repos\Cell\Cell\obj\Debug\net8.0-windows\Cell_hh3p3vgc_wpftmp.sourcelink.json", "JSON", 0, 0, 0, 1, 0, 0, 0, 1
"c:\Users\chris\source\repos\Cell\Cell\obj\Debug\net8.0-windows\Cell_hk0we31j_wpftmp.AssemblyInfo.cs", "C#", 11, 0, 0, 0, 0, 10, 5, 26
"c:\Users\chris\source\repos\Cell\Cell\obj\Debug\net8.0-windows\Cell_hk0we31j_wpftmp.GeneratedMSBuildEditorConfig.editorconfig", "Properties", 0, 0, 0, 0, 21, 0, 1, 22
"c:\Users\chris\source\repos\Cell\Cell\obj\Debug\net8.0-windows\Cell_hk0we31j_wpftmp.GlobalUsings.g.cs", "C#", 5, 0, 0, 0, 0, 1, 1, 7
"c:\Users\chris\source\repos\Cell\Cell\obj\Debug\net8.0-windows\Cell_hk0we31j_wpftmp.sourcelink.json", "JSON", 0, 0, 0, 1, 0, 0, 0, 1
"c:\Users\chris\source\repos\Cell\Cell\obj\Debug\net8.0-windows\Cell_hldoucem_wpftmp.AssemblyInfo.cs", "C#", 11, 0, 0, 0, 0, 10, 5, 26
"c:\Users\chris\source\repos\Cell\Cell\obj\Debug\net8.0-windows\Cell_hldoucem_wpftmp.GeneratedMSBuildEditorConfig.editorconfig", "Properties", 0, 0, 0, 0, 21, 0, 1, 22
"c:\Users\chris\source\repos\Cell\Cell\obj\Debug\net8.0-windows\Cell_hldoucem_wpftmp.GlobalUsings.g.cs", "C#", 5, 0, 0, 0, 0, 1, 1, 7
"c:\Users\chris\source\repos\Cell\Cell\obj\Debug\net8.0-windows\Cell_hldoucem_wpftmp.sourcelink.json", "JSON", 0, 0, 0, 1, 0, 0, 0, 1
"c:\Users\chris\source\repos\Cell\Cell\obj\Debug\net8.0-windows\Cell_hlfmvhhn_wpftmp.AssemblyInfo.cs", "C#", 11, 0, 0, 0, 0, 10, 5, 26
"c:\Users\chris\source\repos\Cell\Cell\obj\Debug\net8.0-windows\Cell_hlfmvhhn_wpftmp.GeneratedMSBuildEditorConfig.editorconfig", "Properties", 0, 0, 0, 0, 21, 0, 1, 22
"c:\Users\chris\source\repos\Cell\Cell\obj\Debug\net8.0-windows\Cell_hlfmvhhn_wpftmp.GlobalUsings.g.cs", "C#", 5, 0, 0, 0, 0, 1, 1, 7
"c:\Users\chris\source\repos\Cell\Cell\obj\Debug\net8.0-windows\Cell_hlfmvhhn_wpftmp.sourcelink.json", "JSON", 0, 0, 0, 1, 0, 0, 0, 1
"c:\Users\chris\source\repos\Cell\Cell\obj\Debug\net8.0-windows\Cell_hmsufgpj_wpftmp.AssemblyInfo.cs", "C#", 11, 0, 0, 0, 0, 10, 5, 26
"c:\Users\chris\source\repos\Cell\Cell\obj\Debug\net8.0-windows\Cell_hmsufgpj_wpftmp.GeneratedMSBuildEditorConfig.editorconfig", "Properties", 0, 0, 0, 0, 21, 0, 1, 22
"c:\Users\chris\source\repos\Cell\Cell\obj\Debug\net8.0-windows\Cell_hmsufgpj_wpftmp.GlobalUsings.g.cs", "C#", 5, 0, 0, 0, 0, 1, 1, 7
"c:\Users\chris\source\repos\Cell\Cell\obj\Debug\net8.0-windows\Cell_hmsufgpj_wpftmp.sourcelink.json", "JSON", 0, 0, 0, 1, 0, 0, 0, 1
"c:\Users\chris\source\repos\Cell\Cell\obj\Debug\net8.0-windows\Cell_hmwqemvo_wpftmp.AssemblyInfo.cs", "C#", 11, 0, 0, 0, 0, 10, 5, 26
"c:\Users\chris\source\repos\Cell\Cell\obj\Debug\net8.0-windows\Cell_hmwqemvo_wpftmp.GeneratedMSBuildEditorConfig.editorconfig", "Properties", 0, 0, 0, 0, 21, 0, 1, 22
"c:\Users\chris\source\repos\Cell\Cell\obj\Debug\net8.0-windows\Cell_hmwqemvo_wpftmp.GlobalUsings.g.cs", "C#", 5, 0, 0, 0, 0, 1, 1, 7
"c:\Users\chris\source\repos\Cell\Cell\obj\Debug\net8.0-windows\Cell_hmwqemvo_wpftmp.sourcelink.json", "JSON", 0, 0, 0, 1, 0, 0, 0, 1
"c:\Users\chris\source\repos\Cell\Cell\obj\Debug\net8.0-windows\Cell_hnj40cxj_wpftmp.AssemblyInfo.cs", "C#", 11, 0, 0, 0, 0, 10, 5, 26
"c:\Users\chris\source\repos\Cell\Cell\obj\Debug\net8.0-windows\Cell_hnj40cxj_wpftmp.GeneratedMSBuildEditorConfig.editorconfig", "Properties", 0, 0, 0, 0, 21, 0, 1, 22
"c:\Users\chris\source\repos\Cell\Cell\obj\Debug\net8.0-windows\Cell_hnj40cxj_wpftmp.GlobalUsings.g.cs", "C#", 5, 0, 0, 0, 0, 1, 1, 7
"c:\Users\chris\source\repos\Cell\Cell\obj\Debug\net8.0-windows\Cell_hnj40cxj_wpftmp.sourcelink.json", "JSON", 0, 0, 0, 1, 0, 0, 0, 1
"c:\Users\chris\source\repos\Cell\Cell\obj\Debug\net8.0-windows\Cell_hnmuyhik_wpftmp.AssemblyInfo.cs", "C#", 11, 0, 0, 0, 0, 10, 5, 26
"c:\Users\chris\source\repos\Cell\Cell\obj\Debug\net8.0-windows\Cell_hnmuyhik_wpftmp.GeneratedMSBuildEditorConfig.editorconfig", "Properties", 0, 0, 0, 0, 21, 0, 1, 22
"c:\Users\chris\source\repos\Cell\Cell\obj\Debug\net8.0-windows\Cell_hnmuyhik_wpftmp.GlobalUsings.g.cs", "C#", 5, 0, 0, 0, 0, 1, 1, 7
"c:\Users\chris\source\repos\Cell\Cell\obj\Debug\net8.0-windows\Cell_hnmuyhik_wpftmp.sourcelink.json", "JSON", 0, 0, 0, 1, 0, 0, 0, 1
"c:\Users\chris\source\repos\Cell\Cell\obj\Debug\net8.0-windows\Cell_hntnh0an_wpftmp.AssemblyInfo.cs", "C#", 11, 0, 0, 0, 0, 10, 5, 26
"c:\Users\chris\source\repos\Cell\Cell\obj\Debug\net8.0-windows\Cell_hntnh0an_wpftmp.GeneratedMSBuildEditorConfig.editorconfig", "Properties", 0, 0, 0, 0, 13, 0, 1, 14
"c:\Users\chris\source\repos\Cell\Cell\obj\Debug\net8.0-windows\Cell_hntnh0an_wpftmp.GlobalUsings.g.cs", "C#", 5, 0, 0, 0, 0, 1, 1, 7
"c:\Users\chris\source\repos\Cell\Cell\obj\Debug\net8.0-windows\Cell_hon4qdg2_wpftmp.AssemblyInfo.cs", "C#", 11, 0, 0, 0, 0, 10, 5, 26
"c:\Users\chris\source\repos\Cell\Cell\obj\Debug\net8.0-windows\Cell_hon4qdg2_wpftmp.GeneratedMSBuildEditorConfig.editorconfig", "Properties", 0, 0, 0, 0, 21, 0, 1, 22
"c:\Users\chris\source\repos\Cell\Cell\obj\Debug\net8.0-windows\Cell_hon4qdg2_wpftmp.GlobalUsings.g.cs", "C#", 5, 0, 0, 0, 0, 1, 1, 7
"c:\Users\chris\source\repos\Cell\Cell\obj\Debug\net8.0-windows\Cell_hon4qdg2_wpftmp.sourcelink.json", "JSON", 0, 0, 0, 1, 0, 0, 0, 1
"c:\Users\chris\source\repos\Cell\Cell\obj\Debug\net8.0-windows\Cell_hpokrzdv_wpftmp.AssemblyInfo.cs", "C#", 11, 0, 0, 0, 0, 10, 5, 26
"c:\Users\chris\source\repos\Cell\Cell\obj\Debug\net8.0-windows\Cell_hpokrzdv_wpftmp.GeneratedMSBuildEditorConfig.editorconfig", "Properties", 0, 0, 0, 0, 21, 0, 1, 22
"c:\Users\chris\source\repos\Cell\Cell\obj\Debug\net8.0-windows\Cell_hpokrzdv_wpftmp.GlobalUsings.g.cs", "C#", 5, 0, 0, 0, 0, 1, 1, 7
"c:\Users\chris\source\repos\Cell\Cell\obj\Debug\net8.0-windows\Cell_hpokrzdv_wpftmp.sourcelink.json", "JSON", 0, 0, 0, 1, 0, 0, 0, 1
"c:\Users\chris\source\repos\Cell\Cell\obj\Debug\net8.0-windows\Cell_hqkelduj_wpftmp.AssemblyInfo.cs", "C#", 11, 0, 0, 0, 0, 10, 5, 26
"c:\Users\chris\source\repos\Cell\Cell\obj\Debug\net8.0-windows\Cell_hqkelduj_wpftmp.GeneratedMSBuildEditorConfig.editorconfig", "Properties", 0, 0, 0, 0, 21, 0, 1, 22
"c:\Users\chris\source\repos\Cell\Cell\obj\Debug\net8.0-windows\Cell_hqkelduj_wpftmp.GlobalUsings.g.cs", "C#", 5, 0, 0, 0, 0, 1, 1, 7
"c:\Users\chris\source\repos\Cell\Cell\obj\Debug\net8.0-windows\Cell_hqkelduj_wpftmp.sourcelink.json", "JSON", 0, 0, 0, 1, 0, 0, 0, 1
"c:\Users\chris\source\repos\Cell\Cell\obj\Debug\net8.0-windows\Cell_hqr14fb2_wpftmp.AssemblyInfo.cs", "C#", 11, 0, 0, 0, 0, 10, 5, 26
"c:\Users\chris\source\repos\Cell\Cell\obj\Debug\net8.0-windows\Cell_hqr14fb2_wpftmp.GeneratedMSBuildEditorConfig.editorconfig", "Properties", 0, 0, 0, 0, 21, 0, 1, 22
"c:\Users\chris\source\repos\Cell\Cell\obj\Debug\net8.0-windows\Cell_hqr14fb2_wpftmp.GlobalUsings.g.cs", "C#", 5, 0, 0, 0, 0, 1, 1, 7
"c:\Users\chris\source\repos\Cell\Cell\obj\Debug\net8.0-windows\Cell_hqr14fb2_wpftmp.sourcelink.json", "JSON", 0, 0, 0, 1, 0, 0, 0, 1
"c:\Users\chris\source\repos\Cell\Cell\obj\Debug\net8.0-windows\Cell_hr2p5qsm_wpftmp.AssemblyInfo.cs", "C#", 11, 0, 0, 0, 0, 10, 5, 26
"c:\Users\chris\source\repos\Cell\Cell\obj\Debug\net8.0-windows\Cell_hr2p5qsm_wpftmp.GeneratedMSBuildEditorConfig.editorconfig", "Properties", 0, 0, 0, 0, 13, 0, 1, 14
"c:\Users\chris\source\repos\Cell\Cell\obj\Debug\net8.0-windows\Cell_hr2p5qsm_wpftmp.GlobalUsings.g.cs", "C#", 5, 0, 0, 0, 0, 1, 1, 7
"c:\Users\chris\source\repos\Cell\Cell\obj\Debug\net8.0-windows\Cell_hr4ompie_wpftmp.AssemblyInfo.cs", "C#", 11, 0, 0, 0, 0, 10, 5, 26
"c:\Users\chris\source\repos\Cell\Cell\obj\Debug\net8.0-windows\Cell_hr4ompie_wpftmp.GeneratedMSBuildEditorConfig.editorconfig", "Properties", 0, 0, 0, 0, 21, 0, 1, 22
"c:\Users\chris\source\repos\Cell\Cell\obj\Debug\net8.0-windows\Cell_hr4ompie_wpftmp.GlobalUsings.g.cs", "C#", 5, 0, 0, 0, 0, 1, 1, 7
"c:\Users\chris\source\repos\Cell\Cell\obj\Debug\net8.0-windows\Cell_hr4ompie_wpftmp.sourcelink.json", "JSON", 0, 0, 0, 1, 0, 0, 0, 1
"c:\Users\chris\source\repos\Cell\Cell\obj\Debug\net8.0-windows\Cell_hsebr2tx_wpftmp.AssemblyInfo.cs", "C#", 11, 0, 0, 0, 0, 10, 5, 26
"c:\Users\chris\source\repos\Cell\Cell\obj\Debug\net8.0-windows\Cell_hsebr2tx_wpftmp.GeneratedMSBuildEditorConfig.editorconfig", "Properties", 0, 0, 0, 0, 21, 0, 1, 22
"c:\Users\chris\source\repos\Cell\Cell\obj\Debug\net8.0-windows\Cell_hsebr2tx_wpftmp.GlobalUsings.g.cs", "C#", 5, 0, 0, 0, 0, 1, 1, 7
"c:\Users\chris\source\repos\Cell\Cell\obj\Debug\net8.0-windows\Cell_hsebr2tx_wpftmp.sourcelink.json", "JSON", 0, 0, 0, 1, 0, 0, 0, 1
"c:\Users\chris\source\repos\Cell\Cell\obj\Debug\net8.0-windows\Cell_hspjwaq4_wpftmp.AssemblyInfo.cs", "C#", 11, 0, 0, 0, 0, 10, 5, 26
"c:\Users\chris\source\repos\Cell\Cell\obj\Debug\net8.0-windows\Cell_hspjwaq4_wpftmp.GeneratedMSBuildEditorConfig.editorconfig", "Properties", 0, 0, 0, 0, 21, 0, 1, 22
"c:\Users\chris\source\repos\Cell\Cell\obj\Debug\net8.0-windows\Cell_hspjwaq4_wpftmp.GlobalUsings.g.cs", "C#", 5, 0, 0, 0, 0, 1, 1, 7
"c:\Users\chris\source\repos\Cell\Cell\obj\Debug\net8.0-windows\Cell_hspjwaq4_wpftmp.sourcelink.json", "JSON", 0, 0, 0, 1, 0, 0, 0, 1
"c:\Users\chris\source\repos\Cell\Cell\obj\Debug\net8.0-windows\Cell_htply5s3_wpftmp.AssemblyInfo.cs", "C#", 11, 0, 0, 0, 0, 10, 5, 26
"c:\Users\chris\source\repos\Cell\Cell\obj\Debug\net8.0-windows\Cell_htply5s3_wpftmp.GeneratedMSBuildEditorConfig.editorconfig", "Properties", 0, 0, 0, 0, 21, 0, 1, 22
"c:\Users\chris\source\repos\Cell\Cell\obj\Debug\net8.0-windows\Cell_htply5s3_wpftmp.GlobalUsings.g.cs", "C#", 5, 0, 0, 0, 0, 1, 1, 7
"c:\Users\chris\source\repos\Cell\Cell\obj\Debug\net8.0-windows\Cell_htply5s3_wpftmp.sourcelink.json", "JSON", 0, 0, 0, 1, 0, 0, 0, 1
"c:\Users\chris\source\repos\Cell\Cell\obj\Debug\net8.0-windows\Cell_hurpvzt1_wpftmp.AssemblyInfo.cs", "C#", 11, 0, 0, 0, 0, 10, 5, 26
"c:\Users\chris\source\repos\Cell\Cell\obj\Debug\net8.0-windows\Cell_hurpvzt1_wpftmp.GeneratedMSBuildEditorConfig.editorconfig", "Properties", 0, 0, 0, 0, 21, 0, 1, 22
"c:\Users\chris\source\repos\Cell\Cell\obj\Debug\net8.0-windows\Cell_hurpvzt1_wpftmp.GlobalUsings.g.cs", "C#", 5, 0, 0, 0, 0, 1, 1, 7
"c:\Users\chris\source\repos\Cell\Cell\obj\Debug\net8.0-windows\Cell_hurpvzt1_wpftmp.sourcelink.json", "JSON", 0, 0, 0, 1, 0, 0, 0, 1
"c:\Users\chris\source\repos\Cell\Cell\obj\Debug\net8.0-windows\Cell_hvabjdek_wpftmp.AssemblyInfo.cs", "C#", 11, 0, 0, 0, 0, 10, 5, 26
"c:\Users\chris\source\repos\Cell\Cell\obj\Debug\net8.0-windows\Cell_hvabjdek_wpftmp.GeneratedMSBuildEditorConfig.editorconfig", "Properties", 0, 0, 0, 0, 21, 0, 1, 22
"c:\Users\chris\source\repos\Cell\Cell\obj\Debug\net8.0-windows\Cell_hvabjdek_wpftmp.GlobalUsings.g.cs", "C#", 5, 0, 0, 0, 0, 1, 1, 7
"c:\Users\chris\source\repos\Cell\Cell\obj\Debug\net8.0-windows\Cell_hvabjdek_wpftmp.sourcelink.json", "JSON", 0, 0, 0, 1, 0, 0, 0, 1
"c:\Users\chris\source\repos\Cell\Cell\obj\Debug\net8.0-windows\Cell_hw34tztv_wpftmp.AssemblyInfo.cs", "C#", 11, 0, 0, 0, 0, 10, 5, 26
"c:\Users\chris\source\repos\Cell\Cell\obj\Debug\net8.0-windows\Cell_hw34tztv_wpftmp.GeneratedMSBuildEditorConfig.editorconfig", "Properties", 0, 0, 0, 0, 21, 0, 1, 22
"c:\Users\chris\source\repos\Cell\Cell\obj\Debug\net8.0-windows\Cell_hw34tztv_wpftmp.GlobalUsings.g.cs", "C#", 5, 0, 0, 0, 0, 1, 1, 7
"c:\Users\chris\source\repos\Cell\Cell\obj\Debug\net8.0-windows\Cell_hw34tztv_wpftmp.sourcelink.json", "JSON", 0, 0, 0, 1, 0, 0, 0, 1
"c:\Users\chris\source\repos\Cell\Cell\obj\Debug\net8.0-windows\Cell_hxcyvliz_wpftmp.AssemblyInfo.cs", "C#", 11, 0, 0, 0, 0, 10, 5, 26
"c:\Users\chris\source\repos\Cell\Cell\obj\Debug\net8.0-windows\Cell_hxcyvliz_wpftmp.GeneratedMSBuildEditorConfig.editorconfig", "Properties", 0, 0, 0, 0, 21, 0, 1, 22
"c:\Users\chris\source\repos\Cell\Cell\obj\Debug\net8.0-windows\Cell_hxcyvliz_wpftmp.GlobalUsings.g.cs", "C#", 5, 0, 0, 0, 0, 1, 1, 7
"c:\Users\chris\source\repos\Cell\Cell\obj\Debug\net8.0-windows\Cell_hxcyvliz_wpftmp.sourcelink.json", "JSON", 0, 0, 0, 1, 0, 0, 0, 1
"c:\Users\chris\source\repos\Cell\Cell\obj\Debug\net8.0-windows\Cell_hxtrmrn3_wpftmp.AssemblyInfo.cs", "C#", 11, 0, 0, 0, 0, 10, 5, 26
"c:\Users\chris\source\repos\Cell\Cell\obj\Debug\net8.0-windows\Cell_hxtrmrn3_wpftmp.GeneratedMSBuildEditorConfig.editorconfig", "Properties", 0, 0, 0, 0, 21, 0, 1, 22
"c:\Users\chris\source\repos\Cell\Cell\obj\Debug\net8.0-windows\Cell_hxtrmrn3_wpftmp.GlobalUsings.g.cs", "C#", 5, 0, 0, 0, 0, 1, 1, 7
"c:\Users\chris\source\repos\Cell\Cell\obj\Debug\net8.0-windows\Cell_hxtrmrn3_wpftmp.sourcelink.json", "JSON", 0, 0, 0, 1, 0, 0, 0, 1
"c:\Users\chris\source\repos\Cell\Cell\obj\Debug\net8.0-windows\Cell_hyt0lqr3_wpftmp.AssemblyInfo.cs", "C#", 11, 0, 0, 0, 0, 10, 5, 26
"c:\Users\chris\source\repos\Cell\Cell\obj\Debug\net8.0-windows\Cell_hyt0lqr3_wpftmp.GeneratedMSBuildEditorConfig.editorconfig", "Properties", 0, 0, 0, 0, 21, 0, 1, 22
"c:\Users\chris\source\repos\Cell\Cell\obj\Debug\net8.0-windows\Cell_hyt0lqr3_wpftmp.GlobalUsings.g.cs", "C#", 5, 0, 0, 0, 0, 1, 1, 7
"c:\Users\chris\source\repos\Cell\Cell\obj\Debug\net8.0-windows\Cell_hyt0lqr3_wpftmp.sourcelink.json", "JSON", 0, 0, 0, 1, 0, 0, 0, 1
"c:\Users\chris\source\repos\Cell\Cell\obj\Debug\net8.0-windows\Cell_hyvorl3d_wpftmp.AssemblyInfo.cs", "C#", 11, 0, 0, 0, 0, 10, 5, 26
"c:\Users\chris\source\repos\Cell\Cell\obj\Debug\net8.0-windows\Cell_hyvorl3d_wpftmp.GeneratedMSBuildEditorConfig.editorconfig", "Properties", 0, 0, 0, 0, 21, 0, 1, 22
"c:\Users\chris\source\repos\Cell\Cell\obj\Debug\net8.0-windows\Cell_hyvorl3d_wpftmp.GlobalUsings.g.cs", "C#", 5, 0, 0, 0, 0, 1, 1, 7
"c:\Users\chris\source\repos\Cell\Cell\obj\Debug\net8.0-windows\Cell_hyvorl3d_wpftmp.sourcelink.json", "JSON", 0, 0, 0, 1, 0, 0, 0, 1
"c:\Users\chris\source\repos\Cell\Cell\obj\Debug\net8.0-windows\Cell_hzed4dct_wpftmp.AssemblyInfo.cs", "C#", 11, 0, 0, 0, 0, 10, 5, 26
"c:\Users\chris\source\repos\Cell\Cell\obj\Debug\net8.0-windows\Cell_hzed4dct_wpftmp.GeneratedMSBuildEditorConfig.editorconfig", "Properties", 0, 0, 0, 0, 21, 0, 1, 22
"c:\Users\chris\source\repos\Cell\Cell\obj\Debug\net8.0-windows\Cell_hzed4dct_wpftmp.GlobalUsings.g.cs", "C#", 5, 0, 0, 0, 0, 1, 1, 7
"c:\Users\chris\source\repos\Cell\Cell\obj\Debug\net8.0-windows\Cell_hzed4dct_wpftmp.sourcelink.json", "JSON", 0, 0, 0, 1, 0, 0, 0, 1
"c:\Users\chris\source\repos\Cell\Cell\obj\Debug\net8.0-windows\Cell_hzog2kwn_wpftmp.AssemblyInfo.cs", "C#", 11, 0, 0, 0, 0, 10, 5, 26
"c:\Users\chris\source\repos\Cell\Cell\obj\Debug\net8.0-windows\Cell_hzog2kwn_wpftmp.GeneratedMSBuildEditorConfig.editorconfig", "Properties", 0, 0, 0, 0, 21, 0, 1, 22
"c:\Users\chris\source\repos\Cell\Cell\obj\Debug\net8.0-windows\Cell_hzog2kwn_wpftmp.GlobalUsings.g.cs", "C#", 5, 0, 0, 0, 0, 1, 1, 7
"c:\Users\chris\source\repos\Cell\Cell\obj\Debug\net8.0-windows\Cell_hzog2kwn_wpftmp.sourcelink.json", "JSON", 0, 0, 0, 1, 0, 0, 0, 1
"c:\Users\chris\source\repos\Cell\Cell\obj\Debug\net8.0-windows\Cell_hztqbbd2_wpftmp.AssemblyInfo.cs", "C#", 11, 0, 0, 0, 0, 10, 5, 26
"c:\Users\chris\source\repos\Cell\Cell\obj\Debug\net8.0-windows\Cell_hztqbbd2_wpftmp.GeneratedMSBuildEditorConfig.editorconfig", "Properties", 0, 0, 0, 0, 21, 0, 1, 22
"c:\Users\chris\source\repos\Cell\Cell\obj\Debug\net8.0-windows\Cell_hztqbbd2_wpftmp.GlobalUsings.g.cs", "C#", 5, 0, 0, 0, 0, 1, 1, 7
"c:\Users\chris\source\repos\Cell\Cell\obj\Debug\net8.0-windows\Cell_hztqbbd2_wpftmp.sourcelink.json", "JSON", 0, 0, 0, 1, 0, 0, 0, 1
"c:\Users\chris\source\repos\Cell\Cell\obj\Debug\net8.0-windows\Cell_i0p3nohd_wpftmp.AssemblyInfo.cs", "C#", 11, 0, 0, 0, 0, 10, 5, 26
"c:\Users\chris\source\repos\Cell\Cell\obj\Debug\net8.0-windows\Cell_i0p3nohd_wpftmp.GeneratedMSBuildEditorConfig.editorconfig", "Properties", 0, 0, 0, 0, 21, 0, 1, 22
"c:\Users\chris\source\repos\Cell\Cell\obj\Debug\net8.0-windows\Cell_i0p3nohd_wpftmp.GlobalUsings.g.cs", "C#", 5, 0, 0, 0, 0, 1, 1, 7
"c:\Users\chris\source\repos\Cell\Cell\obj\Debug\net8.0-windows\Cell_i0p3nohd_wpftmp.sourcelink.json", "JSON", 0, 0, 0, 1, 0, 0, 0, 1
"c:\Users\chris\source\repos\Cell\Cell\obj\Debug\net8.0-windows\Cell_i0zlll2z_wpftmp.AssemblyInfo.cs", "C#", 11, 0, 0, 0, 0, 10, 5, 26
"c:\Users\chris\source\repos\Cell\Cell\obj\Debug\net8.0-windows\Cell_i0zlll2z_wpftmp.GeneratedMSBuildEditorConfig.editorconfig", "Properties", 0, 0, 0, 0, 21, 0, 1, 22
"c:\Users\chris\source\repos\Cell\Cell\obj\Debug\net8.0-windows\Cell_i0zlll2z_wpftmp.GlobalUsings.g.cs", "C#", 5, 0, 0, 0, 0, 1, 1, 7
"c:\Users\chris\source\repos\Cell\Cell\obj\Debug\net8.0-windows\Cell_i0zlll2z_wpftmp.sourcelink.json", "JSON", 0, 0, 0, 1, 0, 0, 0, 1
"c:\Users\chris\source\repos\Cell\Cell\obj\Debug\net8.0-windows\Cell_i1nlmb4z_wpftmp.AssemblyInfo.cs", "C#", 11, 0, 0, 0, 0, 10, 5, 26
"c:\Users\chris\source\repos\Cell\Cell\obj\Debug\net8.0-windows\Cell_i1nlmb4z_wpftmp.GeneratedMSBuildEditorConfig.editorconfig", "Properties", 0, 0, 0, 0, 21, 0, 1, 22
"c:\Users\chris\source\repos\Cell\Cell\obj\Debug\net8.0-windows\Cell_i1nlmb4z_wpftmp.GlobalUsings.g.cs", "C#", 5, 0, 0, 0, 0, 1, 1, 7
"c:\Users\chris\source\repos\Cell\Cell\obj\Debug\net8.0-windows\Cell_i1nlmb4z_wpftmp.sourcelink.json", "JSON", 0, 0, 0, 1, 0, 0, 0, 1
"c:\Users\chris\source\repos\Cell\Cell\obj\Debug\net8.0-windows\Cell_i1q3scar_wpftmp.AssemblyInfo.cs", "C#", 11, 0, 0, 0, 0, 10, 5, 26
"c:\Users\chris\source\repos\Cell\Cell\obj\Debug\net8.0-windows\Cell_i1q3scar_wpftmp.GeneratedMSBuildEditorConfig.editorconfig", "Properties", 0, 0, 0, 0, 21, 0, 1, 22
"c:\Users\chris\source\repos\Cell\Cell\obj\Debug\net8.0-windows\Cell_i1q3scar_wpftmp.GlobalUsings.g.cs", "C#", 5, 0, 0, 0, 0, 1, 1, 7
"c:\Users\chris\source\repos\Cell\Cell\obj\Debug\net8.0-windows\Cell_i1q3scar_wpftmp.sourcelink.json", "JSON", 0, 0, 0, 1, 0, 0, 0, 1
"c:\Users\chris\source\repos\Cell\Cell\obj\Debug\net8.0-windows\Cell_i1qsu2su_wpftmp.AssemblyInfo.cs", "C#", 11, 0, 0, 0, 0, 10, 5, 26
"c:\Users\chris\source\repos\Cell\Cell\obj\Debug\net8.0-windows\Cell_i1qsu2su_wpftmp.GeneratedMSBuildEditorConfig.editorconfig", "Properties", 0, 0, 0, 0, 21, 0, 1, 22
"c:\Users\chris\source\repos\Cell\Cell\obj\Debug\net8.0-windows\Cell_i1qsu2su_wpftmp.GlobalUsings.g.cs", "C#", 5, 0, 0, 0, 0, 1, 1, 7
"c:\Users\chris\source\repos\Cell\Cell\obj\Debug\net8.0-windows\Cell_i1qsu2su_wpftmp.sourcelink.json", "JSON", 0, 0, 0, 1, 0, 0, 0, 1
"c:\Users\chris\source\repos\Cell\Cell\obj\Debug\net8.0-windows\Cell_i1tfbcac_wpftmp.AssemblyInfo.cs", "C#", 11, 0, 0, 0, 0, 10, 5, 26
"c:\Users\chris\source\repos\Cell\Cell\obj\Debug\net8.0-windows\Cell_i1tfbcac_wpftmp.GeneratedMSBuildEditorConfig.editorconfig", "Properties", 0, 0, 0, 0, 21, 0, 1, 22
"c:\Users\chris\source\repos\Cell\Cell\obj\Debug\net8.0-windows\Cell_i1tfbcac_wpftmp.GlobalUsings.g.cs", "C#", 5, 0, 0, 0, 0, 1, 1, 7
"c:\Users\chris\source\repos\Cell\Cell\obj\Debug\net8.0-windows\Cell_i1tfbcac_wpftmp.sourcelink.json", "JSON", 0, 0, 0, 1, 0, 0, 0, 1
"c:\Users\chris\source\repos\Cell\Cell\obj\Debug\net8.0-windows\Cell_i21zkfak_wpftmp.AssemblyInfo.cs", "C#", 11, 0, 0, 0, 0, 10, 5, 26
"c:\Users\chris\source\repos\Cell\Cell\obj\Debug\net8.0-windows\Cell_i21zkfak_wpftmp.GeneratedMSBuildEditorConfig.editorconfig", "Properties", 0, 0, 0, 0, 21, 0, 1, 22
"c:\Users\chris\source\repos\Cell\Cell\obj\Debug\net8.0-windows\Cell_i21zkfak_wpftmp.GlobalUsings.g.cs", "C#", 5, 0, 0, 0, 0, 1, 1, 7
"c:\Users\chris\source\repos\Cell\Cell\obj\Debug\net8.0-windows\Cell_i21zkfak_wpftmp.sourcelink.json", "JSON", 0, 0, 0, 1, 0, 0, 0, 1
"c:\Users\chris\source\repos\Cell\Cell\obj\Debug\net8.0-windows\Cell_i2h5hkos_wpftmp.AssemblyInfo.cs", "C#", 11, 0, 0, 0, 0, 10, 5, 26
"c:\Users\chris\source\repos\Cell\Cell\obj\Debug\net8.0-windows\Cell_i2h5hkos_wpftmp.GeneratedMSBuildEditorConfig.editorconfig", "Properties", 0, 0, 0, 0, 21, 0, 1, 22
"c:\Users\chris\source\repos\Cell\Cell\obj\Debug\net8.0-windows\Cell_i2h5hkos_wpftmp.GlobalUsings.g.cs", "C#", 5, 0, 0, 0, 0, 1, 1, 7
"c:\Users\chris\source\repos\Cell\Cell\obj\Debug\net8.0-windows\Cell_i2h5hkos_wpftmp.sourcelink.json", "JSON", 0, 0, 0, 1, 0, 0, 0, 1
"c:\Users\chris\source\repos\Cell\Cell\obj\Debug\net8.0-windows\Cell_i2o5h4ry_wpftmp.AssemblyInfo.cs", "C#", 11, 0, 0, 0, 0, 10, 5, 26
"c:\Users\chris\source\repos\Cell\Cell\obj\Debug\net8.0-windows\Cell_i2o5h4ry_wpftmp.GeneratedMSBuildEditorConfig.editorconfig", "Properties", 0, 0, 0, 0, 21, 0, 1, 22
"c:\Users\chris\source\repos\Cell\Cell\obj\Debug\net8.0-windows\Cell_i2o5h4ry_wpftmp.GlobalUsings.g.cs", "C#", 5, 0, 0, 0, 0, 1, 1, 7
"c:\Users\chris\source\repos\Cell\Cell\obj\Debug\net8.0-windows\Cell_i2o5h4ry_wpftmp.sourcelink.json", "JSON", 0, 0, 0, 1, 0, 0, 0, 1
"c:\Users\chris\source\repos\Cell\Cell\obj\Debug\net8.0-windows\Cell_i4yp1mql_wpftmp.AssemblyInfo.cs", "C#", 11, 0, 0, 0, 0, 10, 5, 26
"c:\Users\chris\source\repos\Cell\Cell\obj\Debug\net8.0-windows\Cell_i4yp1mql_wpftmp.GeneratedMSBuildEditorConfig.editorconfig", "Properties", 0, 0, 0, 0, 21, 0, 1, 22
"c:\Users\chris\source\repos\Cell\Cell\obj\Debug\net8.0-windows\Cell_i4yp1mql_wpftmp.GlobalUsings.g.cs", "C#", 5, 0, 0, 0, 0, 1, 1, 7
"c:\Users\chris\source\repos\Cell\Cell\obj\Debug\net8.0-windows\Cell_i4yp1mql_wpftmp.sourcelink.json", "JSON", 0, 0, 0, 1, 0, 0, 0, 1
"c:\Users\chris\source\repos\Cell\Cell\obj\Debug\net8.0-windows\Cell_ibnzr01h_wpftmp.AssemblyInfo.cs", "C#", 11, 0, 0, 0, 0, 10, 5, 26
"c:\Users\chris\source\repos\Cell\Cell\obj\Debug\net8.0-windows\Cell_ibnzr01h_wpftmp.GeneratedMSBuildEditorConfig.editorconfig", "Properties", 0, 0, 0, 0, 21, 0, 1, 22
"c:\Users\chris\source\repos\Cell\Cell\obj\Debug\net8.0-windows\Cell_ibnzr01h_wpftmp.GlobalUsings.g.cs", "C#", 5, 0, 0, 0, 0, 1, 1, 7
"c:\Users\chris\source\repos\Cell\Cell\obj\Debug\net8.0-windows\Cell_ibnzr01h_wpftmp.sourcelink.json", "JSON", 0, 0, 0, 1, 0, 0, 0, 1
"c:\Users\chris\source\repos\Cell\Cell\obj\Debug\net8.0-windows\Cell_ibs5cop2_wpftmp.AssemblyInfo.cs", "C#", 11, 0, 0, 0, 0, 10, 5, 26
"c:\Users\chris\source\repos\Cell\Cell\obj\Debug\net8.0-windows\Cell_ibs5cop2_wpftmp.GeneratedMSBuildEditorConfig.editorconfig", "Properties", 0, 0, 0, 0, 21, 0, 1, 22
"c:\Users\chris\source\repos\Cell\Cell\obj\Debug\net8.0-windows\Cell_ibs5cop2_wpftmp.GlobalUsings.g.cs", "C#", 5, 0, 0, 0, 0, 1, 1, 7
"c:\Users\chris\source\repos\Cell\Cell\obj\Debug\net8.0-windows\Cell_ibs5cop2_wpftmp.sourcelink.json", "JSON", 0, 0, 0, 1, 0, 0, 0, 1
"c:\Users\chris\source\repos\Cell\Cell\obj\Debug\net8.0-windows\Cell_ic0oeaqq_wpftmp.AssemblyInfo.cs", "C#", 11, 0, 0, 0, 0, 10, 5, 26
"c:\Users\chris\source\repos\Cell\Cell\obj\Debug\net8.0-windows\Cell_ic0oeaqq_wpftmp.GeneratedMSBuildEditorConfig.editorconfig", "Properties", 0, 0, 0, 0, 21, 0, 1, 22
"c:\Users\chris\source\repos\Cell\Cell\obj\Debug\net8.0-windows\Cell_ic0oeaqq_wpftmp.GlobalUsings.g.cs", "C#", 5, 0, 0, 0, 0, 1, 1, 7
"c:\Users\chris\source\repos\Cell\Cell\obj\Debug\net8.0-windows\Cell_ic0oeaqq_wpftmp.sourcelink.json", "JSON", 0, 0, 0, 1, 0, 0, 0, 1
"c:\Users\chris\source\repos\Cell\Cell\obj\Debug\net8.0-windows\Cell_icwib1rv_wpftmp.AssemblyInfo.cs", "C#", 11, 0, 0, 0, 0, 10, 5, 26
"c:\Users\chris\source\repos\Cell\Cell\obj\Debug\net8.0-windows\Cell_icwib1rv_wpftmp.GeneratedMSBuildEditorConfig.editorconfig", "Properties", 0, 0, 0, 0, 21, 0, 1, 22
"c:\Users\chris\source\repos\Cell\Cell\obj\Debug\net8.0-windows\Cell_icwib1rv_wpftmp.GlobalUsings.g.cs", "C#", 5, 0, 0, 0, 0, 1, 1, 7
"c:\Users\chris\source\repos\Cell\Cell\obj\Debug\net8.0-windows\Cell_icwib1rv_wpftmp.sourcelink.json", "JSON", 0, 0, 0, 1, 0, 0, 0, 1
"c:\Users\chris\source\repos\Cell\Cell\obj\Debug\net8.0-windows\Cell_idwgul2l_wpftmp.AssemblyInfo.cs", "C#", 11, 0, 0, 0, 0, 10, 5, 26
"c:\Users\chris\source\repos\Cell\Cell\obj\Debug\net8.0-windows\Cell_idwgul2l_wpftmp.GeneratedMSBuildEditorConfig.editorconfig", "Properties", 0, 0, 0, 0, 21, 0, 1, 22
"c:\Users\chris\source\repos\Cell\Cell\obj\Debug\net8.0-windows\Cell_idwgul2l_wpftmp.GlobalUsings.g.cs", "C#", 5, 0, 0, 0, 0, 1, 1, 7
"c:\Users\chris\source\repos\Cell\Cell\obj\Debug\net8.0-windows\Cell_idwgul2l_wpftmp.sourcelink.json", "JSON", 0, 0, 0, 1, 0, 0, 0, 1
"c:\Users\chris\source\repos\Cell\Cell\obj\Debug\net8.0-windows\Cell_ie4wq2ne_wpftmp.AssemblyInfo.cs", "C#", 11, 0, 0, 0, 0, 10, 5, 26
"c:\Users\chris\source\repos\Cell\Cell\obj\Debug\net8.0-windows\Cell_ie4wq2ne_wpftmp.GeneratedMSBuildEditorConfig.editorconfig", "Properties", 0, 0, 0, 0, 21, 0, 1, 22
"c:\Users\chris\source\repos\Cell\Cell\obj\Debug\net8.0-windows\Cell_ie4wq2ne_wpftmp.GlobalUsings.g.cs", "C#", 5, 0, 0, 0, 0, 1, 1, 7
"c:\Users\chris\source\repos\Cell\Cell\obj\Debug\net8.0-windows\Cell_ie4wq2ne_wpftmp.sourcelink.json", "JSON", 0, 0, 0, 1, 0, 0, 0, 1
"c:\Users\chris\source\repos\Cell\Cell\obj\Debug\net8.0-windows\Cell_ied0cln1_wpftmp.AssemblyInfo.cs", "C#", 11, 0, 0, 0, 0, 10, 5, 26
"c:\Users\chris\source\repos\Cell\Cell\obj\Debug\net8.0-windows\Cell_ied0cln1_wpftmp.GeneratedMSBuildEditorConfig.editorconfig", "Properties", 0, 0, 0, 0, 13, 0, 1, 14
"c:\Users\chris\source\repos\Cell\Cell\obj\Debug\net8.0-windows\Cell_ied0cln1_wpftmp.GlobalUsings.g.cs", "C#", 5, 0, 0, 0, 0, 1, 1, 7
"c:\Users\chris\source\repos\Cell\Cell\obj\Debug\net8.0-windows\Cell_iehboesx_wpftmp.AssemblyInfo.cs", "C#", 11, 0, 0, 0, 0, 10, 5, 26
"c:\Users\chris\source\repos\Cell\Cell\obj\Debug\net8.0-windows\Cell_iehboesx_wpftmp.GeneratedMSBuildEditorConfig.editorconfig", "Properties", 0, 0, 0, 0, 21, 0, 1, 22
"c:\Users\chris\source\repos\Cell\Cell\obj\Debug\net8.0-windows\Cell_iehboesx_wpftmp.GlobalUsings.g.cs", "C#", 5, 0, 0, 0, 0, 1, 1, 7
"c:\Users\chris\source\repos\Cell\Cell\obj\Debug\net8.0-windows\Cell_iehboesx_wpftmp.sourcelink.json", "JSON", 0, 0, 0, 1, 0, 0, 0, 1
"c:\Users\chris\source\repos\Cell\Cell\obj\Debug\net8.0-windows\Cell_ieiger4u_wpftmp.AssemblyInfo.cs", "C#", 11, 0, 0, 0, 0, 10, 5, 26
"c:\Users\chris\source\repos\Cell\Cell\obj\Debug\net8.0-windows\Cell_ieiger4u_wpftmp.GeneratedMSBuildEditorConfig.editorconfig", "Properties", 0, 0, 0, 0, 13, 0, 1, 14
"c:\Users\chris\source\repos\Cell\Cell\obj\Debug\net8.0-windows\Cell_ieiger4u_wpftmp.GlobalUsings.g.cs", "C#", 5, 0, 0, 0, 0, 1, 1, 7
"c:\Users\chris\source\repos\Cell\Cell\obj\Debug\net8.0-windows\Cell_ietqytcp_wpftmp.AssemblyInfo.cs", "C#", 11, 0, 0, 0, 0, 10, 5, 26
"c:\Users\chris\source\repos\Cell\Cell\obj\Debug\net8.0-windows\Cell_ietqytcp_wpftmp.GeneratedMSBuildEditorConfig.editorconfig", "Properties", 0, 0, 0, 0, 21, 0, 1, 22
"c:\Users\chris\source\repos\Cell\Cell\obj\Debug\net8.0-windows\Cell_ietqytcp_wpftmp.GlobalUsings.g.cs", "C#", 5, 0, 0, 0, 0, 1, 1, 7
"c:\Users\chris\source\repos\Cell\Cell\obj\Debug\net8.0-windows\Cell_ietqytcp_wpftmp.sourcelink.json", "JSON", 0, 0, 0, 1, 0, 0, 0, 1
"c:\Users\chris\source\repos\Cell\Cell\obj\Debug\net8.0-windows\Cell_iff5mbtm_wpftmp.AssemblyInfo.cs", "C#", 11, 0, 0, 0, 0, 10, 5, 26
"c:\Users\chris\source\repos\Cell\Cell\obj\Debug\net8.0-windows\Cell_iff5mbtm_wpftmp.GeneratedMSBuildEditorConfig.editorconfig", "Properties", 0, 0, 0, 0, 21, 0, 1, 22
"c:\Users\chris\source\repos\Cell\Cell\obj\Debug\net8.0-windows\Cell_iff5mbtm_wpftmp.GlobalUsings.g.cs", "C#", 5, 0, 0, 0, 0, 1, 1, 7
"c:\Users\chris\source\repos\Cell\Cell\obj\Debug\net8.0-windows\Cell_iff5mbtm_wpftmp.sourcelink.json", "JSON", 0, 0, 0, 1, 0, 0, 0, 1
"c:\Users\chris\source\repos\Cell\Cell\obj\Debug\net8.0-windows\Cell_ifjqfym5_wpftmp.AssemblyInfo.cs", "C#", 11, 0, 0, 0, 0, 10, 5, 26
"c:\Users\chris\source\repos\Cell\Cell\obj\Debug\net8.0-windows\Cell_ifjqfym5_wpftmp.GeneratedMSBuildEditorConfig.editorconfig", "Properties", 0, 0, 0, 0, 21, 0, 1, 22
"c:\Users\chris\source\repos\Cell\Cell\obj\Debug\net8.0-windows\Cell_ifjqfym5_wpftmp.GlobalUsings.g.cs", "C#", 5, 0, 0, 0, 0, 1, 1, 7
"c:\Users\chris\source\repos\Cell\Cell\obj\Debug\net8.0-windows\Cell_ifjqfym5_wpftmp.sourcelink.json", "JSON", 0, 0, 0, 1, 0, 0, 0, 1
"c:\Users\chris\source\repos\Cell\Cell\obj\Debug\net8.0-windows\Cell_iiapp05v_wpftmp.AssemblyInfo.cs", "C#", 11, 0, 0, 0, 0, 10, 5, 26
"c:\Users\chris\source\repos\Cell\Cell\obj\Debug\net8.0-windows\Cell_iiapp05v_wpftmp.GeneratedMSBuildEditorConfig.editorconfig", "Properties", 0, 0, 0, 0, 21, 0, 1, 22
"c:\Users\chris\source\repos\Cell\Cell\obj\Debug\net8.0-windows\Cell_iiapp05v_wpftmp.GlobalUsings.g.cs", "C#", 5, 0, 0, 0, 0, 1, 1, 7
"c:\Users\chris\source\repos\Cell\Cell\obj\Debug\net8.0-windows\Cell_iiapp05v_wpftmp.sourcelink.json", "JSON", 0, 0, 0, 1, 0, 0, 0, 1
"c:\Users\chris\source\repos\Cell\Cell\obj\Debug\net8.0-windows\Cell_ilj1j4u2_wpftmp.AssemblyInfo.cs", "C#", 11, 0, 0, 0, 0, 10, 5, 26
"c:\Users\chris\source\repos\Cell\Cell\obj\Debug\net8.0-windows\Cell_ilj1j4u2_wpftmp.GeneratedMSBuildEditorConfig.editorconfig", "Properties", 0, 0, 0, 0, 21, 0, 1, 22
"c:\Users\chris\source\repos\Cell\Cell\obj\Debug\net8.0-windows\Cell_ilj1j4u2_wpftmp.GlobalUsings.g.cs", "C#", 5, 0, 0, 0, 0, 1, 1, 7
"c:\Users\chris\source\repos\Cell\Cell\obj\Debug\net8.0-windows\Cell_ilj1j4u2_wpftmp.sourcelink.json", "JSON", 0, 0, 0, 1, 0, 0, 0, 1
"c:\Users\chris\source\repos\Cell\Cell\obj\Debug\net8.0-windows\Cell_ilkbiear_wpftmp.AssemblyInfo.cs", "C#", 11, 0, 0, 0, 0, 10, 5, 26
"c:\Users\chris\source\repos\Cell\Cell\obj\Debug\net8.0-windows\Cell_ilkbiear_wpftmp.GeneratedMSBuildEditorConfig.editorconfig", "Properties", 0, 0, 0, 0, 21, 0, 1, 22
"c:\Users\chris\source\repos\Cell\Cell\obj\Debug\net8.0-windows\Cell_ilkbiear_wpftmp.GlobalUsings.g.cs", "C#", 5, 0, 0, 0, 0, 1, 1, 7
"c:\Users\chris\source\repos\Cell\Cell\obj\Debug\net8.0-windows\Cell_ilkbiear_wpftmp.sourcelink.json", "JSON", 0, 0, 0, 1, 0, 0, 0, 1
"c:\Users\chris\source\repos\Cell\Cell\obj\Debug\net8.0-windows\Cell_immf44pt_wpftmp.AssemblyInfo.cs", "C#", 11, 0, 0, 0, 0, 10, 5, 26
"c:\Users\chris\source\repos\Cell\Cell\obj\Debug\net8.0-windows\Cell_immf44pt_wpftmp.GeneratedMSBuildEditorConfig.editorconfig", "Properties", 0, 0, 0, 0, 21, 0, 1, 22
"c:\Users\chris\source\repos\Cell\Cell\obj\Debug\net8.0-windows\Cell_immf44pt_wpftmp.GlobalUsings.g.cs", "C#", 5, 0, 0, 0, 0, 1, 1, 7
"c:\Users\chris\source\repos\Cell\Cell\obj\Debug\net8.0-windows\Cell_immf44pt_wpftmp.sourcelink.json", "JSON", 0, 0, 0, 1, 0, 0, 0, 1
"c:\Users\chris\source\repos\Cell\Cell\obj\Debug\net8.0-windows\Cell_imsnubta_wpftmp.AssemblyInfo.cs", "C#", 11, 0, 0, 0, 0, 10, 5, 26
"c:\Users\chris\source\repos\Cell\Cell\obj\Debug\net8.0-windows\Cell_imsnubta_wpftmp.GeneratedMSBuildEditorConfig.editorconfig", "Properties", 0, 0, 0, 0, 21, 0, 1, 22
"c:\Users\chris\source\repos\Cell\Cell\obj\Debug\net8.0-windows\Cell_imsnubta_wpftmp.GlobalUsings.g.cs", "C#", 5, 0, 0, 0, 0, 1, 1, 7
"c:\Users\chris\source\repos\Cell\Cell\obj\Debug\net8.0-windows\Cell_imsnubta_wpftmp.sourcelink.json", "JSON", 0, 0, 0, 1, 0, 0, 0, 1
"c:\Users\chris\source\repos\Cell\Cell\obj\Debug\net8.0-windows\Cell_indyv35z_wpftmp.AssemblyInfo.cs", "C#", 11, 0, 0, 0, 0, 10, 5, 26
"c:\Users\chris\source\repos\Cell\Cell\obj\Debug\net8.0-windows\Cell_indyv35z_wpftmp.GeneratedMSBuildEditorConfig.editorconfig", "Properties", 0, 0, 0, 0, 13, 0, 1, 14
"c:\Users\chris\source\repos\Cell\Cell\obj\Debug\net8.0-windows\Cell_indyv35z_wpftmp.GlobalUsings.g.cs", "C#", 5, 0, 0, 0, 0, 1, 1, 7
"c:\Users\chris\source\repos\Cell\Cell\obj\Debug\net8.0-windows\Cell_ioewq04q_wpftmp.AssemblyInfo.cs", "C#", 11, 0, 0, 0, 0, 10, 5, 26
"c:\Users\chris\source\repos\Cell\Cell\obj\Debug\net8.0-windows\Cell_ioewq04q_wpftmp.GeneratedMSBuildEditorConfig.editorconfig", "Properties", 0, 0, 0, 0, 21, 0, 1, 22
"c:\Users\chris\source\repos\Cell\Cell\obj\Debug\net8.0-windows\Cell_ioewq04q_wpftmp.GlobalUsings.g.cs", "C#", 5, 0, 0, 0, 0, 1, 1, 7
"c:\Users\chris\source\repos\Cell\Cell\obj\Debug\net8.0-windows\Cell_ioewq04q_wpftmp.sourcelink.json", "JSON", 0, 0, 0, 1, 0, 0, 0, 1
"c:\Users\chris\source\repos\Cell\Cell\obj\Debug\net8.0-windows\Cell_iokdzjz4_wpftmp.AssemblyInfo.cs", "C#", 11, 0, 0, 0, 0, 10, 5, 26
"c:\Users\chris\source\repos\Cell\Cell\obj\Debug\net8.0-windows\Cell_iokdzjz4_wpftmp.GeneratedMSBuildEditorConfig.editorconfig", "Properties", 0, 0, 0, 0, 21, 0, 1, 22
"c:\Users\chris\source\repos\Cell\Cell\obj\Debug\net8.0-windows\Cell_iokdzjz4_wpftmp.GlobalUsings.g.cs", "C#", 5, 0, 0, 0, 0, 1, 1, 7
"c:\Users\chris\source\repos\Cell\Cell\obj\Debug\net8.0-windows\Cell_iokdzjz4_wpftmp.sourcelink.json", "JSON", 0, 0, 0, 1, 0, 0, 0, 1
"c:\Users\chris\source\repos\Cell\Cell\obj\Debug\net8.0-windows\Cell_ioli2uh3_wpftmp.AssemblyInfo.cs", "C#", 11, 0, 0, 0, 0, 10, 5, 26
"c:\Users\chris\source\repos\Cell\Cell\obj\Debug\net8.0-windows\Cell_ioli2uh3_wpftmp.GeneratedMSBuildEditorConfig.editorconfig", "Properties", 0, 0, 0, 0, 13, 0, 1, 14
"c:\Users\chris\source\repos\Cell\Cell\obj\Debug\net8.0-windows\Cell_ioli2uh3_wpftmp.GlobalUsings.g.cs", "C#", 5, 0, 0, 0, 0, 1, 1, 7
"c:\Users\chris\source\repos\Cell\Cell\obj\Debug\net8.0-windows\Cell_ir4nfgnd_wpftmp.AssemblyInfo.cs", "C#", 11, 0, 0, 0, 0, 10, 5, 26
"c:\Users\chris\source\repos\Cell\Cell\obj\Debug\net8.0-windows\Cell_ir4nfgnd_wpftmp.GeneratedMSBuildEditorConfig.editorconfig", "Properties", 0, 0, 0, 0, 21, 0, 1, 22
"c:\Users\chris\source\repos\Cell\Cell\obj\Debug\net8.0-windows\Cell_ir4nfgnd_wpftmp.GlobalUsings.g.cs", "C#", 5, 0, 0, 0, 0, 1, 1, 7
"c:\Users\chris\source\repos\Cell\Cell\obj\Debug\net8.0-windows\Cell_ir4nfgnd_wpftmp.sourcelink.json", "JSON", 0, 0, 0, 1, 0, 0, 0, 1
"c:\Users\chris\source\repos\Cell\Cell\obj\Debug\net8.0-windows\Cell_irpzcdxo_wpftmp.AssemblyInfo.cs", "C#", 11, 0, 0, 0, 0, 10, 5, 26
"c:\Users\chris\source\repos\Cell\Cell\obj\Debug\net8.0-windows\Cell_irpzcdxo_wpftmp.GeneratedMSBuildEditorConfig.editorconfig", "Properties", 0, 0, 0, 0, 21, 0, 1, 22
"c:\Users\chris\source\repos\Cell\Cell\obj\Debug\net8.0-windows\Cell_irpzcdxo_wpftmp.GlobalUsings.g.cs", "C#", 5, 0, 0, 0, 0, 1, 1, 7
"c:\Users\chris\source\repos\Cell\Cell\obj\Debug\net8.0-windows\Cell_irpzcdxo_wpftmp.sourcelink.json", "JSON", 0, 0, 0, 1, 0, 0, 0, 1
"c:\Users\chris\source\repos\Cell\Cell\obj\Debug\net8.0-windows\Cell_itqseqp4_wpftmp.AssemblyInfo.cs", "C#", 11, 0, 0, 0, 0, 10, 5, 26
"c:\Users\chris\source\repos\Cell\Cell\obj\Debug\net8.0-windows\Cell_itqseqp4_wpftmp.GeneratedMSBuildEditorConfig.editorconfig", "Properties", 0, 0, 0, 0, 13, 0, 1, 14
"c:\Users\chris\source\repos\Cell\Cell\obj\Debug\net8.0-windows\Cell_itqseqp4_wpftmp.GlobalUsings.g.cs", "C#", 5, 0, 0, 0, 0, 1, 1, 7
"c:\Users\chris\source\repos\Cell\Cell\obj\Debug\net8.0-windows\Cell_itrtwwmk_wpftmp.AssemblyInfo.cs", "C#", 11, 0, 0, 0, 0, 10, 5, 26
"c:\Users\chris\source\repos\Cell\Cell\obj\Debug\net8.0-windows\Cell_itrtwwmk_wpftmp.GeneratedMSBuildEditorConfig.editorconfig", "Properties", 0, 0, 0, 0, 21, 0, 1, 22
"c:\Users\chris\source\repos\Cell\Cell\obj\Debug\net8.0-windows\Cell_itrtwwmk_wpftmp.GlobalUsings.g.cs", "C#", 5, 0, 0, 0, 0, 1, 1, 7
"c:\Users\chris\source\repos\Cell\Cell\obj\Debug\net8.0-windows\Cell_itrtwwmk_wpftmp.sourcelink.json", "JSON", 0, 0, 0, 1, 0, 0, 0, 1
"c:\Users\chris\source\repos\Cell\Cell\obj\Debug\net8.0-windows\Cell_iujgpz42_wpftmp.AssemblyInfo.cs", "C#", 11, 0, 0, 0, 0, 10, 5, 26
"c:\Users\chris\source\repos\Cell\Cell\obj\Debug\net8.0-windows\Cell_iujgpz42_wpftmp.GeneratedMSBuildEditorConfig.editorconfig", "Properties", 0, 0, 0, 0, 21, 0, 1, 22
"c:\Users\chris\source\repos\Cell\Cell\obj\Debug\net8.0-windows\Cell_iujgpz42_wpftmp.GlobalUsings.g.cs", "C#", 5, 0, 0, 0, 0, 1, 1, 7
"c:\Users\chris\source\repos\Cell\Cell\obj\Debug\net8.0-windows\Cell_iujgpz42_wpftmp.sourcelink.json", "JSON", 0, 0, 0, 1, 0, 0, 0, 1
"c:\Users\chris\source\repos\Cell\Cell\obj\Debug\net8.0-windows\Cell_iuwphjyv_wpftmp.AssemblyInfo.cs", "C#", 11, 0, 0, 0, 0, 10, 5, 26
"c:\Users\chris\source\repos\Cell\Cell\obj\Debug\net8.0-windows\Cell_iuwphjyv_wpftmp.GeneratedMSBuildEditorConfig.editorconfig", "Properties", 0, 0, 0, 0, 21, 0, 1, 22
"c:\Users\chris\source\repos\Cell\Cell\obj\Debug\net8.0-windows\Cell_iuwphjyv_wpftmp.GlobalUsings.g.cs", "C#", 5, 0, 0, 0, 0, 1, 1, 7
"c:\Users\chris\source\repos\Cell\Cell\obj\Debug\net8.0-windows\Cell_iuwphjyv_wpftmp.sourcelink.json", "JSON", 0, 0, 0, 1, 0, 0, 0, 1
"c:\Users\chris\source\repos\Cell\Cell\obj\Debug\net8.0-windows\Cell_ivszufov_wpftmp.AssemblyInfo.cs", "C#", 11, 0, 0, 0, 0, 10, 5, 26
"c:\Users\chris\source\repos\Cell\Cell\obj\Debug\net8.0-windows\Cell_ivszufov_wpftmp.GeneratedMSBuildEditorConfig.editorconfig", "Properties", 0, 0, 0, 0, 21, 0, 1, 22
"c:\Users\chris\source\repos\Cell\Cell\obj\Debug\net8.0-windows\Cell_ivszufov_wpftmp.GlobalUsings.g.cs", "C#", 5, 0, 0, 0, 0, 1, 1, 7
"c:\Users\chris\source\repos\Cell\Cell\obj\Debug\net8.0-windows\Cell_ivszufov_wpftmp.sourcelink.json", "JSON", 0, 0, 0, 1, 0, 0, 0, 1
"c:\Users\chris\source\repos\Cell\Cell\obj\Debug\net8.0-windows\Cell_iwjcjlyg_wpftmp.AssemblyInfo.cs", "C#", 11, 0, 0, 0, 0, 10, 5, 26
"c:\Users\chris\source\repos\Cell\Cell\obj\Debug\net8.0-windows\Cell_iwjcjlyg_wpftmp.GeneratedMSBuildEditorConfig.editorconfig", "Properties", 0, 0, 0, 0, 13, 0, 1, 14
"c:\Users\chris\source\repos\Cell\Cell\obj\Debug\net8.0-windows\Cell_iwjcjlyg_wpftmp.GlobalUsings.g.cs", "C#", 5, 0, 0, 0, 0, 1, 1, 7
"c:\Users\chris\source\repos\Cell\Cell\obj\Debug\net8.0-windows\Cell_iwjiyqeq_wpftmp.AssemblyInfo.cs", "C#", 11, 0, 0, 0, 0, 10, 5, 26
"c:\Users\chris\source\repos\Cell\Cell\obj\Debug\net8.0-windows\Cell_iwjiyqeq_wpftmp.GeneratedMSBuildEditorConfig.editorconfig", "Properties", 0, 0, 0, 0, 21, 0, 1, 22
"c:\Users\chris\source\repos\Cell\Cell\obj\Debug\net8.0-windows\Cell_iwjiyqeq_wpftmp.GlobalUsings.g.cs", "C#", 5, 0, 0, 0, 0, 1, 1, 7
"c:\Users\chris\source\repos\Cell\Cell\obj\Debug\net8.0-windows\Cell_iwjiyqeq_wpftmp.sourcelink.json", "JSON", 0, 0, 0, 1, 0, 0, 0, 1
"c:\Users\chris\source\repos\Cell\Cell\obj\Debug\net8.0-windows\Cell_ixhell3t_wpftmp.AssemblyInfo.cs", "C#", 11, 0, 0, 0, 0, 10, 5, 26
"c:\Users\chris\source\repos\Cell\Cell\obj\Debug\net8.0-windows\Cell_ixhell3t_wpftmp.GeneratedMSBuildEditorConfig.editorconfig", "Properties", 0, 0, 0, 0, 21, 0, 1, 22
"c:\Users\chris\source\repos\Cell\Cell\obj\Debug\net8.0-windows\Cell_ixhell3t_wpftmp.GlobalUsings.g.cs", "C#", 5, 0, 0, 0, 0, 1, 1, 7
"c:\Users\chris\source\repos\Cell\Cell\obj\Debug\net8.0-windows\Cell_ixhell3t_wpftmp.sourcelink.json", "JSON", 0, 0, 0, 1, 0, 0, 0, 1
"c:\Users\chris\source\repos\Cell\Cell\obj\Debug\net8.0-windows\Cell_ixhrtq3r_wpftmp.AssemblyInfo.cs", "C#", 11, 0, 0, 0, 0, 10, 5, 26
"c:\Users\chris\source\repos\Cell\Cell\obj\Debug\net8.0-windows\Cell_ixhrtq3r_wpftmp.GeneratedMSBuildEditorConfig.editorconfig", "Properties", 0, 0, 0, 0, 21, 0, 1, 22
"c:\Users\chris\source\repos\Cell\Cell\obj\Debug\net8.0-windows\Cell_ixhrtq3r_wpftmp.GlobalUsings.g.cs", "C#", 5, 0, 0, 0, 0, 1, 1, 7
"c:\Users\chris\source\repos\Cell\Cell\obj\Debug\net8.0-windows\Cell_ixhrtq3r_wpftmp.sourcelink.json", "JSON", 0, 0, 0, 1, 0, 0, 0, 1
"c:\Users\chris\source\repos\Cell\Cell\obj\Debug\net8.0-windows\Cell_iykms1j0_wpftmp.AssemblyInfo.cs", "C#", 11, 0, 0, 0, 0, 10, 5, 26
"c:\Users\chris\source\repos\Cell\Cell\obj\Debug\net8.0-windows\Cell_iykms1j0_wpftmp.GeneratedMSBuildEditorConfig.editorconfig", "Properties", 0, 0, 0, 0, 21, 0, 1, 22
"c:\Users\chris\source\repos\Cell\Cell\obj\Debug\net8.0-windows\Cell_iykms1j0_wpftmp.GlobalUsings.g.cs", "C#", 5, 0, 0, 0, 0, 1, 1, 7
"c:\Users\chris\source\repos\Cell\Cell\obj\Debug\net8.0-windows\Cell_iykms1j0_wpftmp.sourcelink.json", "JSON", 0, 0, 0, 1, 0, 0, 0, 1
"c:\Users\chris\source\repos\Cell\Cell\obj\Debug\net8.0-windows\Cell_iz1luehz_wpftmp.AssemblyInfo.cs", "C#", 11, 0, 0, 0, 0, 10, 5, 26
"c:\Users\chris\source\repos\Cell\Cell\obj\Debug\net8.0-windows\Cell_iz1luehz_wpftmp.GeneratedMSBuildEditorConfig.editorconfig", "Properties", 0, 0, 0, 0, 13, 0, 1, 14
"c:\Users\chris\source\repos\Cell\Cell\obj\Debug\net8.0-windows\Cell_iz1luehz_wpftmp.GlobalUsings.g.cs", "C#", 5, 0, 0, 0, 0, 1, 1, 7
"c:\Users\chris\source\repos\Cell\Cell\obj\Debug\net8.0-windows\Cell_iza1dkfj_wpftmp.AssemblyInfo.cs", "C#", 11, 0, 0, 0, 0, 10, 5, 26
"c:\Users\chris\source\repos\Cell\Cell\obj\Debug\net8.0-windows\Cell_iza1dkfj_wpftmp.GeneratedMSBuildEditorConfig.editorconfig", "Properties", 0, 0, 0, 0, 21, 0, 1, 22
"c:\Users\chris\source\repos\Cell\Cell\obj\Debug\net8.0-windows\Cell_iza1dkfj_wpftmp.GlobalUsings.g.cs", "C#", 5, 0, 0, 0, 0, 1, 1, 7
"c:\Users\chris\source\repos\Cell\Cell\obj\Debug\net8.0-windows\Cell_iza1dkfj_wpftmp.sourcelink.json", "JSON", 0, 0, 0, 1, 0, 0, 0, 1
"c:\Users\chris\source\repos\Cell\Cell\obj\Debug\net8.0-windows\Cell_izjbwejp_wpftmp.AssemblyInfo.cs", "C#", 11, 0, 0, 0, 0, 10, 5, 26
"c:\Users\chris\source\repos\Cell\Cell\obj\Debug\net8.0-windows\Cell_izjbwejp_wpftmp.GeneratedMSBuildEditorConfig.editorconfig", "Properties", 0, 0, 0, 0, 21, 0, 1, 22
"c:\Users\chris\source\repos\Cell\Cell\obj\Debug\net8.0-windows\Cell_izjbwejp_wpftmp.GlobalUsings.g.cs", "C#", 5, 0, 0, 0, 0, 1, 1, 7
"c:\Users\chris\source\repos\Cell\Cell\obj\Debug\net8.0-windows\Cell_izjbwejp_wpftmp.sourcelink.json", "JSON", 0, 0, 0, 1, 0, 0, 0, 1
"c:\Users\chris\source\repos\Cell\Cell\obj\Debug\net8.0-windows\Cell_j0xxksig_wpftmp.AssemblyInfo.cs", "C#", 11, 0, 0, 0, 0, 10, 5, 26
"c:\Users\chris\source\repos\Cell\Cell\obj\Debug\net8.0-windows\Cell_j0xxksig_wpftmp.GeneratedMSBuildEditorConfig.editorconfig", "Properties", 0, 0, 0, 0, 13, 0, 1, 14
"c:\Users\chris\source\repos\Cell\Cell\obj\Debug\net8.0-windows\Cell_j0xxksig_wpftmp.GlobalUsings.g.cs", "C#", 5, 0, 0, 0, 0, 1, 1, 7
"c:\Users\chris\source\repos\Cell\Cell\obj\Debug\net8.0-windows\Cell_j1avtqfu_wpftmp.AssemblyInfo.cs", "C#", 11, 0, 0, 0, 0, 10, 5, 26
"c:\Users\chris\source\repos\Cell\Cell\obj\Debug\net8.0-windows\Cell_j1avtqfu_wpftmp.GeneratedMSBuildEditorConfig.editorconfig", "Properties", 0, 0, 0, 0, 21, 0, 1, 22
"c:\Users\chris\source\repos\Cell\Cell\obj\Debug\net8.0-windows\Cell_j1avtqfu_wpftmp.GlobalUsings.g.cs", "C#", 5, 0, 0, 0, 0, 1, 1, 7
"c:\Users\chris\source\repos\Cell\Cell\obj\Debug\net8.0-windows\Cell_j1avtqfu_wpftmp.sourcelink.json", "JSON", 0, 0, 0, 1, 0, 0, 0, 1
"c:\Users\chris\source\repos\Cell\Cell\obj\Debug\net8.0-windows\Cell_j1td4f31_wpftmp.AssemblyInfo.cs", "C#", 11, 0, 0, 0, 0, 10, 5, 26
"c:\Users\chris\source\repos\Cell\Cell\obj\Debug\net8.0-windows\Cell_j1td4f31_wpftmp.GeneratedMSBuildEditorConfig.editorconfig", "Properties", 0, 0, 0, 0, 21, 0, 1, 22
"c:\Users\chris\source\repos\Cell\Cell\obj\Debug\net8.0-windows\Cell_j1td4f31_wpftmp.GlobalUsings.g.cs", "C#", 5, 0, 0, 0, 0, 1, 1, 7
"c:\Users\chris\source\repos\Cell\Cell\obj\Debug\net8.0-windows\Cell_j1td4f31_wpftmp.sourcelink.json", "JSON", 0, 0, 0, 1, 0, 0, 0, 1
"c:\Users\chris\source\repos\Cell\Cell\obj\Debug\net8.0-windows\Cell_j232v0sw_wpftmp.AssemblyInfo.cs", "C#", 11, 0, 0, 0, 0, 10, 5, 26
"c:\Users\chris\source\repos\Cell\Cell\obj\Debug\net8.0-windows\Cell_j232v0sw_wpftmp.GeneratedMSBuildEditorConfig.editorconfig", "Properties", 0, 0, 0, 0, 21, 0, 1, 22
"c:\Users\chris\source\repos\Cell\Cell\obj\Debug\net8.0-windows\Cell_j232v0sw_wpftmp.GlobalUsings.g.cs", "C#", 5, 0, 0, 0, 0, 1, 1, 7
"c:\Users\chris\source\repos\Cell\Cell\obj\Debug\net8.0-windows\Cell_j232v0sw_wpftmp.sourcelink.json", "JSON", 0, 0, 0, 1, 0, 0, 0, 1
"c:\Users\chris\source\repos\Cell\Cell\obj\Debug\net8.0-windows\Cell_j3gbpkf5_wpftmp.AssemblyInfo.cs", "C#", 11, 0, 0, 0, 0, 10, 5, 26
"c:\Users\chris\source\repos\Cell\Cell\obj\Debug\net8.0-windows\Cell_j3gbpkf5_wpftmp.GeneratedMSBuildEditorConfig.editorconfig", "Properties", 0, 0, 0, 0, 21, 0, 1, 22
"c:\Users\chris\source\repos\Cell\Cell\obj\Debug\net8.0-windows\Cell_j3gbpkf5_wpftmp.GlobalUsings.g.cs", "C#", 5, 0, 0, 0, 0, 1, 1, 7
"c:\Users\chris\source\repos\Cell\Cell\obj\Debug\net8.0-windows\Cell_j3gbpkf5_wpftmp.sourcelink.json", "JSON", 0, 0, 0, 1, 0, 0, 0, 1
"c:\Users\chris\source\repos\Cell\Cell\obj\Debug\net8.0-windows\Cell_j3mv55wt_wpftmp.AssemblyInfo.cs", "C#", 11, 0, 0, 0, 0, 10, 5, 26
"c:\Users\chris\source\repos\Cell\Cell\obj\Debug\net8.0-windows\Cell_j3mv55wt_wpftmp.GeneratedMSBuildEditorConfig.editorconfig", "Properties", 0, 0, 0, 0, 21, 0, 1, 22
"c:\Users\chris\source\repos\Cell\Cell\obj\Debug\net8.0-windows\Cell_j3mv55wt_wpftmp.GlobalUsings.g.cs", "C#", 5, 0, 0, 0, 0, 1, 1, 7
"c:\Users\chris\source\repos\Cell\Cell\obj\Debug\net8.0-windows\Cell_j3mv55wt_wpftmp.sourcelink.json", "JSON", 0, 0, 0, 1, 0, 0, 0, 1
"c:\Users\chris\source\repos\Cell\Cell\obj\Debug\net8.0-windows\Cell_j42oxjlj_wpftmp.AssemblyInfo.cs", "C#", 11, 0, 0, 0, 0, 10, 5, 26
"c:\Users\chris\source\repos\Cell\Cell\obj\Debug\net8.0-windows\Cell_j42oxjlj_wpftmp.GeneratedMSBuildEditorConfig.editorconfig", "Properties", 0, 0, 0, 0, 21, 0, 1, 22
"c:\Users\chris\source\repos\Cell\Cell\obj\Debug\net8.0-windows\Cell_j42oxjlj_wpftmp.GlobalUsings.g.cs", "C#", 5, 0, 0, 0, 0, 1, 1, 7
"c:\Users\chris\source\repos\Cell\Cell\obj\Debug\net8.0-windows\Cell_j42oxjlj_wpftmp.sourcelink.json", "JSON", 0, 0, 0, 1, 0, 0, 0, 1
"c:\Users\chris\source\repos\Cell\Cell\obj\Debug\net8.0-windows\Cell_j4bsbaij_wpftmp.AssemblyInfo.cs", "C#", 11, 0, 0, 0, 0, 10, 5, 26
"c:\Users\chris\source\repos\Cell\Cell\obj\Debug\net8.0-windows\Cell_j4bsbaij_wpftmp.GeneratedMSBuildEditorConfig.editorconfig", "Properties", 0, 0, 0, 0, 21, 0, 1, 22
"c:\Users\chris\source\repos\Cell\Cell\obj\Debug\net8.0-windows\Cell_j4bsbaij_wpftmp.GlobalUsings.g.cs", "C#", 5, 0, 0, 0, 0, 1, 1, 7
"c:\Users\chris\source\repos\Cell\Cell\obj\Debug\net8.0-windows\Cell_j4bsbaij_wpftmp.sourcelink.json", "JSON", 0, 0, 0, 1, 0, 0, 0, 1
"c:\Users\chris\source\repos\Cell\Cell\obj\Debug\net8.0-windows\Cell_j4gxonjf_wpftmp.AssemblyInfo.cs", "C#", 11, 0, 0, 0, 0, 10, 5, 26
"c:\Users\chris\source\repos\Cell\Cell\obj\Debug\net8.0-windows\Cell_j4gxonjf_wpftmp.GeneratedMSBuildEditorConfig.editorconfig", "Properties", 0, 0, 0, 0, 21, 0, 1, 22
"c:\Users\chris\source\repos\Cell\Cell\obj\Debug\net8.0-windows\Cell_j4gxonjf_wpftmp.GlobalUsings.g.cs", "C#", 5, 0, 0, 0, 0, 1, 1, 7
"c:\Users\chris\source\repos\Cell\Cell\obj\Debug\net8.0-windows\Cell_j4gxonjf_wpftmp.sourcelink.json", "JSON", 0, 0, 0, 1, 0, 0, 0, 1
"c:\Users\chris\source\repos\Cell\Cell\obj\Debug\net8.0-windows\Cell_j4p2grmj_wpftmp.AssemblyInfo.cs", "C#", 11, 0, 0, 0, 0, 10, 5, 26
"c:\Users\chris\source\repos\Cell\Cell\obj\Debug\net8.0-windows\Cell_j4p2grmj_wpftmp.GeneratedMSBuildEditorConfig.editorconfig", "Properties", 0, 0, 0, 0, 21, 0, 1, 22
"c:\Users\chris\source\repos\Cell\Cell\obj\Debug\net8.0-windows\Cell_j4p2grmj_wpftmp.GlobalUsings.g.cs", "C#", 5, 0, 0, 0, 0, 1, 1, 7
"c:\Users\chris\source\repos\Cell\Cell\obj\Debug\net8.0-windows\Cell_j4p2grmj_wpftmp.sourcelink.json", "JSON", 0, 0, 0, 1, 0, 0, 0, 1
"c:\Users\chris\source\repos\Cell\Cell\obj\Debug\net8.0-windows\Cell_jadrxi1c_wpftmp.AssemblyInfo.cs", "C#", 11, 0, 0, 0, 0, 10, 5, 26
"c:\Users\chris\source\repos\Cell\Cell\obj\Debug\net8.0-windows\Cell_jadrxi1c_wpftmp.GeneratedMSBuildEditorConfig.editorconfig", "Properties", 0, 0, 0, 0, 21, 0, 1, 22
"c:\Users\chris\source\repos\Cell\Cell\obj\Debug\net8.0-windows\Cell_jadrxi1c_wpftmp.GlobalUsings.g.cs", "C#", 5, 0, 0, 0, 0, 1, 1, 7
"c:\Users\chris\source\repos\Cell\Cell\obj\Debug\net8.0-windows\Cell_jadrxi1c_wpftmp.sourcelink.json", "JSON", 0, 0, 0, 1, 0, 0, 0, 1
"c:\Users\chris\source\repos\Cell\Cell\obj\Debug\net8.0-windows\Cell_jam4oc2j_wpftmp.AssemblyInfo.cs", "C#", 11, 0, 0, 0, 0, 10, 5, 26
"c:\Users\chris\source\repos\Cell\Cell\obj\Debug\net8.0-windows\Cell_jam4oc2j_wpftmp.GeneratedMSBuildEditorConfig.editorconfig", "Properties", 0, 0, 0, 0, 21, 0, 1, 22
"c:\Users\chris\source\repos\Cell\Cell\obj\Debug\net8.0-windows\Cell_jam4oc2j_wpftmp.GlobalUsings.g.cs", "C#", 5, 0, 0, 0, 0, 1, 1, 7
"c:\Users\chris\source\repos\Cell\Cell\obj\Debug\net8.0-windows\Cell_jam4oc2j_wpftmp.sourcelink.json", "JSON", 0, 0, 0, 1, 0, 0, 0, 1
"c:\Users\chris\source\repos\Cell\Cell\obj\Debug\net8.0-windows\Cell_jat5esxy_wpftmp.AssemblyInfo.cs", "C#", 11, 0, 0, 0, 0, 10, 5, 26
"c:\Users\chris\source\repos\Cell\Cell\obj\Debug\net8.0-windows\Cell_jat5esxy_wpftmp.GeneratedMSBuildEditorConfig.editorconfig", "Properties", 0, 0, 0, 0, 21, 0, 1, 22
"c:\Users\chris\source\repos\Cell\Cell\obj\Debug\net8.0-windows\Cell_jat5esxy_wpftmp.GlobalUsings.g.cs", "C#", 5, 0, 0, 0, 0, 1, 1, 7
"c:\Users\chris\source\repos\Cell\Cell\obj\Debug\net8.0-windows\Cell_jat5esxy_wpftmp.sourcelink.json", "JSON", 0, 0, 0, 1, 0, 0, 0, 1
"c:\Users\chris\source\repos\Cell\Cell\obj\Debug\net8.0-windows\Cell_jazlwmzl_wpftmp.AssemblyInfo.cs", "C#", 11, 0, 0, 0, 0, 10, 5, 26
"c:\Users\chris\source\repos\Cell\Cell\obj\Debug\net8.0-windows\Cell_jazlwmzl_wpftmp.GeneratedMSBuildEditorConfig.editorconfig", "Properties", 0, 0, 0, 0, 13, 0, 1, 14
"c:\Users\chris\source\repos\Cell\Cell\obj\Debug\net8.0-windows\Cell_jazlwmzl_wpftmp.GlobalUsings.g.cs", "C#", 5, 0, 0, 0, 0, 1, 1, 7
"c:\Users\chris\source\repos\Cell\Cell\obj\Debug\net8.0-windows\Cell_jcpwjg42_wpftmp.AssemblyInfo.cs", "C#", 11, 0, 0, 0, 0, 10, 5, 26
"c:\Users\chris\source\repos\Cell\Cell\obj\Debug\net8.0-windows\Cell_jcpwjg42_wpftmp.GeneratedMSBuildEditorConfig.editorconfig", "Properties", 0, 0, 0, 0, 21, 0, 1, 22
"c:\Users\chris\source\repos\Cell\Cell\obj\Debug\net8.0-windows\Cell_jcpwjg42_wpftmp.GlobalUsings.g.cs", "C#", 5, 0, 0, 0, 0, 1, 1, 7
"c:\Users\chris\source\repos\Cell\Cell\obj\Debug\net8.0-windows\Cell_jcpwjg42_wpftmp.sourcelink.json", "JSON", 0, 0, 0, 1, 0, 0, 0, 1
"c:\Users\chris\source\repos\Cell\Cell\obj\Debug\net8.0-windows\Cell_jd1wr0t5_wpftmp.AssemblyInfo.cs", "C#", 11, 0, 0, 0, 0, 10, 5, 26
"c:\Users\chris\source\repos\Cell\Cell\obj\Debug\net8.0-windows\Cell_jd1wr0t5_wpftmp.GeneratedMSBuildEditorConfig.editorconfig", "Properties", 0, 0, 0, 0, 21, 0, 1, 22
"c:\Users\chris\source\repos\Cell\Cell\obj\Debug\net8.0-windows\Cell_jd1wr0t5_wpftmp.GlobalUsings.g.cs", "C#", 5, 0, 0, 0, 0, 1, 1, 7
"c:\Users\chris\source\repos\Cell\Cell\obj\Debug\net8.0-windows\Cell_jd1wr0t5_wpftmp.sourcelink.json", "JSON", 0, 0, 0, 1, 0, 0, 0, 1
"c:\Users\chris\source\repos\Cell\Cell\obj\Debug\net8.0-windows\Cell_jdatfxxb_wpftmp.AssemblyInfo.cs", "C#", 11, 0, 0, 0, 0, 10, 5, 26
"c:\Users\chris\source\repos\Cell\Cell\obj\Debug\net8.0-windows\Cell_jdatfxxb_wpftmp.GeneratedMSBuildEditorConfig.editorconfig", "Properties", 0, 0, 0, 0, 21, 0, 1, 22
"c:\Users\chris\source\repos\Cell\Cell\obj\Debug\net8.0-windows\Cell_jdatfxxb_wpftmp.GlobalUsings.g.cs", "C#", 5, 0, 0, 0, 0, 1, 1, 7
"c:\Users\chris\source\repos\Cell\Cell\obj\Debug\net8.0-windows\Cell_jdatfxxb_wpftmp.sourcelink.json", "JSON", 0, 0, 0, 1, 0, 0, 0, 1
"c:\Users\chris\source\repos\Cell\Cell\obj\Debug\net8.0-windows\Cell_jdijj0dw_wpftmp.AssemblyInfo.cs", "C#", 11, 0, 0, 0, 0, 10, 5, 26
"c:\Users\chris\source\repos\Cell\Cell\obj\Debug\net8.0-windows\Cell_jdijj0dw_wpftmp.GeneratedMSBuildEditorConfig.editorconfig", "Properties", 0, 0, 0, 0, 21, 0, 1, 22
"c:\Users\chris\source\repos\Cell\Cell\obj\Debug\net8.0-windows\Cell_jdijj0dw_wpftmp.GlobalUsings.g.cs", "C#", 5, 0, 0, 0, 0, 1, 1, 7
"c:\Users\chris\source\repos\Cell\Cell\obj\Debug\net8.0-windows\Cell_jdijj0dw_wpftmp.sourcelink.json", "JSON", 0, 0, 0, 1, 0, 0, 0, 1
"c:\Users\chris\source\repos\Cell\Cell\obj\Debug\net8.0-windows\Cell_je0rum4r_wpftmp.AssemblyInfo.cs", "C#", 11, 0, 0, 0, 0, 10, 5, 26
"c:\Users\chris\source\repos\Cell\Cell\obj\Debug\net8.0-windows\Cell_je0rum4r_wpftmp.GeneratedMSBuildEditorConfig.editorconfig", "Properties", 0, 0, 0, 0, 13, 0, 1, 14
"c:\Users\chris\source\repos\Cell\Cell\obj\Debug\net8.0-windows\Cell_je0rum4r_wpftmp.GlobalUsings.g.cs", "C#", 5, 0, 0, 0, 0, 1, 1, 7
"c:\Users\chris\source\repos\Cell\Cell\obj\Debug\net8.0-windows\Cell_je1v4qyl_wpftmp.AssemblyInfo.cs", "C#", 11, 0, 0, 0, 0, 10, 5, 26
"c:\Users\chris\source\repos\Cell\Cell\obj\Debug\net8.0-windows\Cell_je1v4qyl_wpftmp.GeneratedMSBuildEditorConfig.editorconfig", "Properties", 0, 0, 0, 0, 21, 0, 1, 22
"c:\Users\chris\source\repos\Cell\Cell\obj\Debug\net8.0-windows\Cell_je1v4qyl_wpftmp.GlobalUsings.g.cs", "C#", 5, 0, 0, 0, 0, 1, 1, 7
"c:\Users\chris\source\repos\Cell\Cell\obj\Debug\net8.0-windows\Cell_je1v4qyl_wpftmp.sourcelink.json", "JSON", 0, 0, 0, 1, 0, 0, 0, 1
"c:\Users\chris\source\repos\Cell\Cell\obj\Debug\net8.0-windows\Cell_je3on3ls_wpftmp.AssemblyInfo.cs", "C#", 11, 0, 0, 0, 0, 10, 5, 26
"c:\Users\chris\source\repos\Cell\Cell\obj\Debug\net8.0-windows\Cell_je3on3ls_wpftmp.GeneratedMSBuildEditorConfig.editorconfig", "Properties", 0, 0, 0, 0, 21, 0, 1, 22
"c:\Users\chris\source\repos\Cell\Cell\obj\Debug\net8.0-windows\Cell_je3on3ls_wpftmp.GlobalUsings.g.cs", "C#", 5, 0, 0, 0, 0, 1, 1, 7
"c:\Users\chris\source\repos\Cell\Cell\obj\Debug\net8.0-windows\Cell_je3on3ls_wpftmp.sourcelink.json", "JSON", 0, 0, 0, 1, 0, 0, 0, 1
"c:\Users\chris\source\repos\Cell\Cell\obj\Debug\net8.0-windows\Cell_jeunlj5a_wpftmp.AssemblyInfo.cs", "C#", 11, 0, 0, 0, 0, 10, 5, 26
"c:\Users\chris\source\repos\Cell\Cell\obj\Debug\net8.0-windows\Cell_jeunlj5a_wpftmp.GeneratedMSBuildEditorConfig.editorconfig", "Properties", 0, 0, 0, 0, 13, 0, 1, 14
"c:\Users\chris\source\repos\Cell\Cell\obj\Debug\net8.0-windows\Cell_jeunlj5a_wpftmp.GlobalUsings.g.cs", "C#", 5, 0, 0, 0, 0, 1, 1, 7
"c:\Users\chris\source\repos\Cell\Cell\obj\Debug\net8.0-windows\Cell_jew4t3h4_wpftmp.AssemblyInfo.cs", "C#", 11, 0, 0, 0, 0, 10, 5, 26
"c:\Users\chris\source\repos\Cell\Cell\obj\Debug\net8.0-windows\Cell_jew4t3h4_wpftmp.GeneratedMSBuildEditorConfig.editorconfig", "Properties", 0, 0, 0, 0, 21, 0, 1, 22
"c:\Users\chris\source\repos\Cell\Cell\obj\Debug\net8.0-windows\Cell_jew4t3h4_wpftmp.GlobalUsings.g.cs", "C#", 5, 0, 0, 0, 0, 1, 1, 7
"c:\Users\chris\source\repos\Cell\Cell\obj\Debug\net8.0-windows\Cell_jew4t3h4_wpftmp.sourcelink.json", "JSON", 0, 0, 0, 1, 0, 0, 0, 1
"c:\Users\chris\source\repos\Cell\Cell\obj\Debug\net8.0-windows\Cell_jg4fjd1d_wpftmp.AssemblyInfo.cs", "C#", 11, 0, 0, 0, 0, 10, 5, 26
"c:\Users\chris\source\repos\Cell\Cell\obj\Debug\net8.0-windows\Cell_jg4fjd1d_wpftmp.GeneratedMSBuildEditorConfig.editorconfig", "Properties", 0, 0, 0, 0, 21, 0, 1, 22
"c:\Users\chris\source\repos\Cell\Cell\obj\Debug\net8.0-windows\Cell_jg4fjd1d_wpftmp.GlobalUsings.g.cs", "C#", 5, 0, 0, 0, 0, 1, 1, 7
"c:\Users\chris\source\repos\Cell\Cell\obj\Debug\net8.0-windows\Cell_jg4fjd1d_wpftmp.sourcelink.json", "JSON", 0, 0, 0, 1, 0, 0, 0, 1
"c:\Users\chris\source\repos\Cell\Cell\obj\Debug\net8.0-windows\Cell_jgmfhi0l_wpftmp.AssemblyInfo.cs", "C#", 11, 0, 0, 0, 0, 10, 5, 26
"c:\Users\chris\source\repos\Cell\Cell\obj\Debug\net8.0-windows\Cell_jgmfhi0l_wpftmp.GeneratedMSBuildEditorConfig.editorconfig", "Properties", 0, 0, 0, 0, 13, 0, 1, 14
"c:\Users\chris\source\repos\Cell\Cell\obj\Debug\net8.0-windows\Cell_jgmfhi0l_wpftmp.GlobalUsings.g.cs", "C#", 5, 0, 0, 0, 0, 1, 1, 7
"c:\Users\chris\source\repos\Cell\Cell\obj\Debug\net8.0-windows\Cell_jhnmoczc_wpftmp.AssemblyInfo.cs", "C#", 11, 0, 0, 0, 0, 10, 5, 26
"c:\Users\chris\source\repos\Cell\Cell\obj\Debug\net8.0-windows\Cell_jhnmoczc_wpftmp.GeneratedMSBuildEditorConfig.editorconfig", "Properties", 0, 0, 0, 0, 21, 0, 1, 22
"c:\Users\chris\source\repos\Cell\Cell\obj\Debug\net8.0-windows\Cell_jhnmoczc_wpftmp.GlobalUsings.g.cs", "C#", 5, 0, 0, 0, 0, 1, 1, 7
"c:\Users\chris\source\repos\Cell\Cell\obj\Debug\net8.0-windows\Cell_jhnmoczc_wpftmp.sourcelink.json", "JSON", 0, 0, 0, 1, 0, 0, 0, 1
"c:\Users\chris\source\repos\Cell\Cell\obj\Debug\net8.0-windows\Cell_jicqlawk_wpftmp.AssemblyInfo.cs", "C#", 11, 0, 0, 0, 0, 10, 5, 26
"c:\Users\chris\source\repos\Cell\Cell\obj\Debug\net8.0-windows\Cell_jicqlawk_wpftmp.GeneratedMSBuildEditorConfig.editorconfig", "Properties", 0, 0, 0, 0, 21, 0, 1, 22
"c:\Users\chris\source\repos\Cell\Cell\obj\Debug\net8.0-windows\Cell_jicqlawk_wpftmp.GlobalUsings.g.cs", "C#", 5, 0, 0, 0, 0, 1, 1, 7
"c:\Users\chris\source\repos\Cell\Cell\obj\Debug\net8.0-windows\Cell_jicqlawk_wpftmp.sourcelink.json", "JSON", 0, 0, 0, 1, 0, 0, 0, 1
"c:\Users\chris\source\repos\Cell\Cell\obj\Debug\net8.0-windows\Cell_jjnlvbpx_wpftmp.AssemblyInfo.cs", "C#", 11, 0, 0, 0, 0, 10, 5, 26
"c:\Users\chris\source\repos\Cell\Cell\obj\Debug\net8.0-windows\Cell_jjnlvbpx_wpftmp.GeneratedMSBuildEditorConfig.editorconfig", "Properties", 0, 0, 0, 0, 13, 0, 1, 14
"c:\Users\chris\source\repos\Cell\Cell\obj\Debug\net8.0-windows\Cell_jjnlvbpx_wpftmp.GlobalUsings.g.cs", "C#", 5, 0, 0, 0, 0, 1, 1, 7
"c:\Users\chris\source\repos\Cell\Cell\obj\Debug\net8.0-windows\Cell_jk2daje2_wpftmp.AssemblyInfo.cs", "C#", 11, 0, 0, 0, 0, 10, 5, 26
"c:\Users\chris\source\repos\Cell\Cell\obj\Debug\net8.0-windows\Cell_jk2daje2_wpftmp.GeneratedMSBuildEditorConfig.editorconfig", "Properties", 0, 0, 0, 0, 21, 0, 1, 22
"c:\Users\chris\source\repos\Cell\Cell\obj\Debug\net8.0-windows\Cell_jk2daje2_wpftmp.GlobalUsings.g.cs", "C#", 5, 0, 0, 0, 0, 1, 1, 7
"c:\Users\chris\source\repos\Cell\Cell\obj\Debug\net8.0-windows\Cell_jk2daje2_wpftmp.sourcelink.json", "JSON", 0, 0, 0, 1, 0, 0, 0, 1
"c:\Users\chris\source\repos\Cell\Cell\obj\Debug\net8.0-windows\Cell_jlmncjt0_wpftmp.AssemblyInfo.cs", "C#", 11, 0, 0, 0, 0, 10, 5, 26
"c:\Users\chris\source\repos\Cell\Cell\obj\Debug\net8.0-windows\Cell_jlmncjt0_wpftmp.GeneratedMSBuildEditorConfig.editorconfig", "Properties", 0, 0, 0, 0, 13, 0, 1, 14
"c:\Users\chris\source\repos\Cell\Cell\obj\Debug\net8.0-windows\Cell_jlmncjt0_wpftmp.GlobalUsings.g.cs", "C#", 5, 0, 0, 0, 0, 1, 1, 7
"c:\Users\chris\source\repos\Cell\Cell\obj\Debug\net8.0-windows\Cell_jmofqqod_wpftmp.AssemblyInfo.cs", "C#", 11, 0, 0, 0, 0, 10, 5, 26
"c:\Users\chris\source\repos\Cell\Cell\obj\Debug\net8.0-windows\Cell_jmofqqod_wpftmp.GeneratedMSBuildEditorConfig.editorconfig", "Properties", 0, 0, 0, 0, 21, 0, 1, 22
"c:\Users\chris\source\repos\Cell\Cell\obj\Debug\net8.0-windows\Cell_jmofqqod_wpftmp.GlobalUsings.g.cs", "C#", 5, 0, 0, 0, 0, 1, 1, 7
"c:\Users\chris\source\repos\Cell\Cell\obj\Debug\net8.0-windows\Cell_jmofqqod_wpftmp.sourcelink.json", "JSON", 0, 0, 0, 1, 0, 0, 0, 1
"c:\Users\chris\source\repos\Cell\Cell\obj\Debug\net8.0-windows\Cell_jmok1oiv_wpftmp.AssemblyInfo.cs", "C#", 11, 0, 0, 0, 0, 10, 5, 26
"c:\Users\chris\source\repos\Cell\Cell\obj\Debug\net8.0-windows\Cell_jmok1oiv_wpftmp.GeneratedMSBuildEditorConfig.editorconfig", "Properties", 0, 0, 0, 0, 21, 0, 1, 22
"c:\Users\chris\source\repos\Cell\Cell\obj\Debug\net8.0-windows\Cell_jmok1oiv_wpftmp.GlobalUsings.g.cs", "C#", 5, 0, 0, 0, 0, 1, 1, 7
"c:\Users\chris\source\repos\Cell\Cell\obj\Debug\net8.0-windows\Cell_jmok1oiv_wpftmp.sourcelink.json", "JSON", 0, 0, 0, 1, 0, 0, 0, 1
"c:\Users\chris\source\repos\Cell\Cell\obj\Debug\net8.0-windows\Cell_jmpeaxbl_wpftmp.AssemblyInfo.cs", "C#", 11, 0, 0, 0, 0, 10, 5, 26
"c:\Users\chris\source\repos\Cell\Cell\obj\Debug\net8.0-windows\Cell_jmpeaxbl_wpftmp.GeneratedMSBuildEditorConfig.editorconfig", "Properties", 0, 0, 0, 0, 21, 0, 1, 22
"c:\Users\chris\source\repos\Cell\Cell\obj\Debug\net8.0-windows\Cell_jmpeaxbl_wpftmp.GlobalUsings.g.cs", "C#", 5, 0, 0, 0, 0, 1, 1, 7
"c:\Users\chris\source\repos\Cell\Cell\obj\Debug\net8.0-windows\Cell_jmpeaxbl_wpftmp.sourcelink.json", "JSON", 0, 0, 0, 1, 0, 0, 0, 1
"c:\Users\chris\source\repos\Cell\Cell\obj\Debug\net8.0-windows\Cell_jnqzzbh2_wpftmp.AssemblyInfo.cs", "C#", 11, 0, 0, 0, 0, 10, 5, 26
"c:\Users\chris\source\repos\Cell\Cell\obj\Debug\net8.0-windows\Cell_jnqzzbh2_wpftmp.GeneratedMSBuildEditorConfig.editorconfig", "Properties", 0, 0, 0, 0, 21, 0, 1, 22
"c:\Users\chris\source\repos\Cell\Cell\obj\Debug\net8.0-windows\Cell_jnqzzbh2_wpftmp.GlobalUsings.g.cs", "C#", 5, 0, 0, 0, 0, 1, 1, 7
"c:\Users\chris\source\repos\Cell\Cell\obj\Debug\net8.0-windows\Cell_jnqzzbh2_wpftmp.sourcelink.json", "JSON", 0, 0, 0, 1, 0, 0, 0, 1
"c:\Users\chris\source\repos\Cell\Cell\obj\Debug\net8.0-windows\Cell_jrb4hixh_wpftmp.AssemblyInfo.cs", "C#", 11, 0, 0, 0, 0, 10, 5, 26
"c:\Users\chris\source\repos\Cell\Cell\obj\Debug\net8.0-windows\Cell_jrb4hixh_wpftmp.GeneratedMSBuildEditorConfig.editorconfig", "Properties", 0, 0, 0, 0, 21, 0, 1, 22
"c:\Users\chris\source\repos\Cell\Cell\obj\Debug\net8.0-windows\Cell_jrb4hixh_wpftmp.GlobalUsings.g.cs", "C#", 5, 0, 0, 0, 0, 1, 1, 7
"c:\Users\chris\source\repos\Cell\Cell\obj\Debug\net8.0-windows\Cell_jrb4hixh_wpftmp.sourcelink.json", "JSON", 0, 0, 0, 1, 0, 0, 0, 1
"c:\Users\chris\source\repos\Cell\Cell\obj\Debug\net8.0-windows\Cell_jsauelmz_wpftmp.AssemblyInfo.cs", "C#", 11, 0, 0, 0, 0, 10, 5, 26
"c:\Users\chris\source\repos\Cell\Cell\obj\Debug\net8.0-windows\Cell_jsauelmz_wpftmp.GeneratedMSBuildEditorConfig.editorconfig", "Properties", 0, 0, 0, 0, 21, 0, 1, 22
"c:\Users\chris\source\repos\Cell\Cell\obj\Debug\net8.0-windows\Cell_jsauelmz_wpftmp.GlobalUsings.g.cs", "C#", 5, 0, 0, 0, 0, 1, 1, 7
"c:\Users\chris\source\repos\Cell\Cell\obj\Debug\net8.0-windows\Cell_jsauelmz_wpftmp.sourcelink.json", "JSON", 0, 0, 0, 1, 0, 0, 0, 1
"c:\Users\chris\source\repos\Cell\Cell\obj\Debug\net8.0-windows\Cell_jsgjdhj5_wpftmp.AssemblyInfo.cs", "C#", 11, 0, 0, 0, 0, 10, 5, 26
"c:\Users\chris\source\repos\Cell\Cell\obj\Debug\net8.0-windows\Cell_jsgjdhj5_wpftmp.GeneratedMSBuildEditorConfig.editorconfig", "Properties", 0, 0, 0, 0, 21, 0, 1, 22
"c:\Users\chris\source\repos\Cell\Cell\obj\Debug\net8.0-windows\Cell_jsgjdhj5_wpftmp.GlobalUsings.g.cs", "C#", 5, 0, 0, 0, 0, 1, 1, 7
"c:\Users\chris\source\repos\Cell\Cell\obj\Debug\net8.0-windows\Cell_jsgjdhj5_wpftmp.sourcelink.json", "JSON", 0, 0, 0, 1, 0, 0, 0, 1
"c:\Users\chris\source\repos\Cell\Cell\obj\Debug\net8.0-windows\Cell_jswgvgey_wpftmp.AssemblyInfo.cs", "C#", 11, 0, 0, 0, 0, 10, 5, 26
"c:\Users\chris\source\repos\Cell\Cell\obj\Debug\net8.0-windows\Cell_jswgvgey_wpftmp.GeneratedMSBuildEditorConfig.editorconfig", "Properties", 0, 0, 0, 0, 21, 0, 1, 22
"c:\Users\chris\source\repos\Cell\Cell\obj\Debug\net8.0-windows\Cell_jswgvgey_wpftmp.GlobalUsings.g.cs", "C#", 5, 0, 0, 0, 0, 1, 1, 7
"c:\Users\chris\source\repos\Cell\Cell\obj\Debug\net8.0-windows\Cell_jswgvgey_wpftmp.sourcelink.json", "JSON", 0, 0, 0, 1, 0, 0, 0, 1
"c:\Users\chris\source\repos\Cell\Cell\obj\Debug\net8.0-windows\Cell_jtkmimxg_wpftmp.AssemblyInfo.cs", "C#", 11, 0, 0, 0, 0, 10, 5, 26
"c:\Users\chris\source\repos\Cell\Cell\obj\Debug\net8.0-windows\Cell_jtkmimxg_wpftmp.GeneratedMSBuildEditorConfig.editorconfig", "Properties", 0, 0, 0, 0, 21, 0, 1, 22
"c:\Users\chris\source\repos\Cell\Cell\obj\Debug\net8.0-windows\Cell_jtkmimxg_wpftmp.GlobalUsings.g.cs", "C#", 5, 0, 0, 0, 0, 1, 1, 7
"c:\Users\chris\source\repos\Cell\Cell\obj\Debug\net8.0-windows\Cell_jtkmimxg_wpftmp.sourcelink.json", "JSON", 0, 0, 0, 1, 0, 0, 0, 1
"c:\Users\chris\source\repos\Cell\Cell\obj\Debug\net8.0-windows\Cell_jtxsfugy_wpftmp.AssemblyInfo.cs", "C#", 11, 0, 0, 0, 0, 10, 5, 26
"c:\Users\chris\source\repos\Cell\Cell\obj\Debug\net8.0-windows\Cell_jtxsfugy_wpftmp.GeneratedMSBuildEditorConfig.editorconfig", "Properties", 0, 0, 0, 0, 21, 0, 1, 22
"c:\Users\chris\source\repos\Cell\Cell\obj\Debug\net8.0-windows\Cell_jtxsfugy_wpftmp.GlobalUsings.g.cs", "C#", 5, 0, 0, 0, 0, 1, 1, 7
"c:\Users\chris\source\repos\Cell\Cell\obj\Debug\net8.0-windows\Cell_jtxsfugy_wpftmp.sourcelink.json", "JSON", 0, 0, 0, 1, 0, 0, 0, 1
"c:\Users\chris\source\repos\Cell\Cell\obj\Debug\net8.0-windows\Cell_jumqp5rj_wpftmp.AssemblyInfo.cs", "C#", 11, 0, 0, 0, 0, 10, 5, 26
"c:\Users\chris\source\repos\Cell\Cell\obj\Debug\net8.0-windows\Cell_jumqp5rj_wpftmp.GeneratedMSBuildEditorConfig.editorconfig", "Properties", 0, 0, 0, 0, 21, 0, 1, 22
"c:\Users\chris\source\repos\Cell\Cell\obj\Debug\net8.0-windows\Cell_jumqp5rj_wpftmp.GlobalUsings.g.cs", "C#", 5, 0, 0, 0, 0, 1, 1, 7
"c:\Users\chris\source\repos\Cell\Cell\obj\Debug\net8.0-windows\Cell_jumqp5rj_wpftmp.sourcelink.json", "JSON", 0, 0, 0, 1, 0, 0, 0, 1
"c:\Users\chris\source\repos\Cell\Cell\obj\Debug\net8.0-windows\Cell_junsxusd_wpftmp.AssemblyInfo.cs", "C#", 11, 0, 0, 0, 0, 10, 5, 26
"c:\Users\chris\source\repos\Cell\Cell\obj\Debug\net8.0-windows\Cell_junsxusd_wpftmp.GeneratedMSBuildEditorConfig.editorconfig", "Properties", 0, 0, 0, 0, 21, 0, 1, 22
"c:\Users\chris\source\repos\Cell\Cell\obj\Debug\net8.0-windows\Cell_junsxusd_wpftmp.GlobalUsings.g.cs", "C#", 5, 0, 0, 0, 0, 1, 1, 7
"c:\Users\chris\source\repos\Cell\Cell\obj\Debug\net8.0-windows\Cell_junsxusd_wpftmp.sourcelink.json", "JSON", 0, 0, 0, 1, 0, 0, 0, 1
"c:\Users\chris\source\repos\Cell\Cell\obj\Debug\net8.0-windows\Cell_jutxfrsw_wpftmp.AssemblyInfo.cs", "C#", 11, 0, 0, 0, 0, 10, 5, 26
"c:\Users\chris\source\repos\Cell\Cell\obj\Debug\net8.0-windows\Cell_jutxfrsw_wpftmp.GeneratedMSBuildEditorConfig.editorconfig", "Properties", 0, 0, 0, 0, 21, 0, 1, 22
"c:\Users\chris\source\repos\Cell\Cell\obj\Debug\net8.0-windows\Cell_jutxfrsw_wpftmp.GlobalUsings.g.cs", "C#", 5, 0, 0, 0, 0, 1, 1, 7
"c:\Users\chris\source\repos\Cell\Cell\obj\Debug\net8.0-windows\Cell_jutxfrsw_wpftmp.sourcelink.json", "JSON", 0, 0, 0, 1, 0, 0, 0, 1
"c:\Users\chris\source\repos\Cell\Cell\obj\Debug\net8.0-windows\Cell_juu4xrpj_wpftmp.AssemblyInfo.cs", "C#", 11, 0, 0, 0, 0, 10, 5, 26
"c:\Users\chris\source\repos\Cell\Cell\obj\Debug\net8.0-windows\Cell_juu4xrpj_wpftmp.GeneratedMSBuildEditorConfig.editorconfig", "Properties", 0, 0, 0, 0, 21, 0, 1, 22
"c:\Users\chris\source\repos\Cell\Cell\obj\Debug\net8.0-windows\Cell_juu4xrpj_wpftmp.GlobalUsings.g.cs", "C#", 5, 0, 0, 0, 0, 1, 1, 7
"c:\Users\chris\source\repos\Cell\Cell\obj\Debug\net8.0-windows\Cell_juu4xrpj_wpftmp.sourcelink.json", "JSON", 0, 0, 0, 1, 0, 0, 0, 1
"c:\Users\chris\source\repos\Cell\Cell\obj\Debug\net8.0-windows\Cell_jvcu4umg_wpftmp.AssemblyInfo.cs", "C#", 11, 0, 0, 0, 0, 10, 5, 26
"c:\Users\chris\source\repos\Cell\Cell\obj\Debug\net8.0-windows\Cell_jvcu4umg_wpftmp.GeneratedMSBuildEditorConfig.editorconfig", "Properties", 0, 0, 0, 0, 21, 0, 1, 22
"c:\Users\chris\source\repos\Cell\Cell\obj\Debug\net8.0-windows\Cell_jvcu4umg_wpftmp.GlobalUsings.g.cs", "C#", 5, 0, 0, 0, 0, 1, 1, 7
"c:\Users\chris\source\repos\Cell\Cell\obj\Debug\net8.0-windows\Cell_jvcu4umg_wpftmp.sourcelink.json", "JSON", 0, 0, 0, 1, 0, 0, 0, 1
"c:\Users\chris\source\repos\Cell\Cell\obj\Debug\net8.0-windows\Cell_jxgetufj_wpftmp.AssemblyInfo.cs", "C#", 11, 0, 0, 0, 0, 10, 5, 26
"c:\Users\chris\source\repos\Cell\Cell\obj\Debug\net8.0-windows\Cell_jxgetufj_wpftmp.GeneratedMSBuildEditorConfig.editorconfig", "Properties", 0, 0, 0, 0, 21, 0, 1, 22
"c:\Users\chris\source\repos\Cell\Cell\obj\Debug\net8.0-windows\Cell_jxgetufj_wpftmp.GlobalUsings.g.cs", "C#", 5, 0, 0, 0, 0, 1, 1, 7
"c:\Users\chris\source\repos\Cell\Cell\obj\Debug\net8.0-windows\Cell_jxgetufj_wpftmp.sourcelink.json", "JSON", 0, 0, 0, 1, 0, 0, 0, 1
"c:\Users\chris\source\repos\Cell\Cell\obj\Debug\net8.0-windows\Cell_jxzfumku_wpftmp.AssemblyInfo.cs", "C#", 11, 0, 0, 0, 0, 10, 5, 26
"c:\Users\chris\source\repos\Cell\Cell\obj\Debug\net8.0-windows\Cell_jxzfumku_wpftmp.GeneratedMSBuildEditorConfig.editorconfig", "Properties", 0, 0, 0, 0, 13, 0, 1, 14
"c:\Users\chris\source\repos\Cell\Cell\obj\Debug\net8.0-windows\Cell_jxzfumku_wpftmp.GlobalUsings.g.cs", "C#", 5, 0, 0, 0, 0, 1, 1, 7
"c:\Users\chris\source\repos\Cell\Cell\obj\Debug\net8.0-windows\Cell_jyeyjbbc_wpftmp.AssemblyInfo.cs", "C#", 11, 0, 0, 0, 0, 10, 5, 26
"c:\Users\chris\source\repos\Cell\Cell\obj\Debug\net8.0-windows\Cell_jyeyjbbc_wpftmp.GeneratedMSBuildEditorConfig.editorconfig", "Properties", 0, 0, 0, 0, 21, 0, 1, 22
"c:\Users\chris\source\repos\Cell\Cell\obj\Debug\net8.0-windows\Cell_jyeyjbbc_wpftmp.GlobalUsings.g.cs", "C#", 5, 0, 0, 0, 0, 1, 1, 7
"c:\Users\chris\source\repos\Cell\Cell\obj\Debug\net8.0-windows\Cell_jyeyjbbc_wpftmp.sourcelink.json", "JSON", 0, 0, 0, 1, 0, 0, 0, 1
"c:\Users\chris\source\repos\Cell\Cell\obj\Debug\net8.0-windows\Cell_jynjqxgh_wpftmp.AssemblyInfo.cs", "C#", 11, 0, 0, 0, 0, 10, 5, 26
"c:\Users\chris\source\repos\Cell\Cell\obj\Debug\net8.0-windows\Cell_jynjqxgh_wpftmp.GeneratedMSBuildEditorConfig.editorconfig", "Properties", 0, 0, 0, 0, 21, 0, 1, 22
"c:\Users\chris\source\repos\Cell\Cell\obj\Debug\net8.0-windows\Cell_jynjqxgh_wpftmp.GlobalUsings.g.cs", "C#", 5, 0, 0, 0, 0, 1, 1, 7
"c:\Users\chris\source\repos\Cell\Cell\obj\Debug\net8.0-windows\Cell_jynjqxgh_wpftmp.sourcelink.json", "JSON", 0, 0, 0, 1, 0, 0, 0, 1
"c:\Users\chris\source\repos\Cell\Cell\obj\Debug\net8.0-windows\Cell_jyqwnbzg_wpftmp.AssemblyInfo.cs", "C#", 11, 0, 0, 0, 0, 10, 5, 26
"c:\Users\chris\source\repos\Cell\Cell\obj\Debug\net8.0-windows\Cell_jyqwnbzg_wpftmp.GeneratedMSBuildEditorConfig.editorconfig", "Properties", 0, 0, 0, 0, 13, 0, 1, 14
"c:\Users\chris\source\repos\Cell\Cell\obj\Debug\net8.0-windows\Cell_jyqwnbzg_wpftmp.GlobalUsings.g.cs", "C#", 5, 0, 0, 0, 0, 1, 1, 7
"c:\Users\chris\source\repos\Cell\Cell\obj\Debug\net8.0-windows\Cell_jzll2hwz_wpftmp.AssemblyInfo.cs", "C#", 11, 0, 0, 0, 0, 10, 5, 26
"c:\Users\chris\source\repos\Cell\Cell\obj\Debug\net8.0-windows\Cell_jzll2hwz_wpftmp.GeneratedMSBuildEditorConfig.editorconfig", "Properties", 0, 0, 0, 0, 21, 0, 1, 22
"c:\Users\chris\source\repos\Cell\Cell\obj\Debug\net8.0-windows\Cell_jzll2hwz_wpftmp.GlobalUsings.g.cs", "C#", 5, 0, 0, 0, 0, 1, 1, 7
"c:\Users\chris\source\repos\Cell\Cell\obj\Debug\net8.0-windows\Cell_jzll2hwz_wpftmp.sourcelink.json", "JSON", 0, 0, 0, 1, 0, 0, 0, 1
"c:\Users\chris\source\repos\Cell\Cell\obj\Debug\net8.0-windows\Cell_jzlz45uz_wpftmp.AssemblyInfo.cs", "C#", 11, 0, 0, 0, 0, 10, 5, 26
"c:\Users\chris\source\repos\Cell\Cell\obj\Debug\net8.0-windows\Cell_jzlz45uz_wpftmp.GeneratedMSBuildEditorConfig.editorconfig", "Properties", 0, 0, 0, 0, 21, 0, 1, 22
"c:\Users\chris\source\repos\Cell\Cell\obj\Debug\net8.0-windows\Cell_jzlz45uz_wpftmp.GlobalUsings.g.cs", "C#", 5, 0, 0, 0, 0, 1, 1, 7
"c:\Users\chris\source\repos\Cell\Cell\obj\Debug\net8.0-windows\Cell_jzlz45uz_wpftmp.sourcelink.json", "JSON", 0, 0, 0, 1, 0, 0, 0, 1
"c:\Users\chris\source\repos\Cell\Cell\obj\Debug\net8.0-windows\Cell_k0hot342_wpftmp.AssemblyInfo.cs", "C#", 11, 0, 0, 0, 0, 10, 5, 26
"c:\Users\chris\source\repos\Cell\Cell\obj\Debug\net8.0-windows\Cell_k0hot342_wpftmp.GeneratedMSBuildEditorConfig.editorconfig", "Properties", 0, 0, 0, 0, 21, 0, 1, 22
"c:\Users\chris\source\repos\Cell\Cell\obj\Debug\net8.0-windows\Cell_k0hot342_wpftmp.GlobalUsings.g.cs", "C#", 5, 0, 0, 0, 0, 1, 1, 7
"c:\Users\chris\source\repos\Cell\Cell\obj\Debug\net8.0-windows\Cell_k0hot342_wpftmp.sourcelink.json", "JSON", 0, 0, 0, 1, 0, 0, 0, 1
"c:\Users\chris\source\repos\Cell\Cell\obj\Debug\net8.0-windows\Cell_k0oygg0i_wpftmp.AssemblyInfo.cs", "C#", 11, 0, 0, 0, 0, 10, 5, 26
"c:\Users\chris\source\repos\Cell\Cell\obj\Debug\net8.0-windows\Cell_k0oygg0i_wpftmp.GeneratedMSBuildEditorConfig.editorconfig", "Properties", 0, 0, 0, 0, 21, 0, 1, 22
"c:\Users\chris\source\repos\Cell\Cell\obj\Debug\net8.0-windows\Cell_k0oygg0i_wpftmp.GlobalUsings.g.cs", "C#", 5, 0, 0, 0, 0, 1, 1, 7
"c:\Users\chris\source\repos\Cell\Cell\obj\Debug\net8.0-windows\Cell_k0oygg0i_wpftmp.sourcelink.json", "JSON", 0, 0, 0, 1, 0, 0, 0, 1
"c:\Users\chris\source\repos\Cell\Cell\obj\Debug\net8.0-windows\Cell_k0ta2hmj_wpftmp.AssemblyInfo.cs", "C#", 11, 0, 0, 0, 0, 10, 5, 26
"c:\Users\chris\source\repos\Cell\Cell\obj\Debug\net8.0-windows\Cell_k0ta2hmj_wpftmp.GeneratedMSBuildEditorConfig.editorconfig", "Properties", 0, 0, 0, 0, 21, 0, 1, 22
"c:\Users\chris\source\repos\Cell\Cell\obj\Debug\net8.0-windows\Cell_k0ta2hmj_wpftmp.GlobalUsings.g.cs", "C#", 5, 0, 0, 0, 0, 1, 1, 7
"c:\Users\chris\source\repos\Cell\Cell\obj\Debug\net8.0-windows\Cell_k0ta2hmj_wpftmp.sourcelink.json", "JSON", 0, 0, 0, 1, 0, 0, 0, 1
"c:\Users\chris\source\repos\Cell\Cell\obj\Debug\net8.0-windows\Cell_k1pqqxqa_wpftmp.AssemblyInfo.cs", "C#", 11, 0, 0, 0, 0, 10, 5, 26
"c:\Users\chris\source\repos\Cell\Cell\obj\Debug\net8.0-windows\Cell_k1pqqxqa_wpftmp.GeneratedMSBuildEditorConfig.editorconfig", "Properties", 0, 0, 0, 0, 21, 0, 1, 22
"c:\Users\chris\source\repos\Cell\Cell\obj\Debug\net8.0-windows\Cell_k1pqqxqa_wpftmp.GlobalUsings.g.cs", "C#", 5, 0, 0, 0, 0, 1, 1, 7
"c:\Users\chris\source\repos\Cell\Cell\obj\Debug\net8.0-windows\Cell_k1pqqxqa_wpftmp.sourcelink.json", "JSON", 0, 0, 0, 1, 0, 0, 0, 1
"c:\Users\chris\source\repos\Cell\Cell\obj\Debug\net8.0-windows\Cell_k1qhumy0_wpftmp.AssemblyInfo.cs", "C#", 11, 0, 0, 0, 0, 10, 5, 26
"c:\Users\chris\source\repos\Cell\Cell\obj\Debug\net8.0-windows\Cell_k1qhumy0_wpftmp.GeneratedMSBuildEditorConfig.editorconfig", "Properties", 0, 0, 0, 0, 21, 0, 1, 22
"c:\Users\chris\source\repos\Cell\Cell\obj\Debug\net8.0-windows\Cell_k1qhumy0_wpftmp.GlobalUsings.g.cs", "C#", 5, 0, 0, 0, 0, 1, 1, 7
"c:\Users\chris\source\repos\Cell\Cell\obj\Debug\net8.0-windows\Cell_k1qhumy0_wpftmp.sourcelink.json", "JSON", 0, 0, 0, 1, 0, 0, 0, 1
"c:\Users\chris\source\repos\Cell\Cell\obj\Debug\net8.0-windows\Cell_k1rjknlt_wpftmp.AssemblyInfo.cs", "C#", 11, 0, 0, 0, 0, 10, 5, 26
"c:\Users\chris\source\repos\Cell\Cell\obj\Debug\net8.0-windows\Cell_k1rjknlt_wpftmp.GeneratedMSBuildEditorConfig.editorconfig", "Properties", 0, 0, 0, 0, 21, 0, 1, 22
"c:\Users\chris\source\repos\Cell\Cell\obj\Debug\net8.0-windows\Cell_k1rjknlt_wpftmp.GlobalUsings.g.cs", "C#", 5, 0, 0, 0, 0, 1, 1, 7
"c:\Users\chris\source\repos\Cell\Cell\obj\Debug\net8.0-windows\Cell_k1rjknlt_wpftmp.sourcelink.json", "JSON", 0, 0, 0, 1, 0, 0, 0, 1
"c:\Users\chris\source\repos\Cell\Cell\obj\Debug\net8.0-windows\Cell_k3jdtvyz_wpftmp.AssemblyInfo.cs", "C#", 11, 0, 0, 0, 0, 10, 5, 26
"c:\Users\chris\source\repos\Cell\Cell\obj\Debug\net8.0-windows\Cell_k3jdtvyz_wpftmp.GeneratedMSBuildEditorConfig.editorconfig", "Properties", 0, 0, 0, 0, 21, 0, 1, 22
"c:\Users\chris\source\repos\Cell\Cell\obj\Debug\net8.0-windows\Cell_k3jdtvyz_wpftmp.GlobalUsings.g.cs", "C#", 5, 0, 0, 0, 0, 1, 1, 7
"c:\Users\chris\source\repos\Cell\Cell\obj\Debug\net8.0-windows\Cell_k3jdtvyz_wpftmp.sourcelink.json", "JSON", 0, 0, 0, 1, 0, 0, 0, 1
"c:\Users\chris\source\repos\Cell\Cell\obj\Debug\net8.0-windows\Cell_k3pdbh2b_wpftmp.AssemblyInfo.cs", "C#", 11, 0, 0, 0, 0, 10, 5, 26
"c:\Users\chris\source\repos\Cell\Cell\obj\Debug\net8.0-windows\Cell_k3pdbh2b_wpftmp.GeneratedMSBuildEditorConfig.editorconfig", "Properties", 0, 0, 0, 0, 21, 0, 1, 22
"c:\Users\chris\source\repos\Cell\Cell\obj\Debug\net8.0-windows\Cell_k3pdbh2b_wpftmp.GlobalUsings.g.cs", "C#", 5, 0, 0, 0, 0, 1, 1, 7
"c:\Users\chris\source\repos\Cell\Cell\obj\Debug\net8.0-windows\Cell_k3pdbh2b_wpftmp.sourcelink.json", "JSON", 0, 0, 0, 1, 0, 0, 0, 1
"c:\Users\chris\source\repos\Cell\Cell\obj\Debug\net8.0-windows\Cell_k4tgqhda_wpftmp.AssemblyInfo.cs", "C#", 11, 0, 0, 0, 0, 10, 5, 26
"c:\Users\chris\source\repos\Cell\Cell\obj\Debug\net8.0-windows\Cell_k4tgqhda_wpftmp.GeneratedMSBuildEditorConfig.editorconfig", "Properties", 0, 0, 0, 0, 21, 0, 1, 22
"c:\Users\chris\source\repos\Cell\Cell\obj\Debug\net8.0-windows\Cell_k4tgqhda_wpftmp.GlobalUsings.g.cs", "C#", 5, 0, 0, 0, 0, 1, 1, 7
"c:\Users\chris\source\repos\Cell\Cell\obj\Debug\net8.0-windows\Cell_k4tgqhda_wpftmp.sourcelink.json", "JSON", 0, 0, 0, 1, 0, 0, 0, 1
"c:\Users\chris\source\repos\Cell\Cell\obj\Debug\net8.0-windows\Cell_k550dt1k_wpftmp.AssemblyInfo.cs", "C#", 11, 0, 0, 0, 0, 10, 5, 26
"c:\Users\chris\source\repos\Cell\Cell\obj\Debug\net8.0-windows\Cell_k550dt1k_wpftmp.GeneratedMSBuildEditorConfig.editorconfig", "Properties", 0, 0, 0, 0, 13, 0, 1, 14
"c:\Users\chris\source\repos\Cell\Cell\obj\Debug\net8.0-windows\Cell_k550dt1k_wpftmp.GlobalUsings.g.cs", "C#", 5, 0, 0, 0, 0, 1, 1, 7
"c:\Users\chris\source\repos\Cell\Cell\obj\Debug\net8.0-windows\Cell_kamwefty_wpftmp.AssemblyInfo.cs", "C#", 11, 0, 0, 0, 0, 10, 5, 26
"c:\Users\chris\source\repos\Cell\Cell\obj\Debug\net8.0-windows\Cell_kamwefty_wpftmp.GeneratedMSBuildEditorConfig.editorconfig", "Properties", 0, 0, 0, 0, 21, 0, 1, 22
"c:\Users\chris\source\repos\Cell\Cell\obj\Debug\net8.0-windows\Cell_kamwefty_wpftmp.GlobalUsings.g.cs", "C#", 5, 0, 0, 0, 0, 1, 1, 7
"c:\Users\chris\source\repos\Cell\Cell\obj\Debug\net8.0-windows\Cell_kamwefty_wpftmp.sourcelink.json", "JSON", 0, 0, 0, 1, 0, 0, 0, 1
"c:\Users\chris\source\repos\Cell\Cell\obj\Debug\net8.0-windows\Cell_kb5pfsrc_wpftmp.AssemblyInfo.cs", "C#", 11, 0, 0, 0, 0, 10, 5, 26
"c:\Users\chris\source\repos\Cell\Cell\obj\Debug\net8.0-windows\Cell_kb5pfsrc_wpftmp.GeneratedMSBuildEditorConfig.editorconfig", "Properties", 0, 0, 0, 0, 13, 0, 1, 14
"c:\Users\chris\source\repos\Cell\Cell\obj\Debug\net8.0-windows\Cell_kb5pfsrc_wpftmp.GlobalUsings.g.cs", "C#", 5, 0, 0, 0, 0, 1, 1, 7
"c:\Users\chris\source\repos\Cell\Cell\obj\Debug\net8.0-windows\Cell_kccah3iq_wpftmp.AssemblyInfo.cs", "C#", 11, 0, 0, 0, 0, 10, 5, 26
"c:\Users\chris\source\repos\Cell\Cell\obj\Debug\net8.0-windows\Cell_kccah3iq_wpftmp.GeneratedMSBuildEditorConfig.editorconfig", "Properties", 0, 0, 0, 0, 21, 0, 1, 22
"c:\Users\chris\source\repos\Cell\Cell\obj\Debug\net8.0-windows\Cell_kccah3iq_wpftmp.GlobalUsings.g.cs", "C#", 5, 0, 0, 0, 0, 1, 1, 7
"c:\Users\chris\source\repos\Cell\Cell\obj\Debug\net8.0-windows\Cell_kccah3iq_wpftmp.sourcelink.json", "JSON", 0, 0, 0, 1, 0, 0, 0, 1
"c:\Users\chris\source\repos\Cell\Cell\obj\Debug\net8.0-windows\Cell_kckspvo5_wpftmp.AssemblyInfo.cs", "C#", 11, 0, 0, 0, 0, 10, 5, 26
"c:\Users\chris\source\repos\Cell\Cell\obj\Debug\net8.0-windows\Cell_kckspvo5_wpftmp.GeneratedMSBuildEditorConfig.editorconfig", "Properties", 0, 0, 0, 0, 21, 0, 1, 22
"c:\Users\chris\source\repos\Cell\Cell\obj\Debug\net8.0-windows\Cell_kckspvo5_wpftmp.GlobalUsings.g.cs", "C#", 5, 0, 0, 0, 0, 1, 1, 7
"c:\Users\chris\source\repos\Cell\Cell\obj\Debug\net8.0-windows\Cell_kckspvo5_wpftmp.sourcelink.json", "JSON", 0, 0, 0, 1, 0, 0, 0, 1
"c:\Users\chris\source\repos\Cell\Cell\obj\Debug\net8.0-windows\Cell_kdqgvlpm_wpftmp.AssemblyInfo.cs", "C#", 11, 0, 0, 0, 0, 10, 5, 26
"c:\Users\chris\source\repos\Cell\Cell\obj\Debug\net8.0-windows\Cell_kdqgvlpm_wpftmp.GeneratedMSBuildEditorConfig.editorconfig", "Properties", 0, 0, 0, 0, 21, 0, 1, 22
"c:\Users\chris\source\repos\Cell\Cell\obj\Debug\net8.0-windows\Cell_kdqgvlpm_wpftmp.GlobalUsings.g.cs", "C#", 5, 0, 0, 0, 0, 1, 1, 7
"c:\Users\chris\source\repos\Cell\Cell\obj\Debug\net8.0-windows\Cell_kdqgvlpm_wpftmp.sourcelink.json", "JSON", 0, 0, 0, 1, 0, 0, 0, 1
"c:\Users\chris\source\repos\Cell\Cell\obj\Debug\net8.0-windows\Cell_kdznilla_wpftmp.AssemblyInfo.cs", "C#", 11, 0, 0, 0, 0, 10, 5, 26
"c:\Users\chris\source\repos\Cell\Cell\obj\Debug\net8.0-windows\Cell_kdznilla_wpftmp.GeneratedMSBuildEditorConfig.editorconfig", "Properties", 0, 0, 0, 0, 13, 0, 1, 14
"c:\Users\chris\source\repos\Cell\Cell\obj\Debug\net8.0-windows\Cell_kdznilla_wpftmp.GlobalUsings.g.cs", "C#", 5, 0, 0, 0, 0, 1, 1, 7
"c:\Users\chris\source\repos\Cell\Cell\obj\Debug\net8.0-windows\Cell_kf4tbp3d_wpftmp.AssemblyInfo.cs", "C#", 11, 0, 0, 0, 0, 10, 5, 26
"c:\Users\chris\source\repos\Cell\Cell\obj\Debug\net8.0-windows\Cell_kf4tbp3d_wpftmp.GeneratedMSBuildEditorConfig.editorconfig", "Properties", 0, 0, 0, 0, 21, 0, 1, 22
"c:\Users\chris\source\repos\Cell\Cell\obj\Debug\net8.0-windows\Cell_kf4tbp3d_wpftmp.GlobalUsings.g.cs", "C#", 5, 0, 0, 0, 0, 1, 1, 7
"c:\Users\chris\source\repos\Cell\Cell\obj\Debug\net8.0-windows\Cell_kf4tbp3d_wpftmp.sourcelink.json", "JSON", 0, 0, 0, 1, 0, 0, 0, 1
"c:\Users\chris\source\repos\Cell\Cell\obj\Debug\net8.0-windows\Cell_kgfbhkyj_wpftmp.AssemblyInfo.cs", "C#", 11, 0, 0, 0, 0, 10, 5, 26
"c:\Users\chris\source\repos\Cell\Cell\obj\Debug\net8.0-windows\Cell_kgfbhkyj_wpftmp.GeneratedMSBuildEditorConfig.editorconfig", "Properties", 0, 0, 0, 0, 13, 0, 1, 14
"c:\Users\chris\source\repos\Cell\Cell\obj\Debug\net8.0-windows\Cell_kgfbhkyj_wpftmp.GlobalUsings.g.cs", "C#", 5, 0, 0, 0, 0, 1, 1, 7
"c:\Users\chris\source\repos\Cell\Cell\obj\Debug\net8.0-windows\Cell_kgpug0z1_wpftmp.AssemblyInfo.cs", "C#", 11, 0, 0, 0, 0, 10, 5, 26
"c:\Users\chris\source\repos\Cell\Cell\obj\Debug\net8.0-windows\Cell_kgpug0z1_wpftmp.GeneratedMSBuildEditorConfig.editorconfig", "Properties", 0, 0, 0, 0, 21, 0, 1, 22
"c:\Users\chris\source\repos\Cell\Cell\obj\Debug\net8.0-windows\Cell_kgpug0z1_wpftmp.GlobalUsings.g.cs", "C#", 5, 0, 0, 0, 0, 1, 1, 7
"c:\Users\chris\source\repos\Cell\Cell\obj\Debug\net8.0-windows\Cell_kgpug0z1_wpftmp.sourcelink.json", "JSON", 0, 0, 0, 1, 0, 0, 0, 1
"c:\Users\chris\source\repos\Cell\Cell\obj\Debug\net8.0-windows\Cell_khiinqlu_wpftmp.AssemblyInfo.cs", "C#", 11, 0, 0, 0, 0, 10, 5, 26
"c:\Users\chris\source\repos\Cell\Cell\obj\Debug\net8.0-windows\Cell_khiinqlu_wpftmp.GeneratedMSBuildEditorConfig.editorconfig", "Properties", 0, 0, 0, 0, 21, 0, 1, 22
"c:\Users\chris\source\repos\Cell\Cell\obj\Debug\net8.0-windows\Cell_khiinqlu_wpftmp.GlobalUsings.g.cs", "C#", 5, 0, 0, 0, 0, 1, 1, 7
"c:\Users\chris\source\repos\Cell\Cell\obj\Debug\net8.0-windows\Cell_khiinqlu_wpftmp.sourcelink.json", "JSON", 0, 0, 0, 1, 0, 0, 0, 1
"c:\Users\chris\source\repos\Cell\Cell\obj\Debug\net8.0-windows\Cell_khwnepoc_wpftmp.AssemblyInfo.cs", "C#", 11, 0, 0, 0, 0, 10, 5, 26
"c:\Users\chris\source\repos\Cell\Cell\obj\Debug\net8.0-windows\Cell_khwnepoc_wpftmp.GeneratedMSBuildEditorConfig.editorconfig", "Properties", 0, 0, 0, 0, 21, 0, 1, 22
"c:\Users\chris\source\repos\Cell\Cell\obj\Debug\net8.0-windows\Cell_khwnepoc_wpftmp.GlobalUsings.g.cs", "C#", 5, 0, 0, 0, 0, 1, 1, 7
"c:\Users\chris\source\repos\Cell\Cell\obj\Debug\net8.0-windows\Cell_khwnepoc_wpftmp.sourcelink.json", "JSON", 0, 0, 0, 1, 0, 0, 0, 1
"c:\Users\chris\source\repos\Cell\Cell\obj\Debug\net8.0-windows\Cell_kjjlrnuc_wpftmp.AssemblyInfo.cs", "C#", 11, 0, 0, 0, 0, 10, 5, 26
"c:\Users\chris\source\repos\Cell\Cell\obj\Debug\net8.0-windows\Cell_kjjlrnuc_wpftmp.GeneratedMSBuildEditorConfig.editorconfig", "Properties", 0, 0, 0, 0, 21, 0, 1, 22
"c:\Users\chris\source\repos\Cell\Cell\obj\Debug\net8.0-windows\Cell_kjjlrnuc_wpftmp.GlobalUsings.g.cs", "C#", 5, 0, 0, 0, 0, 1, 1, 7
"c:\Users\chris\source\repos\Cell\Cell\obj\Debug\net8.0-windows\Cell_kjjlrnuc_wpftmp.sourcelink.json", "JSON", 0, 0, 0, 1, 0, 0, 0, 1
"c:\Users\chris\source\repos\Cell\Cell\obj\Debug\net8.0-windows\Cell_klaghjkh_wpftmp.AssemblyInfo.cs", "C#", 11, 0, 0, 0, 0, 10, 5, 26
"c:\Users\chris\source\repos\Cell\Cell\obj\Debug\net8.0-windows\Cell_klaghjkh_wpftmp.GeneratedMSBuildEditorConfig.editorconfig", "Properties", 0, 0, 0, 0, 21, 0, 1, 22
"c:\Users\chris\source\repos\Cell\Cell\obj\Debug\net8.0-windows\Cell_klaghjkh_wpftmp.GlobalUsings.g.cs", "C#", 5, 0, 0, 0, 0, 1, 1, 7
"c:\Users\chris\source\repos\Cell\Cell\obj\Debug\net8.0-windows\Cell_klaghjkh_wpftmp.sourcelink.json", "JSON", 0, 0, 0, 1, 0, 0, 0, 1
"c:\Users\chris\source\repos\Cell\Cell\obj\Debug\net8.0-windows\Cell_kli3zkny_wpftmp.AssemblyInfo.cs", "C#", 11, 0, 0, 0, 0, 10, 5, 26
"c:\Users\chris\source\repos\Cell\Cell\obj\Debug\net8.0-windows\Cell_kli3zkny_wpftmp.GeneratedMSBuildEditorConfig.editorconfig", "Properties", 0, 0, 0, 0, 21, 0, 1, 22
"c:\Users\chris\source\repos\Cell\Cell\obj\Debug\net8.0-windows\Cell_kli3zkny_wpftmp.GlobalUsings.g.cs", "C#", 5, 0, 0, 0, 0, 1, 1, 7
"c:\Users\chris\source\repos\Cell\Cell\obj\Debug\net8.0-windows\Cell_kli3zkny_wpftmp.sourcelink.json", "JSON", 0, 0, 0, 1, 0, 0, 0, 1
"c:\Users\chris\source\repos\Cell\Cell\obj\Debug\net8.0-windows\Cell_klpr3fev_wpftmp.AssemblyInfo.cs", "C#", 11, 0, 0, 0, 0, 10, 5, 26
"c:\Users\chris\source\repos\Cell\Cell\obj\Debug\net8.0-windows\Cell_klpr3fev_wpftmp.GeneratedMSBuildEditorConfig.editorconfig", "Properties", 0, 0, 0, 0, 21, 0, 1, 22
"c:\Users\chris\source\repos\Cell\Cell\obj\Debug\net8.0-windows\Cell_klpr3fev_wpftmp.GlobalUsings.g.cs", "C#", 5, 0, 0, 0, 0, 1, 1, 7
"c:\Users\chris\source\repos\Cell\Cell\obj\Debug\net8.0-windows\Cell_klzhdh4e_wpftmp.AssemblyInfo.cs", "C#", 11, 0, 0, 0, 0, 10, 5, 26
"c:\Users\chris\source\repos\Cell\Cell\obj\Debug\net8.0-windows\Cell_klzhdh4e_wpftmp.GeneratedMSBuildEditorConfig.editorconfig", "Properties", 0, 0, 0, 0, 21, 0, 1, 22
"c:\Users\chris\source\repos\Cell\Cell\obj\Debug\net8.0-windows\Cell_klzhdh4e_wpftmp.GlobalUsings.g.cs", "C#", 5, 0, 0, 0, 0, 1, 1, 7
"c:\Users\chris\source\repos\Cell\Cell\obj\Debug\net8.0-windows\Cell_klzhdh4e_wpftmp.sourcelink.json", "JSON", 0, 0, 0, 1, 0, 0, 0, 1
"c:\Users\chris\source\repos\Cell\Cell\obj\Debug\net8.0-windows\Cell_kmateqn5_wpftmp.AssemblyInfo.cs", "C#", 11, 0, 0, 0, 0, 10, 5, 26
"c:\Users\chris\source\repos\Cell\Cell\obj\Debug\net8.0-windows\Cell_kmateqn5_wpftmp.GeneratedMSBuildEditorConfig.editorconfig", "Properties", 0, 0, 0, 0, 21, 0, 1, 22
"c:\Users\chris\source\repos\Cell\Cell\obj\Debug\net8.0-windows\Cell_kmateqn5_wpftmp.GlobalUsings.g.cs", "C#", 5, 0, 0, 0, 0, 1, 1, 7
"c:\Users\chris\source\repos\Cell\Cell\obj\Debug\net8.0-windows\Cell_kmateqn5_wpftmp.sourcelink.json", "JSON", 0, 0, 0, 1, 0, 0, 0, 1
"c:\Users\chris\source\repos\Cell\Cell\obj\Debug\net8.0-windows\Cell_kmy0pleu_wpftmp.AssemblyInfo.cs", "C#", 11, 0, 0, 0, 0, 10, 5, 26
"c:\Users\chris\source\repos\Cell\Cell\obj\Debug\net8.0-windows\Cell_kmy0pleu_wpftmp.GeneratedMSBuildEditorConfig.editorconfig", "Properties", 0, 0, 0, 0, 21, 0, 1, 22
"c:\Users\chris\source\repos\Cell\Cell\obj\Debug\net8.0-windows\Cell_kmy0pleu_wpftmp.GlobalUsings.g.cs", "C#", 5, 0, 0, 0, 0, 1, 1, 7
"c:\Users\chris\source\repos\Cell\Cell\obj\Debug\net8.0-windows\Cell_kmy0pleu_wpftmp.sourcelink.json", "JSON", 0, 0, 0, 1, 0, 0, 0, 1
"c:\Users\chris\source\repos\Cell\Cell\obj\Debug\net8.0-windows\Cell_kocert4k_wpftmp.AssemblyInfo.cs", "C#", 11, 0, 0, 0, 0, 10, 5, 26
"c:\Users\chris\source\repos\Cell\Cell\obj\Debug\net8.0-windows\Cell_kocert4k_wpftmp.GeneratedMSBuildEditorConfig.editorconfig", "Properties", 0, 0, 0, 0, 13, 0, 1, 14
"c:\Users\chris\source\repos\Cell\Cell\obj\Debug\net8.0-windows\Cell_kocert4k_wpftmp.GlobalUsings.g.cs", "C#", 5, 0, 0, 0, 0, 1, 1, 7
"c:\Users\chris\source\repos\Cell\Cell\obj\Debug\net8.0-windows\Cell_kphxgwp3_wpftmp.AssemblyInfo.cs", "C#", 11, 0, 0, 0, 0, 10, 5, 26
"c:\Users\chris\source\repos\Cell\Cell\obj\Debug\net8.0-windows\Cell_kphxgwp3_wpftmp.GeneratedMSBuildEditorConfig.editorconfig", "Properties", 0, 0, 0, 0, 21, 0, 1, 22
"c:\Users\chris\source\repos\Cell\Cell\obj\Debug\net8.0-windows\Cell_kphxgwp3_wpftmp.GlobalUsings.g.cs", "C#", 5, 0, 0, 0, 0, 1, 1, 7
"c:\Users\chris\source\repos\Cell\Cell\obj\Debug\net8.0-windows\Cell_kphxgwp3_wpftmp.sourcelink.json", "JSON", 0, 0, 0, 1, 0, 0, 0, 1
"c:\Users\chris\source\repos\Cell\Cell\obj\Debug\net8.0-windows\Cell_kpjtm4vc_wpftmp.AssemblyInfo.cs", "C#", 11, 0, 0, 0, 0, 10, 5, 26
"c:\Users\chris\source\repos\Cell\Cell\obj\Debug\net8.0-windows\Cell_kpjtm4vc_wpftmp.GeneratedMSBuildEditorConfig.editorconfig", "Properties", 0, 0, 0, 0, 21, 0, 1, 22
"c:\Users\chris\source\repos\Cell\Cell\obj\Debug\net8.0-windows\Cell_kpjtm4vc_wpftmp.GlobalUsings.g.cs", "C#", 5, 0, 0, 0, 0, 1, 1, 7
"c:\Users\chris\source\repos\Cell\Cell\obj\Debug\net8.0-windows\Cell_kpjtm4vc_wpftmp.sourcelink.json", "JSON", 0, 0, 0, 1, 0, 0, 0, 1
"c:\Users\chris\source\repos\Cell\Cell\obj\Debug\net8.0-windows\Cell_kpskugc4_wpftmp.AssemblyInfo.cs", "C#", 11, 0, 0, 0, 0, 10, 5, 26
"c:\Users\chris\source\repos\Cell\Cell\obj\Debug\net8.0-windows\Cell_kpskugc4_wpftmp.GeneratedMSBuildEditorConfig.editorconfig", "Properties", 0, 0, 0, 0, 21, 0, 1, 22
"c:\Users\chris\source\repos\Cell\Cell\obj\Debug\net8.0-windows\Cell_kpskugc4_wpftmp.GlobalUsings.g.cs", "C#", 5, 0, 0, 0, 0, 1, 1, 7
"c:\Users\chris\source\repos\Cell\Cell\obj\Debug\net8.0-windows\Cell_kpskugc4_wpftmp.sourcelink.json", "JSON", 0, 0, 0, 1, 0, 0, 0, 1
"c:\Users\chris\source\repos\Cell\Cell\obj\Debug\net8.0-windows\Cell_kq4dx2x2_wpftmp.AssemblyInfo.cs", "C#", 11, 0, 0, 0, 0, 10, 5, 26
"c:\Users\chris\source\repos\Cell\Cell\obj\Debug\net8.0-windows\Cell_kq4dx2x2_wpftmp.GeneratedMSBuildEditorConfig.editorconfig", "Properties", 0, 0, 0, 0, 21, 0, 1, 22
"c:\Users\chris\source\repos\Cell\Cell\obj\Debug\net8.0-windows\Cell_kq4dx2x2_wpftmp.GlobalUsings.g.cs", "C#", 5, 0, 0, 0, 0, 1, 1, 7
"c:\Users\chris\source\repos\Cell\Cell\obj\Debug\net8.0-windows\Cell_kq4dx2x2_wpftmp.sourcelink.json", "JSON", 0, 0, 0, 1, 0, 0, 0, 1
"c:\Users\chris\source\repos\Cell\Cell\obj\Debug\net8.0-windows\Cell_ks5agsbt_wpftmp.AssemblyInfo.cs", "C#", 11, 0, 0, 0, 0, 10, 5, 26
"c:\Users\chris\source\repos\Cell\Cell\obj\Debug\net8.0-windows\Cell_ks5agsbt_wpftmp.GeneratedMSBuildEditorConfig.editorconfig", "Properties", 0, 0, 0, 0, 21, 0, 1, 22
"c:\Users\chris\source\repos\Cell\Cell\obj\Debug\net8.0-windows\Cell_ks5agsbt_wpftmp.GlobalUsings.g.cs", "C#", 5, 0, 0, 0, 0, 1, 1, 7
"c:\Users\chris\source\repos\Cell\Cell\obj\Debug\net8.0-windows\Cell_ks5agsbt_wpftmp.sourcelink.json", "JSON", 0, 0, 0, 1, 0, 0, 0, 1
"c:\Users\chris\source\repos\Cell\Cell\obj\Debug\net8.0-windows\Cell_ks5zep33_wpftmp.AssemblyInfo.cs", "C#", 11, 0, 0, 0, 0, 10, 5, 26
"c:\Users\chris\source\repos\Cell\Cell\obj\Debug\net8.0-windows\Cell_ks5zep33_wpftmp.GeneratedMSBuildEditorConfig.editorconfig", "Properties", 0, 0, 0, 0, 21, 0, 1, 22
"c:\Users\chris\source\repos\Cell\Cell\obj\Debug\net8.0-windows\Cell_ks5zep33_wpftmp.GlobalUsings.g.cs", "C#", 5, 0, 0, 0, 0, 1, 1, 7
"c:\Users\chris\source\repos\Cell\Cell\obj\Debug\net8.0-windows\Cell_ks5zep33_wpftmp.sourcelink.json", "JSON", 0, 0, 0, 1, 0, 0, 0, 1
"c:\Users\chris\source\repos\Cell\Cell\obj\Debug\net8.0-windows\Cell_kszqrfsw_wpftmp.AssemblyInfo.cs", "C#", 11, 0, 0, 0, 0, 10, 5, 26
"c:\Users\chris\source\repos\Cell\Cell\obj\Debug\net8.0-windows\Cell_kszqrfsw_wpftmp.GeneratedMSBuildEditorConfig.editorconfig", "Properties", 0, 0, 0, 0, 13, 0, 1, 14
"c:\Users\chris\source\repos\Cell\Cell\obj\Debug\net8.0-windows\Cell_kszqrfsw_wpftmp.GlobalUsings.g.cs", "C#", 5, 0, 0, 0, 0, 1, 1, 7
"c:\Users\chris\source\repos\Cell\Cell\obj\Debug\net8.0-windows\Cell_ktbepacm_wpftmp.AssemblyInfo.cs", "C#", 11, 0, 0, 0, 0, 10, 5, 26
"c:\Users\chris\source\repos\Cell\Cell\obj\Debug\net8.0-windows\Cell_ktbepacm_wpftmp.GeneratedMSBuildEditorConfig.editorconfig", "Properties", 0, 0, 0, 0, 13, 0, 1, 14
"c:\Users\chris\source\repos\Cell\Cell\obj\Debug\net8.0-windows\Cell_ktbepacm_wpftmp.GlobalUsings.g.cs", "C#", 5, 0, 0, 0, 0, 1, 1, 7
"c:\Users\chris\source\repos\Cell\Cell\obj\Debug\net8.0-windows\Cell_ktow5giy_wpftmp.AssemblyInfo.cs", "C#", 11, 0, 0, 0, 0, 10, 5, 26
"c:\Users\chris\source\repos\Cell\Cell\obj\Debug\net8.0-windows\Cell_ktow5giy_wpftmp.GeneratedMSBuildEditorConfig.editorconfig", "Properties", 0, 0, 0, 0, 13, 0, 1, 14
"c:\Users\chris\source\repos\Cell\Cell\obj\Debug\net8.0-windows\Cell_ktow5giy_wpftmp.GlobalUsings.g.cs", "C#", 5, 0, 0, 0, 0, 1, 1, 7
"c:\Users\chris\source\repos\Cell\Cell\obj\Debug\net8.0-windows\Cell_ku5cs1b0_wpftmp.AssemblyInfo.cs", "C#", 11, 0, 0, 0, 0, 10, 5, 26
"c:\Users\chris\source\repos\Cell\Cell\obj\Debug\net8.0-windows\Cell_ku5cs1b0_wpftmp.GeneratedMSBuildEditorConfig.editorconfig", "Properties", 0, 0, 0, 0, 21, 0, 1, 22
"c:\Users\chris\source\repos\Cell\Cell\obj\Debug\net8.0-windows\Cell_ku5cs1b0_wpftmp.GlobalUsings.g.cs", "C#", 5, 0, 0, 0, 0, 1, 1, 7
"c:\Users\chris\source\repos\Cell\Cell\obj\Debug\net8.0-windows\Cell_kujeva0e_wpftmp.AssemblyInfo.cs", "C#", 11, 0, 0, 0, 0, 10, 5, 26
"c:\Users\chris\source\repos\Cell\Cell\obj\Debug\net8.0-windows\Cell_kujeva0e_wpftmp.GeneratedMSBuildEditorConfig.editorconfig", "Properties", 0, 0, 0, 0, 21, 0, 1, 22
"c:\Users\chris\source\repos\Cell\Cell\obj\Debug\net8.0-windows\Cell_kujeva0e_wpftmp.GlobalUsings.g.cs", "C#", 5, 0, 0, 0, 0, 1, 1, 7
"c:\Users\chris\source\repos\Cell\Cell\obj\Debug\net8.0-windows\Cell_kujeva0e_wpftmp.sourcelink.json", "JSON", 0, 0, 0, 1, 0, 0, 0, 1
"c:\Users\chris\source\repos\Cell\Cell\obj\Debug\net8.0-windows\Cell_kvi2srw0_wpftmp.AssemblyInfo.cs", "C#", 11, 0, 0, 0, 0, 10, 5, 26
"c:\Users\chris\source\repos\Cell\Cell\obj\Debug\net8.0-windows\Cell_kvi2srw0_wpftmp.GeneratedMSBuildEditorConfig.editorconfig", "Properties", 0, 0, 0, 0, 21, 0, 1, 22
"c:\Users\chris\source\repos\Cell\Cell\obj\Debug\net8.0-windows\Cell_kvi2srw0_wpftmp.GlobalUsings.g.cs", "C#", 5, 0, 0, 0, 0, 1, 1, 7
"c:\Users\chris\source\repos\Cell\Cell\obj\Debug\net8.0-windows\Cell_kvi2srw0_wpftmp.sourcelink.json", "JSON", 0, 0, 0, 1, 0, 0, 0, 1
"c:\Users\chris\source\repos\Cell\Cell\obj\Debug\net8.0-windows\Cell_kvyfarwz_wpftmp.AssemblyInfo.cs", "C#", 11, 0, 0, 0, 0, 10, 5, 26
"c:\Users\chris\source\repos\Cell\Cell\obj\Debug\net8.0-windows\Cell_kvyfarwz_wpftmp.GeneratedMSBuildEditorConfig.editorconfig", "Properties", 0, 0, 0, 0, 21, 0, 1, 22
"c:\Users\chris\source\repos\Cell\Cell\obj\Debug\net8.0-windows\Cell_kvyfarwz_wpftmp.GlobalUsings.g.cs", "C#", 5, 0, 0, 0, 0, 1, 1, 7
"c:\Users\chris\source\repos\Cell\Cell\obj\Debug\net8.0-windows\Cell_kvyfarwz_wpftmp.sourcelink.json", "JSON", 0, 0, 0, 1, 0, 0, 0, 1
"c:\Users\chris\source\repos\Cell\Cell\obj\Debug\net8.0-windows\Cell_kwtto55k_wpftmp.AssemblyInfo.cs", "C#", 11, 0, 0, 0, 0, 10, 5, 26
"c:\Users\chris\source\repos\Cell\Cell\obj\Debug\net8.0-windows\Cell_kwtto55k_wpftmp.GeneratedMSBuildEditorConfig.editorconfig", "Properties", 0, 0, 0, 0, 21, 0, 1, 22
"c:\Users\chris\source\repos\Cell\Cell\obj\Debug\net8.0-windows\Cell_kwtto55k_wpftmp.GlobalUsings.g.cs", "C#", 5, 0, 0, 0, 0, 1, 1, 7
"c:\Users\chris\source\repos\Cell\Cell\obj\Debug\net8.0-windows\Cell_kwtto55k_wpftmp.sourcelink.json", "JSON", 0, 0, 0, 1, 0, 0, 0, 1
"c:\Users\chris\source\repos\Cell\Cell\obj\Debug\net8.0-windows\Cell_kwxsnc5x_wpftmp.AssemblyInfo.cs", "C#", 11, 0, 0, 0, 0, 10, 5, 26
"c:\Users\chris\source\repos\Cell\Cell\obj\Debug\net8.0-windows\Cell_kwxsnc5x_wpftmp.GeneratedMSBuildEditorConfig.editorconfig", "Properties", 0, 0, 0, 0, 21, 0, 1, 22
"c:\Users\chris\source\repos\Cell\Cell\obj\Debug\net8.0-windows\Cell_kwxsnc5x_wpftmp.GlobalUsings.g.cs", "C#", 5, 0, 0, 0, 0, 1, 1, 7
"c:\Users\chris\source\repos\Cell\Cell\obj\Debug\net8.0-windows\Cell_kwxsnc5x_wpftmp.sourcelink.json", "JSON", 0, 0, 0, 1, 0, 0, 0, 1
"c:\Users\chris\source\repos\Cell\Cell\obj\Debug\net8.0-windows\Cell_kx5osewn_wpftmp.AssemblyInfo.cs", "C#", 11, 0, 0, 0, 0, 10, 5, 26
"c:\Users\chris\source\repos\Cell\Cell\obj\Debug\net8.0-windows\Cell_kx5osewn_wpftmp.GeneratedMSBuildEditorConfig.editorconfig", "Properties", 0, 0, 0, 0, 21, 0, 1, 22
"c:\Users\chris\source\repos\Cell\Cell\obj\Debug\net8.0-windows\Cell_kx5osewn_wpftmp.GlobalUsings.g.cs", "C#", 5, 0, 0, 0, 0, 1, 1, 7
"c:\Users\chris\source\repos\Cell\Cell\obj\Debug\net8.0-windows\Cell_kx5osewn_wpftmp.sourcelink.json", "JSON", 0, 0, 0, 1, 0, 0, 0, 1
"c:\Users\chris\source\repos\Cell\Cell\obj\Debug\net8.0-windows\Cell_kxbzzw1z_wpftmp.AssemblyInfo.cs", "C#", 11, 0, 0, 0, 0, 10, 5, 26
"c:\Users\chris\source\repos\Cell\Cell\obj\Debug\net8.0-windows\Cell_kxbzzw1z_wpftmp.GeneratedMSBuildEditorConfig.editorconfig", "Properties", 0, 0, 0, 0, 21, 0, 1, 22
"c:\Users\chris\source\repos\Cell\Cell\obj\Debug\net8.0-windows\Cell_kxbzzw1z_wpftmp.GlobalUsings.g.cs", "C#", 5, 0, 0, 0, 0, 1, 1, 7
"c:\Users\chris\source\repos\Cell\Cell\obj\Debug\net8.0-windows\Cell_kxbzzw1z_wpftmp.sourcelink.json", "JSON", 0, 0, 0, 1, 0, 0, 0, 1
"c:\Users\chris\source\repos\Cell\Cell\obj\Debug\net8.0-windows\Cell_kxj4wsqn_wpftmp.AssemblyInfo.cs", "C#", 11, 0, 0, 0, 0, 10, 5, 26
"c:\Users\chris\source\repos\Cell\Cell\obj\Debug\net8.0-windows\Cell_kxj4wsqn_wpftmp.GeneratedMSBuildEditorConfig.editorconfig", "Properties", 0, 0, 0, 0, 21, 0, 1, 22
"c:\Users\chris\source\repos\Cell\Cell\obj\Debug\net8.0-windows\Cell_kxj4wsqn_wpftmp.GlobalUsings.g.cs", "C#", 5, 0, 0, 0, 0, 1, 1, 7
"c:\Users\chris\source\repos\Cell\Cell\obj\Debug\net8.0-windows\Cell_kxj4wsqn_wpftmp.sourcelink.json", "JSON", 0, 0, 0, 1, 0, 0, 0, 1
"c:\Users\chris\source\repos\Cell\Cell\obj\Debug\net8.0-windows\Cell_kxxqkpkz_wpftmp.AssemblyInfo.cs", "C#", 11, 0, 0, 0, 0, 10, 5, 26
"c:\Users\chris\source\repos\Cell\Cell\obj\Debug\net8.0-windows\Cell_kxxqkpkz_wpftmp.GeneratedMSBuildEditorConfig.editorconfig", "Properties", 0, 0, 0, 0, 21, 0, 1, 22
"c:\Users\chris\source\repos\Cell\Cell\obj\Debug\net8.0-windows\Cell_kxxqkpkz_wpftmp.GlobalUsings.g.cs", "C#", 5, 0, 0, 0, 0, 1, 1, 7
"c:\Users\chris\source\repos\Cell\Cell\obj\Debug\net8.0-windows\Cell_kxxqkpkz_wpftmp.sourcelink.json", "JSON", 0, 0, 0, 1, 0, 0, 0, 1
"c:\Users\chris\source\repos\Cell\Cell\obj\Debug\net8.0-windows\Cell_kz0x2ipr_wpftmp.AssemblyInfo.cs", "C#", 11, 0, 0, 0, 0, 10, 5, 26
"c:\Users\chris\source\repos\Cell\Cell\obj\Debug\net8.0-windows\Cell_kz0x2ipr_wpftmp.GeneratedMSBuildEditorConfig.editorconfig", "Properties", 0, 0, 0, 0, 21, 0, 1, 22
"c:\Users\chris\source\repos\Cell\Cell\obj\Debug\net8.0-windows\Cell_kz0x2ipr_wpftmp.GlobalUsings.g.cs", "C#", 5, 0, 0, 0, 0, 1, 1, 7
"c:\Users\chris\source\repos\Cell\Cell\obj\Debug\net8.0-windows\Cell_kz0x2ipr_wpftmp.sourcelink.json", "JSON", 0, 0, 0, 1, 0, 0, 0, 1
"c:\Users\chris\source\repos\Cell\Cell\obj\Debug\net8.0-windows\Cell_l0tt5usp_wpftmp.AssemblyInfo.cs", "C#", 11, 0, 0, 0, 0, 10, 5, 26
"c:\Users\chris\source\repos\Cell\Cell\obj\Debug\net8.0-windows\Cell_l0tt5usp_wpftmp.GeneratedMSBuildEditorConfig.editorconfig", "Properties", 0, 0, 0, 0, 21, 0, 1, 22
"c:\Users\chris\source\repos\Cell\Cell\obj\Debug\net8.0-windows\Cell_l0tt5usp_wpftmp.GlobalUsings.g.cs", "C#", 5, 0, 0, 0, 0, 1, 1, 7
"c:\Users\chris\source\repos\Cell\Cell\obj\Debug\net8.0-windows\Cell_l0tt5usp_wpftmp.sourcelink.json", "JSON", 0, 0, 0, 1, 0, 0, 0, 1
"c:\Users\chris\source\repos\Cell\Cell\obj\Debug\net8.0-windows\Cell_l0ubtnl5_wpftmp.AssemblyInfo.cs", "C#", 11, 0, 0, 0, 0, 10, 5, 26
"c:\Users\chris\source\repos\Cell\Cell\obj\Debug\net8.0-windows\Cell_l0ubtnl5_wpftmp.GeneratedMSBuildEditorConfig.editorconfig", "Properties", 0, 0, 0, 0, 21, 0, 1, 22
"c:\Users\chris\source\repos\Cell\Cell\obj\Debug\net8.0-windows\Cell_l0ubtnl5_wpftmp.GlobalUsings.g.cs", "C#", 5, 0, 0, 0, 0, 1, 1, 7
"c:\Users\chris\source\repos\Cell\Cell\obj\Debug\net8.0-windows\Cell_l0ubtnl5_wpftmp.sourcelink.json", "JSON", 0, 0, 0, 1, 0, 0, 0, 1
"c:\Users\chris\source\repos\Cell\Cell\obj\Debug\net8.0-windows\Cell_l1hgujpk_wpftmp.AssemblyInfo.cs", "C#", 11, 0, 0, 0, 0, 10, 5, 26
"c:\Users\chris\source\repos\Cell\Cell\obj\Debug\net8.0-windows\Cell_l1hgujpk_wpftmp.GeneratedMSBuildEditorConfig.editorconfig", "Properties", 0, 0, 0, 0, 13, 0, 1, 14
"c:\Users\chris\source\repos\Cell\Cell\obj\Debug\net8.0-windows\Cell_l1hgujpk_wpftmp.GlobalUsings.g.cs", "C#", 5, 0, 0, 0, 0, 1, 1, 7
"c:\Users\chris\source\repos\Cell\Cell\obj\Debug\net8.0-windows\Cell_l2z5jhwu_wpftmp.AssemblyInfo.cs", "C#", 11, 0, 0, 0, 0, 10, 5, 26
"c:\Users\chris\source\repos\Cell\Cell\obj\Debug\net8.0-windows\Cell_l2z5jhwu_wpftmp.GeneratedMSBuildEditorConfig.editorconfig", "Properties", 0, 0, 0, 0, 13, 0, 1, 14
"c:\Users\chris\source\repos\Cell\Cell\obj\Debug\net8.0-windows\Cell_l2z5jhwu_wpftmp.GlobalUsings.g.cs", "C#", 5, 0, 0, 0, 0, 1, 1, 7
"c:\Users\chris\source\repos\Cell\Cell\obj\Debug\net8.0-windows\Cell_l415rs1q_wpftmp.AssemblyInfo.cs", "C#", 11, 0, 0, 0, 0, 10, 5, 26
"c:\Users\chris\source\repos\Cell\Cell\obj\Debug\net8.0-windows\Cell_l415rs1q_wpftmp.GeneratedMSBuildEditorConfig.editorconfig", "Properties", 0, 0, 0, 0, 21, 0, 1, 22
"c:\Users\chris\source\repos\Cell\Cell\obj\Debug\net8.0-windows\Cell_l415rs1q_wpftmp.GlobalUsings.g.cs", "C#", 5, 0, 0, 0, 0, 1, 1, 7
"c:\Users\chris\source\repos\Cell\Cell\obj\Debug\net8.0-windows\Cell_l415rs1q_wpftmp.sourcelink.json", "JSON", 0, 0, 0, 1, 0, 0, 0, 1
"c:\Users\chris\source\repos\Cell\Cell\obj\Debug\net8.0-windows\Cell_l51om5bb_wpftmp.AssemblyInfo.cs", "C#", 11, 0, 0, 0, 0, 10, 5, 26
"c:\Users\chris\source\repos\Cell\Cell\obj\Debug\net8.0-windows\Cell_l51om5bb_wpftmp.GeneratedMSBuildEditorConfig.editorconfig", "Properties", 0, 0, 0, 0, 21, 0, 1, 22
"c:\Users\chris\source\repos\Cell\Cell\obj\Debug\net8.0-windows\Cell_l51om5bb_wpftmp.GlobalUsings.g.cs", "C#", 5, 0, 0, 0, 0, 1, 1, 7
"c:\Users\chris\source\repos\Cell\Cell\obj\Debug\net8.0-windows\Cell_l51om5bb_wpftmp.sourcelink.json", "JSON", 0, 0, 0, 1, 0, 0, 0, 1
"c:\Users\chris\source\repos\Cell\Cell\obj\Debug\net8.0-windows\Cell_l5fwtnu0_wpftmp.AssemblyInfo.cs", "C#", 11, 0, 0, 0, 0, 10, 5, 26
"c:\Users\chris\source\repos\Cell\Cell\obj\Debug\net8.0-windows\Cell_l5fwtnu0_wpftmp.GeneratedMSBuildEditorConfig.editorconfig", "Properties", 0, 0, 0, 0, 13, 0, 1, 14
"c:\Users\chris\source\repos\Cell\Cell\obj\Debug\net8.0-windows\Cell_l5fwtnu0_wpftmp.GlobalUsings.g.cs", "C#", 5, 0, 0, 0, 0, 1, 1, 7
"c:\Users\chris\source\repos\Cell\Cell\obj\Debug\net8.0-windows\Cell_la2n4ijl_wpftmp.AssemblyInfo.cs", "C#", 11, 0, 0, 0, 0, 10, 5, 26
"c:\Users\chris\source\repos\Cell\Cell\obj\Debug\net8.0-windows\Cell_la2n4ijl_wpftmp.GeneratedMSBuildEditorConfig.editorconfig", "Properties", 0, 0, 0, 0, 21, 0, 1, 22
"c:\Users\chris\source\repos\Cell\Cell\obj\Debug\net8.0-windows\Cell_la2n4ijl_wpftmp.GlobalUsings.g.cs", "C#", 5, 0, 0, 0, 0, 1, 1, 7
"c:\Users\chris\source\repos\Cell\Cell\obj\Debug\net8.0-windows\Cell_la2n4ijl_wpftmp.sourcelink.json", "JSON", 0, 0, 0, 1, 0, 0, 0, 1
"c:\Users\chris\source\repos\Cell\Cell\obj\Debug\net8.0-windows\Cell_lbtl0zbv_wpftmp.AssemblyInfo.cs", "C#", 11, 0, 0, 0, 0, 10, 5, 26
"c:\Users\chris\source\repos\Cell\Cell\obj\Debug\net8.0-windows\Cell_lbtl0zbv_wpftmp.GeneratedMSBuildEditorConfig.editorconfig", "Properties", 0, 0, 0, 0, 21, 0, 1, 22
"c:\Users\chris\source\repos\Cell\Cell\obj\Debug\net8.0-windows\Cell_lbtl0zbv_wpftmp.GlobalUsings.g.cs", "C#", 5, 0, 0, 0, 0, 1, 1, 7
"c:\Users\chris\source\repos\Cell\Cell\obj\Debug\net8.0-windows\Cell_lbtl0zbv_wpftmp.sourcelink.json", "JSON", 0, 0, 0, 1, 0, 0, 0, 1
"c:\Users\chris\source\repos\Cell\Cell\obj\Debug\net8.0-windows\Cell_lcfs5hxe_wpftmp.AssemblyInfo.cs", "C#", 11, 0, 0, 0, 0, 10, 5, 26
"c:\Users\chris\source\repos\Cell\Cell\obj\Debug\net8.0-windows\Cell_lcfs5hxe_wpftmp.GeneratedMSBuildEditorConfig.editorconfig", "Properties", 0, 0, 0, 0, 21, 0, 1, 22
"c:\Users\chris\source\repos\Cell\Cell\obj\Debug\net8.0-windows\Cell_lcfs5hxe_wpftmp.GlobalUsings.g.cs", "C#", 5, 0, 0, 0, 0, 1, 1, 7
"c:\Users\chris\source\repos\Cell\Cell\obj\Debug\net8.0-windows\Cell_lcfs5hxe_wpftmp.sourcelink.json", "JSON", 0, 0, 0, 1, 0, 0, 0, 1
"c:\Users\chris\source\repos\Cell\Cell\obj\Debug\net8.0-windows\Cell_lczhuwaf_wpftmp.AssemblyInfo.cs", "C#", 11, 0, 0, 0, 0, 10, 5, 26
"c:\Users\chris\source\repos\Cell\Cell\obj\Debug\net8.0-windows\Cell_lczhuwaf_wpftmp.GeneratedMSBuildEditorConfig.editorconfig", "Properties", 0, 0, 0, 0, 21, 0, 1, 22
"c:\Users\chris\source\repos\Cell\Cell\obj\Debug\net8.0-windows\Cell_lczhuwaf_wpftmp.GlobalUsings.g.cs", "C#", 5, 0, 0, 0, 0, 1, 1, 7
"c:\Users\chris\source\repos\Cell\Cell\obj\Debug\net8.0-windows\Cell_lczhuwaf_wpftmp.sourcelink.json", "JSON", 0, 0, 0, 1, 0, 0, 0, 1
"c:\Users\chris\source\repos\Cell\Cell\obj\Debug\net8.0-windows\Cell_le1az4tf_wpftmp.AssemblyInfo.cs", "C#", 11, 0, 0, 0, 0, 10, 5, 26
"c:\Users\chris\source\repos\Cell\Cell\obj\Debug\net8.0-windows\Cell_le1az4tf_wpftmp.GeneratedMSBuildEditorConfig.editorconfig", "Properties", 0, 0, 0, 0, 21, 0, 1, 22
"c:\Users\chris\source\repos\Cell\Cell\obj\Debug\net8.0-windows\Cell_le1az4tf_wpftmp.GlobalUsings.g.cs", "C#", 5, 0, 0, 0, 0, 1, 1, 7
"c:\Users\chris\source\repos\Cell\Cell\obj\Debug\net8.0-windows\Cell_le1az4tf_wpftmp.sourcelink.json", "JSON", 0, 0, 0, 1, 0, 0, 0, 1
"c:\Users\chris\source\repos\Cell\Cell\obj\Debug\net8.0-windows\Cell_le1biwoy_wpftmp.AssemblyInfo.cs", "C#", 11, 0, 0, 0, 0, 10, 5, 26
"c:\Users\chris\source\repos\Cell\Cell\obj\Debug\net8.0-windows\Cell_le1biwoy_wpftmp.GeneratedMSBuildEditorConfig.editorconfig", "Properties", 0, 0, 0, 0, 21, 0, 1, 22
"c:\Users\chris\source\repos\Cell\Cell\obj\Debug\net8.0-windows\Cell_le1biwoy_wpftmp.GlobalUsings.g.cs", "C#", 5, 0, 0, 0, 0, 1, 1, 7
"c:\Users\chris\source\repos\Cell\Cell\obj\Debug\net8.0-windows\Cell_le1biwoy_wpftmp.sourcelink.json", "JSON", 0, 0, 0, 1, 0, 0, 0, 1
"c:\Users\chris\source\repos\Cell\Cell\obj\Debug\net8.0-windows\Cell_leowz5eh_wpftmp.AssemblyInfo.cs", "C#", 11, 0, 0, 0, 0, 10, 5, 26
"c:\Users\chris\source\repos\Cell\Cell\obj\Debug\net8.0-windows\Cell_leowz5eh_wpftmp.GeneratedMSBuildEditorConfig.editorconfig", "Properties", 0, 0, 0, 0, 21, 0, 1, 22
"c:\Users\chris\source\repos\Cell\Cell\obj\Debug\net8.0-windows\Cell_leowz5eh_wpftmp.GlobalUsings.g.cs", "C#", 5, 0, 0, 0, 0, 1, 1, 7
"c:\Users\chris\source\repos\Cell\Cell\obj\Debug\net8.0-windows\Cell_leowz5eh_wpftmp.sourcelink.json", "JSON", 0, 0, 0, 1, 0, 0, 0, 1
"c:\Users\chris\source\repos\Cell\Cell\obj\Debug\net8.0-windows\Cell_lgot2myk_wpftmp.AssemblyInfo.cs", "C#", 11, 0, 0, 0, 0, 10, 5, 26
"c:\Users\chris\source\repos\Cell\Cell\obj\Debug\net8.0-windows\Cell_lgot2myk_wpftmp.GeneratedMSBuildEditorConfig.editorconfig", "Properties", 0, 0, 0, 0, 21, 0, 1, 22
"c:\Users\chris\source\repos\Cell\Cell\obj\Debug\net8.0-windows\Cell_lgot2myk_wpftmp.GlobalUsings.g.cs", "C#", 5, 0, 0, 0, 0, 1, 1, 7
"c:\Users\chris\source\repos\Cell\Cell\obj\Debug\net8.0-windows\Cell_lgot2myk_wpftmp.sourcelink.json", "JSON", 0, 0, 0, 1, 0, 0, 0, 1
"c:\Users\chris\source\repos\Cell\Cell\obj\Debug\net8.0-windows\Cell_li54csfg_wpftmp.AssemblyInfo.cs", "C#", 11, 0, 0, 0, 0, 10, 5, 26
"c:\Users\chris\source\repos\Cell\Cell\obj\Debug\net8.0-windows\Cell_li54csfg_wpftmp.GeneratedMSBuildEditorConfig.editorconfig", "Properties", 0, 0, 0, 0, 21, 0, 1, 22
"c:\Users\chris\source\repos\Cell\Cell\obj\Debug\net8.0-windows\Cell_li54csfg_wpftmp.GlobalUsings.g.cs", "C#", 5, 0, 0, 0, 0, 1, 1, 7
"c:\Users\chris\source\repos\Cell\Cell\obj\Debug\net8.0-windows\Cell_li54csfg_wpftmp.sourcelink.json", "JSON", 0, 0, 0, 1, 0, 0, 0, 1
"c:\Users\chris\source\repos\Cell\Cell\obj\Debug\net8.0-windows\Cell_lijxjiye_wpftmp.AssemblyInfo.cs", "C#", 11, 0, 0, 0, 0, 10, 5, 26
"c:\Users\chris\source\repos\Cell\Cell\obj\Debug\net8.0-windows\Cell_lijxjiye_wpftmp.GeneratedMSBuildEditorConfig.editorconfig", "Properties", 0, 0, 0, 0, 21, 0, 1, 22
"c:\Users\chris\source\repos\Cell\Cell\obj\Debug\net8.0-windows\Cell_lijxjiye_wpftmp.GlobalUsings.g.cs", "C#", 5, 0, 0, 0, 0, 1, 1, 7
"c:\Users\chris\source\repos\Cell\Cell\obj\Debug\net8.0-windows\Cell_lijxjiye_wpftmp.sourcelink.json", "JSON", 0, 0, 0, 1, 0, 0, 0, 1
"c:\Users\chris\source\repos\Cell\Cell\obj\Debug\net8.0-windows\Cell_ljkuvy3s_wpftmp.AssemblyInfo.cs", "C#", 11, 0, 0, 0, 0, 10, 5, 26
"c:\Users\chris\source\repos\Cell\Cell\obj\Debug\net8.0-windows\Cell_ljkuvy3s_wpftmp.GeneratedMSBuildEditorConfig.editorconfig", "Properties", 0, 0, 0, 0, 21, 0, 1, 22
"c:\Users\chris\source\repos\Cell\Cell\obj\Debug\net8.0-windows\Cell_ljkuvy3s_wpftmp.GlobalUsings.g.cs", "C#", 5, 0, 0, 0, 0, 1, 1, 7
"c:\Users\chris\source\repos\Cell\Cell\obj\Debug\net8.0-windows\Cell_ljkuvy3s_wpftmp.sourcelink.json", "JSON", 0, 0, 0, 1, 0, 0, 0, 1
"c:\Users\chris\source\repos\Cell\Cell\obj\Debug\net8.0-windows\Cell_ljnei3g1_wpftmp.AssemblyInfo.cs", "C#", 11, 0, 0, 0, 0, 10, 5, 26
"c:\Users\chris\source\repos\Cell\Cell\obj\Debug\net8.0-windows\Cell_ljnei3g1_wpftmp.GeneratedMSBuildEditorConfig.editorconfig", "Properties", 0, 0, 0, 0, 21, 0, 1, 22
"c:\Users\chris\source\repos\Cell\Cell\obj\Debug\net8.0-windows\Cell_ljnei3g1_wpftmp.GlobalUsings.g.cs", "C#", 5, 0, 0, 0, 0, 1, 1, 7
"c:\Users\chris\source\repos\Cell\Cell\obj\Debug\net8.0-windows\Cell_ljnei3g1_wpftmp.sourcelink.json", "JSON", 0, 0, 0, 1, 0, 0, 0, 1
"c:\Users\chris\source\repos\Cell\Cell\obj\Debug\net8.0-windows\Cell_ljwqe4vl_wpftmp.AssemblyInfo.cs", "C#", 11, 0, 0, 0, 0, 10, 5, 26
"c:\Users\chris\source\repos\Cell\Cell\obj\Debug\net8.0-windows\Cell_ljwqe4vl_wpftmp.GeneratedMSBuildEditorConfig.editorconfig", "Properties", 0, 0, 0, 0, 21, 0, 1, 22
"c:\Users\chris\source\repos\Cell\Cell\obj\Debug\net8.0-windows\Cell_ljwqe4vl_wpftmp.GlobalUsings.g.cs", "C#", 5, 0, 0, 0, 0, 1, 1, 7
"c:\Users\chris\source\repos\Cell\Cell\obj\Debug\net8.0-windows\Cell_ljwqe4vl_wpftmp.sourcelink.json", "JSON", 0, 0, 0, 1, 0, 0, 0, 1
"c:\Users\chris\source\repos\Cell\Cell\obj\Debug\net8.0-windows\Cell_lk50zlrz_wpftmp.AssemblyInfo.cs", "C#", 11, 0, 0, 0, 0, 10, 5, 26
"c:\Users\chris\source\repos\Cell\Cell\obj\Debug\net8.0-windows\Cell_lk50zlrz_wpftmp.GeneratedMSBuildEditorConfig.editorconfig", "Properties", 0, 0, 0, 0, 21, 0, 1, 22
"c:\Users\chris\source\repos\Cell\Cell\obj\Debug\net8.0-windows\Cell_lk50zlrz_wpftmp.GlobalUsings.g.cs", "C#", 5, 0, 0, 0, 0, 1, 1, 7
"c:\Users\chris\source\repos\Cell\Cell\obj\Debug\net8.0-windows\Cell_lk50zlrz_wpftmp.sourcelink.json", "JSON", 0, 0, 0, 1, 0, 0, 0, 1
"c:\Users\chris\source\repos\Cell\Cell\obj\Debug\net8.0-windows\Cell_lk5e40og_wpftmp.AssemblyInfo.cs", "C#", 11, 0, 0, 0, 0, 10, 5, 26
"c:\Users\chris\source\repos\Cell\Cell\obj\Debug\net8.0-windows\Cell_lk5e40og_wpftmp.GeneratedMSBuildEditorConfig.editorconfig", "Properties", 0, 0, 0, 0, 21, 0, 1, 22
"c:\Users\chris\source\repos\Cell\Cell\obj\Debug\net8.0-windows\Cell_lk5e40og_wpftmp.GlobalUsings.g.cs", "C#", 5, 0, 0, 0, 0, 1, 1, 7
"c:\Users\chris\source\repos\Cell\Cell\obj\Debug\net8.0-windows\Cell_lk5e40og_wpftmp.sourcelink.json", "JSON", 0, 0, 0, 1, 0, 0, 0, 1
"c:\Users\chris\source\repos\Cell\Cell\obj\Debug\net8.0-windows\Cell_lkdvikye_wpftmp.AssemblyInfo.cs", "C#", 11, 0, 0, 0, 0, 10, 5, 26
"c:\Users\chris\source\repos\Cell\Cell\obj\Debug\net8.0-windows\Cell_lkdvikye_wpftmp.GeneratedMSBuildEditorConfig.editorconfig", "Properties", 0, 0, 0, 0, 21, 0, 1, 22
"c:\Users\chris\source\repos\Cell\Cell\obj\Debug\net8.0-windows\Cell_lkdvikye_wpftmp.GlobalUsings.g.cs", "C#", 5, 0, 0, 0, 0, 1, 1, 7
"c:\Users\chris\source\repos\Cell\Cell\obj\Debug\net8.0-windows\Cell_lkdvikye_wpftmp.sourcelink.json", "JSON", 0, 0, 0, 1, 0, 0, 0, 1
"c:\Users\chris\source\repos\Cell\Cell\obj\Debug\net8.0-windows\Cell_ll15oyo5_wpftmp.AssemblyInfo.cs", "C#", 11, 0, 0, 0, 0, 10, 5, 26
"c:\Users\chris\source\repos\Cell\Cell\obj\Debug\net8.0-windows\Cell_ll15oyo5_wpftmp.GeneratedMSBuildEditorConfig.editorconfig", "Properties", 0, 0, 0, 0, 21, 0, 1, 22
"c:\Users\chris\source\repos\Cell\Cell\obj\Debug\net8.0-windows\Cell_ll15oyo5_wpftmp.GlobalUsings.g.cs", "C#", 5, 0, 0, 0, 0, 1, 1, 7
"c:\Users\chris\source\repos\Cell\Cell\obj\Debug\net8.0-windows\Cell_ll15oyo5_wpftmp.sourcelink.json", "JSON", 0, 0, 0, 1, 0, 0, 0, 1
"c:\Users\chris\source\repos\Cell\Cell\obj\Debug\net8.0-windows\Cell_llrnmjtn_wpftmp.AssemblyInfo.cs", "C#", 11, 0, 0, 0, 0, 10, 5, 26
"c:\Users\chris\source\repos\Cell\Cell\obj\Debug\net8.0-windows\Cell_llrnmjtn_wpftmp.GeneratedMSBuildEditorConfig.editorconfig", "Properties", 0, 0, 0, 0, 21, 0, 1, 22
"c:\Users\chris\source\repos\Cell\Cell\obj\Debug\net8.0-windows\Cell_llrnmjtn_wpftmp.GlobalUsings.g.cs", "C#", 5, 0, 0, 0, 0, 1, 1, 7
"c:\Users\chris\source\repos\Cell\Cell\obj\Debug\net8.0-windows\Cell_llrnmjtn_wpftmp.sourcelink.json", "JSON", 0, 0, 0, 1, 0, 0, 0, 1
"c:\Users\chris\source\repos\Cell\Cell\obj\Debug\net8.0-windows\Cell_lltemn0h_wpftmp.AssemblyInfo.cs", "C#", 11, 0, 0, 0, 0, 10, 5, 26
"c:\Users\chris\source\repos\Cell\Cell\obj\Debug\net8.0-windows\Cell_lltemn0h_wpftmp.GeneratedMSBuildEditorConfig.editorconfig", "Properties", 0, 0, 0, 0, 21, 0, 1, 22
"c:\Users\chris\source\repos\Cell\Cell\obj\Debug\net8.0-windows\Cell_lltemn0h_wpftmp.GlobalUsings.g.cs", "C#", 5, 0, 0, 0, 0, 1, 1, 7
"c:\Users\chris\source\repos\Cell\Cell\obj\Debug\net8.0-windows\Cell_lltemn0h_wpftmp.sourcelink.json", "JSON", 0, 0, 0, 1, 0, 0, 0, 1
"c:\Users\chris\source\repos\Cell\Cell\obj\Debug\net8.0-windows\Cell_llwchcws_wpftmp.AssemblyInfo.cs", "C#", 11, 0, 0, 0, 0, 10, 5, 26
"c:\Users\chris\source\repos\Cell\Cell\obj\Debug\net8.0-windows\Cell_llwchcws_wpftmp.GeneratedMSBuildEditorConfig.editorconfig", "Properties", 0, 0, 0, 0, 21, 0, 1, 22
"c:\Users\chris\source\repos\Cell\Cell\obj\Debug\net8.0-windows\Cell_llwchcws_wpftmp.GlobalUsings.g.cs", "C#", 5, 0, 0, 0, 0, 1, 1, 7
"c:\Users\chris\source\repos\Cell\Cell\obj\Debug\net8.0-windows\Cell_llwchcws_wpftmp.sourcelink.json", "JSON", 0, 0, 0, 1, 0, 0, 0, 1
"c:\Users\chris\source\repos\Cell\Cell\obj\Debug\net8.0-windows\Cell_llypnbc3_wpftmp.AssemblyInfo.cs", "C#", 11, 0, 0, 0, 0, 10, 5, 26
"c:\Users\chris\source\repos\Cell\Cell\obj\Debug\net8.0-windows\Cell_llypnbc3_wpftmp.GeneratedMSBuildEditorConfig.editorconfig", "Properties", 0, 0, 0, 0, 21, 0, 1, 22
"c:\Users\chris\source\repos\Cell\Cell\obj\Debug\net8.0-windows\Cell_llypnbc3_wpftmp.GlobalUsings.g.cs", "C#", 5, 0, 0, 0, 0, 1, 1, 7
"c:\Users\chris\source\repos\Cell\Cell\obj\Debug\net8.0-windows\Cell_llypnbc3_wpftmp.sourcelink.json", "JSON", 0, 0, 0, 1, 0, 0, 0, 1
"c:\Users\chris\source\repos\Cell\Cell\obj\Debug\net8.0-windows\Cell_lm23cx2s_wpftmp.AssemblyInfo.cs", "C#", 11, 0, 0, 0, 0, 10, 5, 26
"c:\Users\chris\source\repos\Cell\Cell\obj\Debug\net8.0-windows\Cell_lm23cx2s_wpftmp.GeneratedMSBuildEditorConfig.editorconfig", "Properties", 0, 0, 0, 0, 13, 0, 1, 14
"c:\Users\chris\source\repos\Cell\Cell\obj\Debug\net8.0-windows\Cell_lm23cx2s_wpftmp.GlobalUsings.g.cs", "C#", 5, 0, 0, 0, 0, 1, 1, 7
"c:\Users\chris\source\repos\Cell\Cell\obj\Debug\net8.0-windows\Cell_lmgabspn_wpftmp.AssemblyInfo.cs", "C#", 11, 0, 0, 0, 0, 10, 5, 26
"c:\Users\chris\source\repos\Cell\Cell\obj\Debug\net8.0-windows\Cell_lmgabspn_wpftmp.GeneratedMSBuildEditorConfig.editorconfig", "Properties", 0, 0, 0, 0, 21, 0, 1, 22
"c:\Users\chris\source\repos\Cell\Cell\obj\Debug\net8.0-windows\Cell_lmgabspn_wpftmp.GlobalUsings.g.cs", "C#", 5, 0, 0, 0, 0, 1, 1, 7
"c:\Users\chris\source\repos\Cell\Cell\obj\Debug\net8.0-windows\Cell_lmgabspn_wpftmp.sourcelink.json", "JSON", 0, 0, 0, 1, 0, 0, 0, 1
"c:\Users\chris\source\repos\Cell\Cell\obj\Debug\net8.0-windows\Cell_lmk1gnay_wpftmp.AssemblyInfo.cs", "C#", 11, 0, 0, 0, 0, 10, 5, 26
"c:\Users\chris\source\repos\Cell\Cell\obj\Debug\net8.0-windows\Cell_lmk1gnay_wpftmp.GeneratedMSBuildEditorConfig.editorconfig", "Properties", 0, 0, 0, 0, 13, 0, 1, 14
"c:\Users\chris\source\repos\Cell\Cell\obj\Debug\net8.0-windows\Cell_lmk1gnay_wpftmp.GlobalUsings.g.cs", "C#", 5, 0, 0, 0, 0, 1, 1, 7
"c:\Users\chris\source\repos\Cell\Cell\obj\Debug\net8.0-windows\Cell_lo0fpsgl_wpftmp.AssemblyInfo.cs", "C#", 11, 0, 0, 0, 0, 10, 5, 26
"c:\Users\chris\source\repos\Cell\Cell\obj\Debug\net8.0-windows\Cell_lo0fpsgl_wpftmp.GeneratedMSBuildEditorConfig.editorconfig", "Properties", 0, 0, 0, 0, 13, 0, 1, 14
"c:\Users\chris\source\repos\Cell\Cell\obj\Debug\net8.0-windows\Cell_lo0fpsgl_wpftmp.GlobalUsings.g.cs", "C#", 5, 0, 0, 0, 0, 1, 1, 7
"c:\Users\chris\source\repos\Cell\Cell\obj\Debug\net8.0-windows\Cell_loauuuz0_wpftmp.AssemblyInfo.cs", "C#", 11, 0, 0, 0, 0, 10, 5, 26
"c:\Users\chris\source\repos\Cell\Cell\obj\Debug\net8.0-windows\Cell_loauuuz0_wpftmp.GeneratedMSBuildEditorConfig.editorconfig", "Properties", 0, 0, 0, 0, 21, 0, 1, 22
"c:\Users\chris\source\repos\Cell\Cell\obj\Debug\net8.0-windows\Cell_loauuuz0_wpftmp.GlobalUsings.g.cs", "C#", 5, 0, 0, 0, 0, 1, 1, 7
"c:\Users\chris\source\repos\Cell\Cell\obj\Debug\net8.0-windows\Cell_loauuuz0_wpftmp.sourcelink.json", "JSON", 0, 0, 0, 1, 0, 0, 0, 1
"c:\Users\chris\source\repos\Cell\Cell\obj\Debug\net8.0-windows\Cell_loceapoe_wpftmp.AssemblyInfo.cs", "C#", 11, 0, 0, 0, 0, 10, 5, 26
"c:\Users\chris\source\repos\Cell\Cell\obj\Debug\net8.0-windows\Cell_loceapoe_wpftmp.GeneratedMSBuildEditorConfig.editorconfig", "Properties", 0, 0, 0, 0, 21, 0, 1, 22
"c:\Users\chris\source\repos\Cell\Cell\obj\Debug\net8.0-windows\Cell_loceapoe_wpftmp.GlobalUsings.g.cs", "C#", 5, 0, 0, 0, 0, 1, 1, 7
"c:\Users\chris\source\repos\Cell\Cell\obj\Debug\net8.0-windows\Cell_loceapoe_wpftmp.sourcelink.json", "JSON", 0, 0, 0, 1, 0, 0, 0, 1
"c:\Users\chris\source\repos\Cell\Cell\obj\Debug\net8.0-windows\Cell_lolp5trj_wpftmp.AssemblyInfo.cs", "C#", 11, 0, 0, 0, 0, 10, 5, 26
"c:\Users\chris\source\repos\Cell\Cell\obj\Debug\net8.0-windows\Cell_lolp5trj_wpftmp.GeneratedMSBuildEditorConfig.editorconfig", "Properties", 0, 0, 0, 0, 21, 0, 1, 22
"c:\Users\chris\source\repos\Cell\Cell\obj\Debug\net8.0-windows\Cell_lolp5trj_wpftmp.GlobalUsings.g.cs", "C#", 5, 0, 0, 0, 0, 1, 1, 7
"c:\Users\chris\source\repos\Cell\Cell\obj\Debug\net8.0-windows\Cell_lolp5trj_wpftmp.sourcelink.json", "JSON", 0, 0, 0, 1, 0, 0, 0, 1
"c:\Users\chris\source\repos\Cell\Cell\obj\Debug\net8.0-windows\Cell_lqeh3wbe_wpftmp.AssemblyInfo.cs", "C#", 11, 0, 0, 0, 0, 10, 5, 26
"c:\Users\chris\source\repos\Cell\Cell\obj\Debug\net8.0-windows\Cell_lqeh3wbe_wpftmp.GeneratedMSBuildEditorConfig.editorconfig", "Properties", 0, 0, 0, 0, 13, 0, 1, 14
"c:\Users\chris\source\repos\Cell\Cell\obj\Debug\net8.0-windows\Cell_lqeh3wbe_wpftmp.GlobalUsings.g.cs", "C#", 5, 0, 0, 0, 0, 1, 1, 7
"c:\Users\chris\source\repos\Cell\Cell\obj\Debug\net8.0-windows\Cell_lqeshkye_wpftmp.AssemblyInfo.cs", "C#", 11, 0, 0, 0, 0, 10, 5, 26
"c:\Users\chris\source\repos\Cell\Cell\obj\Debug\net8.0-windows\Cell_lqeshkye_wpftmp.GeneratedMSBuildEditorConfig.editorconfig", "Properties", 0, 0, 0, 0, 21, 0, 1, 22
"c:\Users\chris\source\repos\Cell\Cell\obj\Debug\net8.0-windows\Cell_lqeshkye_wpftmp.GlobalUsings.g.cs", "C#", 5, 0, 0, 0, 0, 1, 1, 7
"c:\Users\chris\source\repos\Cell\Cell\obj\Debug\net8.0-windows\Cell_lqeshkye_wpftmp.sourcelink.json", "JSON", 0, 0, 0, 1, 0, 0, 0, 1
"c:\Users\chris\source\repos\Cell\Cell\obj\Debug\net8.0-windows\Cell_lrjapzu4_wpftmp.AssemblyInfo.cs", "C#", 11, 0, 0, 0, 0, 10, 5, 26
"c:\Users\chris\source\repos\Cell\Cell\obj\Debug\net8.0-windows\Cell_lrjapzu4_wpftmp.GeneratedMSBuildEditorConfig.editorconfig", "Properties", 0, 0, 0, 0, 21, 0, 1, 22
"c:\Users\chris\source\repos\Cell\Cell\obj\Debug\net8.0-windows\Cell_lrjapzu4_wpftmp.GlobalUsings.g.cs", "C#", 5, 0, 0, 0, 0, 1, 1, 7
"c:\Users\chris\source\repos\Cell\Cell\obj\Debug\net8.0-windows\Cell_lrjapzu4_wpftmp.sourcelink.json", "JSON", 0, 0, 0, 1, 0, 0, 0, 1
"c:\Users\chris\source\repos\Cell\Cell\obj\Debug\net8.0-windows\Cell_lseaiibo_wpftmp.AssemblyInfo.cs", "C#", 11, 0, 0, 0, 0, 10, 5, 26
"c:\Users\chris\source\repos\Cell\Cell\obj\Debug\net8.0-windows\Cell_lseaiibo_wpftmp.GeneratedMSBuildEditorConfig.editorconfig", "Properties", 0, 0, 0, 0, 21, 0, 1, 22
"c:\Users\chris\source\repos\Cell\Cell\obj\Debug\net8.0-windows\Cell_lseaiibo_wpftmp.GlobalUsings.g.cs", "C#", 5, 0, 0, 0, 0, 1, 1, 7
"c:\Users\chris\source\repos\Cell\Cell\obj\Debug\net8.0-windows\Cell_lseaiibo_wpftmp.sourcelink.json", "JSON", 0, 0, 0, 1, 0, 0, 0, 1
"c:\Users\chris\source\repos\Cell\Cell\obj\Debug\net8.0-windows\Cell_ltb3xfoj_wpftmp.AssemblyInfo.cs", "C#", 11, 0, 0, 0, 0, 10, 5, 26
"c:\Users\chris\source\repos\Cell\Cell\obj\Debug\net8.0-windows\Cell_ltb3xfoj_wpftmp.GeneratedMSBuildEditorConfig.editorconfig", "Properties", 0, 0, 0, 0, 21, 0, 1, 22
"c:\Users\chris\source\repos\Cell\Cell\obj\Debug\net8.0-windows\Cell_ltb3xfoj_wpftmp.GlobalUsings.g.cs", "C#", 5, 0, 0, 0, 0, 1, 1, 7
"c:\Users\chris\source\repos\Cell\Cell\obj\Debug\net8.0-windows\Cell_ltb3xfoj_wpftmp.sourcelink.json", "JSON", 0, 0, 0, 1, 0, 0, 0, 1
"c:\Users\chris\source\repos\Cell\Cell\obj\Debug\net8.0-windows\Cell_luaq2zkf_wpftmp.AssemblyInfo.cs", "C#", 11, 0, 0, 0, 0, 10, 5, 26
"c:\Users\chris\source\repos\Cell\Cell\obj\Debug\net8.0-windows\Cell_luaq2zkf_wpftmp.GeneratedMSBuildEditorConfig.editorconfig", "Properties", 0, 0, 0, 0, 21, 0, 1, 22
"c:\Users\chris\source\repos\Cell\Cell\obj\Debug\net8.0-windows\Cell_luaq2zkf_wpftmp.GlobalUsings.g.cs", "C#", 5, 0, 0, 0, 0, 1, 1, 7
"c:\Users\chris\source\repos\Cell\Cell\obj\Debug\net8.0-windows\Cell_luaq2zkf_wpftmp.sourcelink.json", "JSON", 0, 0, 0, 1, 0, 0, 0, 1
"c:\Users\chris\source\repos\Cell\Cell\obj\Debug\net8.0-windows\Cell_lv2poni2_wpftmp.AssemblyInfo.cs", "C#", 11, 0, 0, 0, 0, 10, 5, 26
"c:\Users\chris\source\repos\Cell\Cell\obj\Debug\net8.0-windows\Cell_lv2poni2_wpftmp.GeneratedMSBuildEditorConfig.editorconfig", "Properties", 0, 0, 0, 0, 21, 0, 1, 22
"c:\Users\chris\source\repos\Cell\Cell\obj\Debug\net8.0-windows\Cell_lv2poni2_wpftmp.GlobalUsings.g.cs", "C#", 5, 0, 0, 0, 0, 1, 1, 7
"c:\Users\chris\source\repos\Cell\Cell\obj\Debug\net8.0-windows\Cell_lv2poni2_wpftmp.sourcelink.json", "JSON", 0, 0, 0, 1, 0, 0, 0, 1
"c:\Users\chris\source\repos\Cell\Cell\obj\Debug\net8.0-windows\Cell_lv31o55g_wpftmp.AssemblyInfo.cs", "C#", 11, 0, 0, 0, 0, 10, 5, 26
"c:\Users\chris\source\repos\Cell\Cell\obj\Debug\net8.0-windows\Cell_lv31o55g_wpftmp.GeneratedMSBuildEditorConfig.editorconfig", "Properties", 0, 0, 0, 0, 21, 0, 1, 22
"c:\Users\chris\source\repos\Cell\Cell\obj\Debug\net8.0-windows\Cell_lv31o55g_wpftmp.GlobalUsings.g.cs", "C#", 5, 0, 0, 0, 0, 1, 1, 7
"c:\Users\chris\source\repos\Cell\Cell\obj\Debug\net8.0-windows\Cell_lv31o55g_wpftmp.sourcelink.json", "JSON", 0, 0, 0, 1, 0, 0, 0, 1
"c:\Users\chris\source\repos\Cell\Cell\obj\Debug\net8.0-windows\Cell_lwf12qyn_wpftmp.AssemblyInfo.cs", "C#", 11, 0, 0, 0, 0, 10, 5, 26
"c:\Users\chris\source\repos\Cell\Cell\obj\Debug\net8.0-windows\Cell_lwf12qyn_wpftmp.GeneratedMSBuildEditorConfig.editorconfig", "Properties", 0, 0, 0, 0, 21, 0, 1, 22
"c:\Users\chris\source\repos\Cell\Cell\obj\Debug\net8.0-windows\Cell_lwf12qyn_wpftmp.GlobalUsings.g.cs", "C#", 5, 0, 0, 0, 0, 1, 1, 7
"c:\Users\chris\source\repos\Cell\Cell\obj\Debug\net8.0-windows\Cell_lwf12qyn_wpftmp.sourcelink.json", "JSON", 0, 0, 0, 1, 0, 0, 0, 1
"c:\Users\chris\source\repos\Cell\Cell\obj\Debug\net8.0-windows\Cell_lwshuvdu_wpftmp.AssemblyInfo.cs", "C#", 11, 0, 0, 0, 0, 10, 5, 26
"c:\Users\chris\source\repos\Cell\Cell\obj\Debug\net8.0-windows\Cell_lwshuvdu_wpftmp.GeneratedMSBuildEditorConfig.editorconfig", "Properties", 0, 0, 0, 0, 21, 0, 1, 22
"c:\Users\chris\source\repos\Cell\Cell\obj\Debug\net8.0-windows\Cell_lwshuvdu_wpftmp.GlobalUsings.g.cs", "C#", 5, 0, 0, 0, 0, 1, 1, 7
"c:\Users\chris\source\repos\Cell\Cell\obj\Debug\net8.0-windows\Cell_lwshuvdu_wpftmp.sourcelink.json", "JSON", 0, 0, 0, 1, 0, 0, 0, 1
"c:\Users\chris\source\repos\Cell\Cell\obj\Debug\net8.0-windows\Cell_lwzfshyr_wpftmp.AssemblyInfo.cs", "C#", 11, 0, 0, 0, 0, 10, 5, 26
"c:\Users\chris\source\repos\Cell\Cell\obj\Debug\net8.0-windows\Cell_lwzfshyr_wpftmp.GeneratedMSBuildEditorConfig.editorconfig", "Properties", 0, 0, 0, 0, 21, 0, 1, 22
"c:\Users\chris\source\repos\Cell\Cell\obj\Debug\net8.0-windows\Cell_lwzfshyr_wpftmp.GlobalUsings.g.cs", "C#", 5, 0, 0, 0, 0, 1, 1, 7
"c:\Users\chris\source\repos\Cell\Cell\obj\Debug\net8.0-windows\Cell_lwzfshyr_wpftmp.sourcelink.json", "JSON", 0, 0, 0, 1, 0, 0, 0, 1
"c:\Users\chris\source\repos\Cell\Cell\obj\Debug\net8.0-windows\Cell_lydtrmke_wpftmp.AssemblyInfo.cs", "C#", 11, 0, 0, 0, 0, 10, 5, 26
"c:\Users\chris\source\repos\Cell\Cell\obj\Debug\net8.0-windows\Cell_lydtrmke_wpftmp.GeneratedMSBuildEditorConfig.editorconfig", "Properties", 0, 0, 0, 0, 21, 0, 1, 22
"c:\Users\chris\source\repos\Cell\Cell\obj\Debug\net8.0-windows\Cell_lydtrmke_wpftmp.GlobalUsings.g.cs", "C#", 5, 0, 0, 0, 0, 1, 1, 7
"c:\Users\chris\source\repos\Cell\Cell\obj\Debug\net8.0-windows\Cell_lydtrmke_wpftmp.sourcelink.json", "JSON", 0, 0, 0, 1, 0, 0, 0, 1
"c:\Users\chris\source\repos\Cell\Cell\obj\Debug\net8.0-windows\Cell_lylmvndw_wpftmp.AssemblyInfo.cs", "C#", 11, 0, 0, 0, 0, 10, 5, 26
"c:\Users\chris\source\repos\Cell\Cell\obj\Debug\net8.0-windows\Cell_lylmvndw_wpftmp.GeneratedMSBuildEditorConfig.editorconfig", "Properties", 0, 0, 0, 0, 21, 0, 1, 22
"c:\Users\chris\source\repos\Cell\Cell\obj\Debug\net8.0-windows\Cell_lylmvndw_wpftmp.GlobalUsings.g.cs", "C#", 5, 0, 0, 0, 0, 1, 1, 7
"c:\Users\chris\source\repos\Cell\Cell\obj\Debug\net8.0-windows\Cell_lylmvndw_wpftmp.sourcelink.json", "JSON", 0, 0, 0, 1, 0, 0, 0, 1
"c:\Users\chris\source\repos\Cell\Cell\obj\Debug\net8.0-windows\Cell_lyrdodus_wpftmp.AssemblyInfo.cs", "C#", 11, 0, 0, 0, 0, 10, 5, 26
"c:\Users\chris\source\repos\Cell\Cell\obj\Debug\net8.0-windows\Cell_lyrdodus_wpftmp.GeneratedMSBuildEditorConfig.editorconfig", "Properties", 0, 0, 0, 0, 13, 0, 1, 14
"c:\Users\chris\source\repos\Cell\Cell\obj\Debug\net8.0-windows\Cell_lyrdodus_wpftmp.GlobalUsings.g.cs", "C#", 5, 0, 0, 0, 0, 1, 1, 7
"c:\Users\chris\source\repos\Cell\Cell\obj\Debug\net8.0-windows\Cell_lz3ccrd1_wpftmp.AssemblyInfo.cs", "C#", 11, 0, 0, 0, 0, 10, 5, 26
"c:\Users\chris\source\repos\Cell\Cell\obj\Debug\net8.0-windows\Cell_lz3ccrd1_wpftmp.GeneratedMSBuildEditorConfig.editorconfig", "Properties", 0, 0, 0, 0, 21, 0, 1, 22
"c:\Users\chris\source\repos\Cell\Cell\obj\Debug\net8.0-windows\Cell_lz3ccrd1_wpftmp.GlobalUsings.g.cs", "C#", 5, 0, 0, 0, 0, 1, 1, 7
"c:\Users\chris\source\repos\Cell\Cell\obj\Debug\net8.0-windows\Cell_lz3ccrd1_wpftmp.sourcelink.json", "JSON", 0, 0, 0, 1, 0, 0, 0, 1
"c:\Users\chris\source\repos\Cell\Cell\obj\Debug\net8.0-windows\Cell_lzjkjh30_wpftmp.AssemblyInfo.cs", "C#", 11, 0, 0, 0, 0, 10, 5, 26
"c:\Users\chris\source\repos\Cell\Cell\obj\Debug\net8.0-windows\Cell_lzjkjh30_wpftmp.GeneratedMSBuildEditorConfig.editorconfig", "Properties", 0, 0, 0, 0, 21, 0, 1, 22
"c:\Users\chris\source\repos\Cell\Cell\obj\Debug\net8.0-windows\Cell_lzjkjh30_wpftmp.GlobalUsings.g.cs", "C#", 5, 0, 0, 0, 0, 1, 1, 7
"c:\Users\chris\source\repos\Cell\Cell\obj\Debug\net8.0-windows\Cell_lzjkjh30_wpftmp.sourcelink.json", "JSON", 0, 0, 0, 1, 0, 0, 0, 1
"c:\Users\chris\source\repos\Cell\Cell\obj\Debug\net8.0-windows\Cell_m02yqn0h_wpftmp.AssemblyInfo.cs", "C#", 11, 0, 0, 0, 0, 10, 5, 26
"c:\Users\chris\source\repos\Cell\Cell\obj\Debug\net8.0-windows\Cell_m02yqn0h_wpftmp.GeneratedMSBuildEditorConfig.editorconfig", "Properties", 0, 0, 0, 0, 21, 0, 1, 22
"c:\Users\chris\source\repos\Cell\Cell\obj\Debug\net8.0-windows\Cell_m02yqn0h_wpftmp.GlobalUsings.g.cs", "C#", 5, 0, 0, 0, 0, 1, 1, 7
"c:\Users\chris\source\repos\Cell\Cell\obj\Debug\net8.0-windows\Cell_m02yqn0h_wpftmp.sourcelink.json", "JSON", 0, 0, 0, 1, 0, 0, 0, 1
"c:\Users\chris\source\repos\Cell\Cell\obj\Debug\net8.0-windows\Cell_m0ldfomn_wpftmp.AssemblyInfo.cs", "C#", 11, 0, 0, 0, 0, 10, 5, 26
"c:\Users\chris\source\repos\Cell\Cell\obj\Debug\net8.0-windows\Cell_m0ldfomn_wpftmp.GeneratedMSBuildEditorConfig.editorconfig", "Properties", 0, 0, 0, 0, 21, 0, 1, 22
"c:\Users\chris\source\repos\Cell\Cell\obj\Debug\net8.0-windows\Cell_m0ldfomn_wpftmp.GlobalUsings.g.cs", "C#", 5, 0, 0, 0, 0, 1, 1, 7
"c:\Users\chris\source\repos\Cell\Cell\obj\Debug\net8.0-windows\Cell_m0ldfomn_wpftmp.sourcelink.json", "JSON", 0, 0, 0, 1, 0, 0, 0, 1
"c:\Users\chris\source\repos\Cell\Cell\obj\Debug\net8.0-windows\Cell_m1csmq4w_wpftmp.AssemblyInfo.cs", "C#", 11, 0, 0, 0, 0, 10, 5, 26
"c:\Users\chris\source\repos\Cell\Cell\obj\Debug\net8.0-windows\Cell_m1csmq4w_wpftmp.GeneratedMSBuildEditorConfig.editorconfig", "Properties", 0, 0, 0, 0, 21, 0, 1, 22
"c:\Users\chris\source\repos\Cell\Cell\obj\Debug\net8.0-windows\Cell_m1csmq4w_wpftmp.GlobalUsings.g.cs", "C#", 5, 0, 0, 0, 0, 1, 1, 7
"c:\Users\chris\source\repos\Cell\Cell\obj\Debug\net8.0-windows\Cell_m1csmq4w_wpftmp.sourcelink.json", "JSON", 0, 0, 0, 1, 0, 0, 0, 1
"c:\Users\chris\source\repos\Cell\Cell\obj\Debug\net8.0-windows\Cell_m1evmdi4_wpftmp.AssemblyInfo.cs", "C#", 11, 0, 0, 0, 0, 10, 5, 26
"c:\Users\chris\source\repos\Cell\Cell\obj\Debug\net8.0-windows\Cell_m1evmdi4_wpftmp.GeneratedMSBuildEditorConfig.editorconfig", "Properties", 0, 0, 0, 0, 21, 0, 1, 22
"c:\Users\chris\source\repos\Cell\Cell\obj\Debug\net8.0-windows\Cell_m1evmdi4_wpftmp.GlobalUsings.g.cs", "C#", 5, 0, 0, 0, 0, 1, 1, 7
"c:\Users\chris\source\repos\Cell\Cell\obj\Debug\net8.0-windows\Cell_m1evmdi4_wpftmp.sourcelink.json", "JSON", 0, 0, 0, 1, 0, 0, 0, 1
"c:\Users\chris\source\repos\Cell\Cell\obj\Debug\net8.0-windows\Cell_m3haj10u_wpftmp.AssemblyInfo.cs", "C#", 11, 0, 0, 0, 0, 10, 5, 26
"c:\Users\chris\source\repos\Cell\Cell\obj\Debug\net8.0-windows\Cell_m3haj10u_wpftmp.GeneratedMSBuildEditorConfig.editorconfig", "Properties", 0, 0, 0, 0, 21, 0, 1, 22
"c:\Users\chris\source\repos\Cell\Cell\obj\Debug\net8.0-windows\Cell_m3haj10u_wpftmp.GlobalUsings.g.cs", "C#", 5, 0, 0, 0, 0, 1, 1, 7
"c:\Users\chris\source\repos\Cell\Cell\obj\Debug\net8.0-windows\Cell_m3haj10u_wpftmp.sourcelink.json", "JSON", 0, 0, 0, 1, 0, 0, 0, 1
"c:\Users\chris\source\repos\Cell\Cell\obj\Debug\net8.0-windows\Cell_m4rxdp5a_wpftmp.AssemblyInfo.cs", "C#", 11, 0, 0, 0, 0, 10, 5, 26
"c:\Users\chris\source\repos\Cell\Cell\obj\Debug\net8.0-windows\Cell_m4rxdp5a_wpftmp.GeneratedMSBuildEditorConfig.editorconfig", "Properties", 0, 0, 0, 0, 13, 0, 1, 14
"c:\Users\chris\source\repos\Cell\Cell\obj\Debug\net8.0-windows\Cell_m4rxdp5a_wpftmp.GlobalUsings.g.cs", "C#", 5, 0, 0, 0, 0, 1, 1, 7
"c:\Users\chris\source\repos\Cell\Cell\obj\Debug\net8.0-windows\Cell_m4stiscq_wpftmp.AssemblyInfo.cs", "C#", 11, 0, 0, 0, 0, 10, 5, 26
"c:\Users\chris\source\repos\Cell\Cell\obj\Debug\net8.0-windows\Cell_m4stiscq_wpftmp.GeneratedMSBuildEditorConfig.editorconfig", "Properties", 0, 0, 0, 0, 21, 0, 1, 22
"c:\Users\chris\source\repos\Cell\Cell\obj\Debug\net8.0-windows\Cell_m4stiscq_wpftmp.GlobalUsings.g.cs", "C#", 5, 0, 0, 0, 0, 1, 1, 7
"c:\Users\chris\source\repos\Cell\Cell\obj\Debug\net8.0-windows\Cell_m4stiscq_wpftmp.sourcelink.json", "JSON", 0, 0, 0, 1, 0, 0, 0, 1
"c:\Users\chris\source\repos\Cell\Cell\obj\Debug\net8.0-windows\Cell_m5yvbnix_wpftmp.AssemblyInfo.cs", "C#", 11, 0, 0, 0, 0, 10, 5, 26
"c:\Users\chris\source\repos\Cell\Cell\obj\Debug\net8.0-windows\Cell_m5yvbnix_wpftmp.GeneratedMSBuildEditorConfig.editorconfig", "Properties", 0, 0, 0, 0, 21, 0, 1, 22
"c:\Users\chris\source\repos\Cell\Cell\obj\Debug\net8.0-windows\Cell_m5yvbnix_wpftmp.GlobalUsings.g.cs", "C#", 5, 0, 0, 0, 0, 1, 1, 7
"c:\Users\chris\source\repos\Cell\Cell\obj\Debug\net8.0-windows\Cell_m5yvbnix_wpftmp.sourcelink.json", "JSON", 0, 0, 0, 1, 0, 0, 0, 1
"c:\Users\chris\source\repos\Cell\Cell\obj\Debug\net8.0-windows\Cell_md4bmphn_wpftmp.AssemblyInfo.cs", "C#", 11, 0, 0, 0, 0, 10, 5, 26
"c:\Users\chris\source\repos\Cell\Cell\obj\Debug\net8.0-windows\Cell_md4bmphn_wpftmp.GeneratedMSBuildEditorConfig.editorconfig", "Properties", 0, 0, 0, 0, 21, 0, 1, 22
"c:\Users\chris\source\repos\Cell\Cell\obj\Debug\net8.0-windows\Cell_md4bmphn_wpftmp.GlobalUsings.g.cs", "C#", 5, 0, 0, 0, 0, 1, 1, 7
"c:\Users\chris\source\repos\Cell\Cell\obj\Debug\net8.0-windows\Cell_md4bmphn_wpftmp.sourcelink.json", "JSON", 0, 0, 0, 1, 0, 0, 0, 1
"c:\Users\chris\source\repos\Cell\Cell\obj\Debug\net8.0-windows\Cell_mdfsxo32_wpftmp.AssemblyInfo.cs", "C#", 11, 0, 0, 0, 0, 10, 5, 26
"c:\Users\chris\source\repos\Cell\Cell\obj\Debug\net8.0-windows\Cell_mdfsxo32_wpftmp.GeneratedMSBuildEditorConfig.editorconfig", "Properties", 0, 0, 0, 0, 21, 0, 1, 22
"c:\Users\chris\source\repos\Cell\Cell\obj\Debug\net8.0-windows\Cell_mdfsxo32_wpftmp.GlobalUsings.g.cs", "C#", 5, 0, 0, 0, 0, 1, 1, 7
"c:\Users\chris\source\repos\Cell\Cell\obj\Debug\net8.0-windows\Cell_mdfsxo32_wpftmp.sourcelink.json", "JSON", 0, 0, 0, 1, 0, 0, 0, 1
"c:\Users\chris\source\repos\Cell\Cell\obj\Debug\net8.0-windows\Cell_mdtlhoki_wpftmp.AssemblyInfo.cs", "C#", 11, 0, 0, 0, 0, 10, 5, 26
"c:\Users\chris\source\repos\Cell\Cell\obj\Debug\net8.0-windows\Cell_mdtlhoki_wpftmp.GeneratedMSBuildEditorConfig.editorconfig", "Properties", 0, 0, 0, 0, 21, 0, 1, 22
"c:\Users\chris\source\repos\Cell\Cell\obj\Debug\net8.0-windows\Cell_mdtlhoki_wpftmp.GlobalUsings.g.cs", "C#", 5, 0, 0, 0, 0, 1, 1, 7
"c:\Users\chris\source\repos\Cell\Cell\obj\Debug\net8.0-windows\Cell_mdtlhoki_wpftmp.sourcelink.json", "JSON", 0, 0, 0, 1, 0, 0, 0, 1
"c:\Users\chris\source\repos\Cell\Cell\obj\Debug\net8.0-windows\Cell_mdwtk1as_wpftmp.AssemblyInfo.cs", "C#", 11, 0, 0, 0, 0, 10, 5, 26
"c:\Users\chris\source\repos\Cell\Cell\obj\Debug\net8.0-windows\Cell_mdwtk1as_wpftmp.GeneratedMSBuildEditorConfig.editorconfig", "Properties", 0, 0, 0, 0, 21, 0, 1, 22
"c:\Users\chris\source\repos\Cell\Cell\obj\Debug\net8.0-windows\Cell_mdwtk1as_wpftmp.GlobalUsings.g.cs", "C#", 5, 0, 0, 0, 0, 1, 1, 7
"c:\Users\chris\source\repos\Cell\Cell\obj\Debug\net8.0-windows\Cell_mdwtk1as_wpftmp.sourcelink.json", "JSON", 0, 0, 0, 1, 0, 0, 0, 1
"c:\Users\chris\source\repos\Cell\Cell\obj\Debug\net8.0-windows\Cell_mfdalsn4_wpftmp.AssemblyInfo.cs", "C#", 11, 0, 0, 0, 0, 10, 5, 26
"c:\Users\chris\source\repos\Cell\Cell\obj\Debug\net8.0-windows\Cell_mfdalsn4_wpftmp.GeneratedMSBuildEditorConfig.editorconfig", "Properties", 0, 0, 0, 0, 21, 0, 1, 22
"c:\Users\chris\source\repos\Cell\Cell\obj\Debug\net8.0-windows\Cell_mfdalsn4_wpftmp.GlobalUsings.g.cs", "C#", 5, 0, 0, 0, 0, 1, 1, 7
"c:\Users\chris\source\repos\Cell\Cell\obj\Debug\net8.0-windows\Cell_mfdalsn4_wpftmp.sourcelink.json", "JSON", 0, 0, 0, 1, 0, 0, 0, 1
"c:\Users\chris\source\repos\Cell\Cell\obj\Debug\net8.0-windows\Cell_mfe0q5ra_wpftmp.AssemblyInfo.cs", "C#", 11, 0, 0, 0, 0, 10, 5, 26
"c:\Users\chris\source\repos\Cell\Cell\obj\Debug\net8.0-windows\Cell_mfe0q5ra_wpftmp.GeneratedMSBuildEditorConfig.editorconfig", "Properties", 0, 0, 0, 0, 21, 0, 1, 22
"c:\Users\chris\source\repos\Cell\Cell\obj\Debug\net8.0-windows\Cell_mfe0q5ra_wpftmp.GlobalUsings.g.cs", "C#", 5, 0, 0, 0, 0, 1, 1, 7
"c:\Users\chris\source\repos\Cell\Cell\obj\Debug\net8.0-windows\Cell_mfe0q5ra_wpftmp.sourcelink.json", "JSON", 0, 0, 0, 1, 0, 0, 0, 1
"c:\Users\chris\source\repos\Cell\Cell\obj\Debug\net8.0-windows\Cell_mfkn4jss_wpftmp.AssemblyInfo.cs", "C#", 11, 0, 0, 0, 0, 10, 5, 26
"c:\Users\chris\source\repos\Cell\Cell\obj\Debug\net8.0-windows\Cell_mfkn4jss_wpftmp.GeneratedMSBuildEditorConfig.editorconfig", "Properties", 0, 0, 0, 0, 21, 0, 1, 22
"c:\Users\chris\source\repos\Cell\Cell\obj\Debug\net8.0-windows\Cell_mfkn4jss_wpftmp.GlobalUsings.g.cs", "C#", 5, 0, 0, 0, 0, 1, 1, 7
"c:\Users\chris\source\repos\Cell\Cell\obj\Debug\net8.0-windows\Cell_mfkn4jss_wpftmp.sourcelink.json", "JSON", 0, 0, 0, 1, 0, 0, 0, 1
"c:\Users\chris\source\repos\Cell\Cell\obj\Debug\net8.0-windows\Cell_mfr3twpa_wpftmp.AssemblyInfo.cs", "C#", 11, 0, 0, 0, 0, 10, 5, 26
"c:\Users\chris\source\repos\Cell\Cell\obj\Debug\net8.0-windows\Cell_mfr3twpa_wpftmp.GeneratedMSBuildEditorConfig.editorconfig", "Properties", 0, 0, 0, 0, 21, 0, 1, 22
"c:\Users\chris\source\repos\Cell\Cell\obj\Debug\net8.0-windows\Cell_mfr3twpa_wpftmp.GlobalUsings.g.cs", "C#", 5, 0, 0, 0, 0, 1, 1, 7
"c:\Users\chris\source\repos\Cell\Cell\obj\Debug\net8.0-windows\Cell_mfr3twpa_wpftmp.sourcelink.json", "JSON", 0, 0, 0, 1, 0, 0, 0, 1
"c:\Users\chris\source\repos\Cell\Cell\obj\Debug\net8.0-windows\Cell_mgfp0ntp_wpftmp.AssemblyInfo.cs", "C#", 11, 0, 0, 0, 0, 10, 5, 26
"c:\Users\chris\source\repos\Cell\Cell\obj\Debug\net8.0-windows\Cell_mgfp0ntp_wpftmp.GeneratedMSBuildEditorConfig.editorconfig", "Properties", 0, 0, 0, 0, 21, 0, 1, 22
"c:\Users\chris\source\repos\Cell\Cell\obj\Debug\net8.0-windows\Cell_mgfp0ntp_wpftmp.GlobalUsings.g.cs", "C#", 5, 0, 0, 0, 0, 1, 1, 7
"c:\Users\chris\source\repos\Cell\Cell\obj\Debug\net8.0-windows\Cell_mgfp0ntp_wpftmp.sourcelink.json", "JSON", 0, 0, 0, 1, 0, 0, 0, 1
"c:\Users\chris\source\repos\Cell\Cell\obj\Debug\net8.0-windows\Cell_mgkyq3hk_wpftmp.AssemblyInfo.cs", "C#", 11, 0, 0, 0, 0, 10, 5, 26
"c:\Users\chris\source\repos\Cell\Cell\obj\Debug\net8.0-windows\Cell_mgkyq3hk_wpftmp.GeneratedMSBuildEditorConfig.editorconfig", "Properties", 0, 0, 0, 0, 21, 0, 1, 22
"c:\Users\chris\source\repos\Cell\Cell\obj\Debug\net8.0-windows\Cell_mgkyq3hk_wpftmp.GlobalUsings.g.cs", "C#", 5, 0, 0, 0, 0, 1, 1, 7
"c:\Users\chris\source\repos\Cell\Cell\obj\Debug\net8.0-windows\Cell_mgkyq3hk_wpftmp.sourcelink.json", "JSON", 0, 0, 0, 1, 0, 0, 0, 1
"c:\Users\chris\source\repos\Cell\Cell\obj\Debug\net8.0-windows\Cell_mgvv1s5g_wpftmp.AssemblyInfo.cs", "C#", 11, 0, 0, 0, 0, 10, 5, 26
"c:\Users\chris\source\repos\Cell\Cell\obj\Debug\net8.0-windows\Cell_mgvv1s5g_wpftmp.GeneratedMSBuildEditorConfig.editorconfig", "Properties", 0, 0, 0, 0, 21, 0, 1, 22
"c:\Users\chris\source\repos\Cell\Cell\obj\Debug\net8.0-windows\Cell_mgvv1s5g_wpftmp.GlobalUsings.g.cs", "C#", 5, 0, 0, 0, 0, 1, 1, 7
"c:\Users\chris\source\repos\Cell\Cell\obj\Debug\net8.0-windows\Cell_mgvv1s5g_wpftmp.sourcelink.json", "JSON", 0, 0, 0, 1, 0, 0, 0, 1
"c:\Users\chris\source\repos\Cell\Cell\obj\Debug\net8.0-windows\Cell_mgwmii2b_wpftmp.AssemblyInfo.cs", "C#", 11, 0, 0, 0, 0, 10, 5, 26
"c:\Users\chris\source\repos\Cell\Cell\obj\Debug\net8.0-windows\Cell_mgwmii2b_wpftmp.GeneratedMSBuildEditorConfig.editorconfig", "Properties", 0, 0, 0, 0, 21, 0, 1, 22
"c:\Users\chris\source\repos\Cell\Cell\obj\Debug\net8.0-windows\Cell_mgwmii2b_wpftmp.GlobalUsings.g.cs", "C#", 5, 0, 0, 0, 0, 1, 1, 7
"c:\Users\chris\source\repos\Cell\Cell\obj\Debug\net8.0-windows\Cell_mgwmii2b_wpftmp.sourcelink.json", "JSON", 0, 0, 0, 1, 0, 0, 0, 1
"c:\Users\chris\source\repos\Cell\Cell\obj\Debug\net8.0-windows\Cell_mhstxsvr_wpftmp.AssemblyInfo.cs", "C#", 11, 0, 0, 0, 0, 10, 5, 26
"c:\Users\chris\source\repos\Cell\Cell\obj\Debug\net8.0-windows\Cell_mhstxsvr_wpftmp.GeneratedMSBuildEditorConfig.editorconfig", "Properties", 0, 0, 0, 0, 13, 0, 1, 14
"c:\Users\chris\source\repos\Cell\Cell\obj\Debug\net8.0-windows\Cell_mhstxsvr_wpftmp.GlobalUsings.g.cs", "C#", 5, 0, 0, 0, 0, 1, 1, 7
"c:\Users\chris\source\repos\Cell\Cell\obj\Debug\net8.0-windows\Cell_miolycnz_wpftmp.AssemblyInfo.cs", "C#", 11, 0, 0, 0, 0, 10, 5, 26
"c:\Users\chris\source\repos\Cell\Cell\obj\Debug\net8.0-windows\Cell_miolycnz_wpftmp.GeneratedMSBuildEditorConfig.editorconfig", "Properties", 0, 0, 0, 0, 21, 0, 1, 22
"c:\Users\chris\source\repos\Cell\Cell\obj\Debug\net8.0-windows\Cell_miolycnz_wpftmp.GlobalUsings.g.cs", "C#", 5, 0, 0, 0, 0, 1, 1, 7
"c:\Users\chris\source\repos\Cell\Cell\obj\Debug\net8.0-windows\Cell_miolycnz_wpftmp.sourcelink.json", "JSON", 0, 0, 0, 1, 0, 0, 0, 1
"c:\Users\chris\source\repos\Cell\Cell\obj\Debug\net8.0-windows\Cell_misaom4u_wpftmp.AssemblyInfo.cs", "C#", 11, 0, 0, 0, 0, 10, 5, 26
"c:\Users\chris\source\repos\Cell\Cell\obj\Debug\net8.0-windows\Cell_misaom4u_wpftmp.GeneratedMSBuildEditorConfig.editorconfig", "Properties", 0, 0, 0, 0, 21, 0, 1, 22
"c:\Users\chris\source\repos\Cell\Cell\obj\Debug\net8.0-windows\Cell_misaom4u_wpftmp.GlobalUsings.g.cs", "C#", 5, 0, 0, 0, 0, 1, 1, 7
"c:\Users\chris\source\repos\Cell\Cell\obj\Debug\net8.0-windows\Cell_misaom4u_wpftmp.sourcelink.json", "JSON", 0, 0, 0, 1, 0, 0, 0, 1
"c:\Users\chris\source\repos\Cell\Cell\obj\Debug\net8.0-windows\Cell_mitlh0uf_wpftmp.AssemblyInfo.cs", "C#", 11, 0, 0, 0, 0, 10, 5, 26
"c:\Users\chris\source\repos\Cell\Cell\obj\Debug\net8.0-windows\Cell_mitlh0uf_wpftmp.GeneratedMSBuildEditorConfig.editorconfig", "Properties", 0, 0, 0, 0, 21, 0, 1, 22
"c:\Users\chris\source\repos\Cell\Cell\obj\Debug\net8.0-windows\Cell_mitlh0uf_wpftmp.GlobalUsings.g.cs", "C#", 5, 0, 0, 0, 0, 1, 1, 7
"c:\Users\chris\source\repos\Cell\Cell\obj\Debug\net8.0-windows\Cell_mitlh0uf_wpftmp.sourcelink.json", "JSON", 0, 0, 0, 1, 0, 0, 0, 1
"c:\Users\chris\source\repos\Cell\Cell\obj\Debug\net8.0-windows\Cell_mjkpwfmn_wpftmp.AssemblyInfo.cs", "C#", 11, 0, 0, 0, 0, 10, 5, 26
"c:\Users\chris\source\repos\Cell\Cell\obj\Debug\net8.0-windows\Cell_mjkpwfmn_wpftmp.GeneratedMSBuildEditorConfig.editorconfig", "Properties", 0, 0, 0, 0, 21, 0, 1, 22
"c:\Users\chris\source\repos\Cell\Cell\obj\Debug\net8.0-windows\Cell_mjkpwfmn_wpftmp.GlobalUsings.g.cs", "C#", 5, 0, 0, 0, 0, 1, 1, 7
"c:\Users\chris\source\repos\Cell\Cell\obj\Debug\net8.0-windows\Cell_mjkpwfmn_wpftmp.sourcelink.json", "JSON", 0, 0, 0, 1, 0, 0, 0, 1
"c:\Users\chris\source\repos\Cell\Cell\obj\Debug\net8.0-windows\Cell_mjyfl0of_wpftmp.AssemblyInfo.cs", "C#", 11, 0, 0, 0, 0, 10, 5, 26
"c:\Users\chris\source\repos\Cell\Cell\obj\Debug\net8.0-windows\Cell_mjyfl0of_wpftmp.GeneratedMSBuildEditorConfig.editorconfig", "Properties", 0, 0, 0, 0, 21, 0, 1, 22
"c:\Users\chris\source\repos\Cell\Cell\obj\Debug\net8.0-windows\Cell_mjyfl0of_wpftmp.GlobalUsings.g.cs", "C#", 5, 0, 0, 0, 0, 1, 1, 7
"c:\Users\chris\source\repos\Cell\Cell\obj\Debug\net8.0-windows\Cell_mjyfl0of_wpftmp.sourcelink.json", "JSON", 0, 0, 0, 1, 0, 0, 0, 1
"c:\Users\chris\source\repos\Cell\Cell\obj\Debug\net8.0-windows\Cell_mjzv3gcb_wpftmp.AssemblyInfo.cs", "C#", 11, 0, 0, 0, 0, 10, 5, 26
"c:\Users\chris\source\repos\Cell\Cell\obj\Debug\net8.0-windows\Cell_mjzv3gcb_wpftmp.GeneratedMSBuildEditorConfig.editorconfig", "Properties", 0, 0, 0, 0, 21, 0, 1, 22
"c:\Users\chris\source\repos\Cell\Cell\obj\Debug\net8.0-windows\Cell_mjzv3gcb_wpftmp.GlobalUsings.g.cs", "C#", 5, 0, 0, 0, 0, 1, 1, 7
"c:\Users\chris\source\repos\Cell\Cell\obj\Debug\net8.0-windows\Cell_mjzv3gcb_wpftmp.sourcelink.json", "JSON", 0, 0, 0, 1, 0, 0, 0, 1
"c:\Users\chris\source\repos\Cell\Cell\obj\Debug\net8.0-windows\Cell_mkp4sheq_wpftmp.AssemblyInfo.cs", "C#", 11, 0, 0, 0, 0, 10, 5, 26
"c:\Users\chris\source\repos\Cell\Cell\obj\Debug\net8.0-windows\Cell_mkp4sheq_wpftmp.GeneratedMSBuildEditorConfig.editorconfig", "Properties", 0, 0, 0, 0, 21, 0, 1, 22
"c:\Users\chris\source\repos\Cell\Cell\obj\Debug\net8.0-windows\Cell_mkp4sheq_wpftmp.GlobalUsings.g.cs", "C#", 5, 0, 0, 0, 0, 1, 1, 7
"c:\Users\chris\source\repos\Cell\Cell\obj\Debug\net8.0-windows\Cell_mkp4sheq_wpftmp.sourcelink.json", "JSON", 0, 0, 0, 1, 0, 0, 0, 1
"c:\Users\chris\source\repos\Cell\Cell\obj\Debug\net8.0-windows\Cell_mmw4zhr2_wpftmp.AssemblyInfo.cs", "C#", 11, 0, 0, 0, 0, 10, 5, 26
"c:\Users\chris\source\repos\Cell\Cell\obj\Debug\net8.0-windows\Cell_mmw4zhr2_wpftmp.GeneratedMSBuildEditorConfig.editorconfig", "Properties", 0, 0, 0, 0, 21, 0, 1, 22
"c:\Users\chris\source\repos\Cell\Cell\obj\Debug\net8.0-windows\Cell_mmw4zhr2_wpftmp.GlobalUsings.g.cs", "C#", 5, 0, 0, 0, 0, 1, 1, 7
"c:\Users\chris\source\repos\Cell\Cell\obj\Debug\net8.0-windows\Cell_mmw4zhr2_wpftmp.sourcelink.json", "JSON", 0, 0, 0, 1, 0, 0, 0, 1
"c:\Users\chris\source\repos\Cell\Cell\obj\Debug\net8.0-windows\Cell_mozzaxjt_wpftmp.AssemblyInfo.cs", "C#", 11, 0, 0, 0, 0, 10, 5, 26
"c:\Users\chris\source\repos\Cell\Cell\obj\Debug\net8.0-windows\Cell_mozzaxjt_wpftmp.GeneratedMSBuildEditorConfig.editorconfig", "Properties", 0, 0, 0, 0, 21, 0, 1, 22
"c:\Users\chris\source\repos\Cell\Cell\obj\Debug\net8.0-windows\Cell_mozzaxjt_wpftmp.GlobalUsings.g.cs", "C#", 5, 0, 0, 0, 0, 1, 1, 7
"c:\Users\chris\source\repos\Cell\Cell\obj\Debug\net8.0-windows\Cell_mozzaxjt_wpftmp.sourcelink.json", "JSON", 0, 0, 0, 1, 0, 0, 0, 1
"c:\Users\chris\source\repos\Cell\Cell\obj\Debug\net8.0-windows\Cell_mp1svclf_wpftmp.AssemblyInfo.cs", "C#", 11, 0, 0, 0, 0, 10, 5, 26
"c:\Users\chris\source\repos\Cell\Cell\obj\Debug\net8.0-windows\Cell_mp1svclf_wpftmp.GeneratedMSBuildEditorConfig.editorconfig", "Properties", 0, 0, 0, 0, 13, 0, 1, 14
"c:\Users\chris\source\repos\Cell\Cell\obj\Debug\net8.0-windows\Cell_mp1svclf_wpftmp.GlobalUsings.g.cs", "C#", 5, 0, 0, 0, 0, 1, 1, 7
"c:\Users\chris\source\repos\Cell\Cell\obj\Debug\net8.0-windows\Cell_mpcwlnqd_wpftmp.AssemblyInfo.cs", "C#", 11, 0, 0, 0, 0, 10, 5, 26
"c:\Users\chris\source\repos\Cell\Cell\obj\Debug\net8.0-windows\Cell_mpcwlnqd_wpftmp.GeneratedMSBuildEditorConfig.editorconfig", "Properties", 0, 0, 0, 0, 13, 0, 1, 14
"c:\Users\chris\source\repos\Cell\Cell\obj\Debug\net8.0-windows\Cell_mpcwlnqd_wpftmp.GlobalUsings.g.cs", "C#", 5, 0, 0, 0, 0, 1, 1, 7
"c:\Users\chris\source\repos\Cell\Cell\obj\Debug\net8.0-windows\Cell_mqdqxcn2_wpftmp.AssemblyInfo.cs", "C#", 11, 0, 0, 0, 0, 10, 5, 26
"c:\Users\chris\source\repos\Cell\Cell\obj\Debug\net8.0-windows\Cell_mqdqxcn2_wpftmp.GeneratedMSBuildEditorConfig.editorconfig", "Properties", 0, 0, 0, 0, 21, 0, 1, 22
"c:\Users\chris\source\repos\Cell\Cell\obj\Debug\net8.0-windows\Cell_mqdqxcn2_wpftmp.GlobalUsings.g.cs", "C#", 5, 0, 0, 0, 0, 1, 1, 7
"c:\Users\chris\source\repos\Cell\Cell\obj\Debug\net8.0-windows\Cell_mqdqxcn2_wpftmp.sourcelink.json", "JSON", 0, 0, 0, 1, 0, 0, 0, 1
"c:\Users\chris\source\repos\Cell\Cell\obj\Debug\net8.0-windows\Cell_mrb0m2xz_wpftmp.AssemblyInfo.cs", "C#", 11, 0, 0, 0, 0, 10, 5, 26
"c:\Users\chris\source\repos\Cell\Cell\obj\Debug\net8.0-windows\Cell_mrb0m2xz_wpftmp.GeneratedMSBuildEditorConfig.editorconfig", "Properties", 0, 0, 0, 0, 21, 0, 1, 22
"c:\Users\chris\source\repos\Cell\Cell\obj\Debug\net8.0-windows\Cell_mrb0m2xz_wpftmp.GlobalUsings.g.cs", "C#", 5, 0, 0, 0, 0, 1, 1, 7
"c:\Users\chris\source\repos\Cell\Cell\obj\Debug\net8.0-windows\Cell_mrb0m2xz_wpftmp.sourcelink.json", "JSON", 0, 0, 0, 1, 0, 0, 0, 1
"c:\Users\chris\source\repos\Cell\Cell\obj\Debug\net8.0-windows\Cell_mrchuura_wpftmp.AssemblyInfo.cs", "C#", 11, 0, 0, 0, 0, 10, 5, 26
"c:\Users\chris\source\repos\Cell\Cell\obj\Debug\net8.0-windows\Cell_mrchuura_wpftmp.GeneratedMSBuildEditorConfig.editorconfig", "Properties", 0, 0, 0, 0, 21, 0, 1, 22
"c:\Users\chris\source\repos\Cell\Cell\obj\Debug\net8.0-windows\Cell_mrchuura_wpftmp.GlobalUsings.g.cs", "C#", 5, 0, 0, 0, 0, 1, 1, 7
"c:\Users\chris\source\repos\Cell\Cell\obj\Debug\net8.0-windows\Cell_mrchuura_wpftmp.sourcelink.json", "JSON", 0, 0, 0, 1, 0, 0, 0, 1
"c:\Users\chris\source\repos\Cell\Cell\obj\Debug\net8.0-windows\Cell_mrxd3dbq_wpftmp.AssemblyInfo.cs", "C#", 11, 0, 0, 0, 0, 10, 5, 26
"c:\Users\chris\source\repos\Cell\Cell\obj\Debug\net8.0-windows\Cell_mrxd3dbq_wpftmp.GeneratedMSBuildEditorConfig.editorconfig", "Properties", 0, 0, 0, 0, 13, 0, 1, 14
"c:\Users\chris\source\repos\Cell\Cell\obj\Debug\net8.0-windows\Cell_mrxd3dbq_wpftmp.GlobalUsings.g.cs", "C#", 5, 0, 0, 0, 0, 1, 1, 7
"c:\Users\chris\source\repos\Cell\Cell\obj\Debug\net8.0-windows\Cell_mrxnthul_wpftmp.AssemblyInfo.cs", "C#", 11, 0, 0, 0, 0, 10, 5, 26
"c:\Users\chris\source\repos\Cell\Cell\obj\Debug\net8.0-windows\Cell_mrxnthul_wpftmp.GeneratedMSBuildEditorConfig.editorconfig", "Properties", 0, 0, 0, 0, 21, 0, 1, 22
"c:\Users\chris\source\repos\Cell\Cell\obj\Debug\net8.0-windows\Cell_mrxnthul_wpftmp.GlobalUsings.g.cs", "C#", 5, 0, 0, 0, 0, 1, 1, 7
"c:\Users\chris\source\repos\Cell\Cell\obj\Debug\net8.0-windows\Cell_mrxnthul_wpftmp.sourcelink.json", "JSON", 0, 0, 0, 1, 0, 0, 0, 1
"c:\Users\chris\source\repos\Cell\Cell\obj\Debug\net8.0-windows\Cell_mwl1wt3d_wpftmp.AssemblyInfo.cs", "C#", 11, 0, 0, 0, 0, 10, 5, 26
"c:\Users\chris\source\repos\Cell\Cell\obj\Debug\net8.0-windows\Cell_mwl1wt3d_wpftmp.GeneratedMSBuildEditorConfig.editorconfig", "Properties", 0, 0, 0, 0, 21, 0, 1, 22
"c:\Users\chris\source\repos\Cell\Cell\obj\Debug\net8.0-windows\Cell_mwl1wt3d_wpftmp.GlobalUsings.g.cs", "C#", 5, 0, 0, 0, 0, 1, 1, 7
"c:\Users\chris\source\repos\Cell\Cell\obj\Debug\net8.0-windows\Cell_mwl1wt3d_wpftmp.sourcelink.json", "JSON", 0, 0, 0, 1, 0, 0, 0, 1
"c:\Users\chris\source\repos\Cell\Cell\obj\Debug\net8.0-windows\Cell_mwtw33rg_wpftmp.AssemblyInfo.cs", "C#", 11, 0, 0, 0, 0, 10, 5, 26
"c:\Users\chris\source\repos\Cell\Cell\obj\Debug\net8.0-windows\Cell_mwtw33rg_wpftmp.GeneratedMSBuildEditorConfig.editorconfig", "Properties", 0, 0, 0, 0, 21, 0, 1, 22
"c:\Users\chris\source\repos\Cell\Cell\obj\Debug\net8.0-windows\Cell_mwtw33rg_wpftmp.GlobalUsings.g.cs", "C#", 5, 0, 0, 0, 0, 1, 1, 7
"c:\Users\chris\source\repos\Cell\Cell\obj\Debug\net8.0-windows\Cell_mwtw33rg_wpftmp.sourcelink.json", "JSON", 0, 0, 0, 1, 0, 0, 0, 1
"c:\Users\chris\source\repos\Cell\Cell\obj\Debug\net8.0-windows\Cell_mx1p2ju5_wpftmp.AssemblyInfo.cs", "C#", 11, 0, 0, 0, 0, 10, 5, 26
"c:\Users\chris\source\repos\Cell\Cell\obj\Debug\net8.0-windows\Cell_mx1p2ju5_wpftmp.GeneratedMSBuildEditorConfig.editorconfig", "Properties", 0, 0, 0, 0, 21, 0, 1, 22
"c:\Users\chris\source\repos\Cell\Cell\obj\Debug\net8.0-windows\Cell_mx1p2ju5_wpftmp.GlobalUsings.g.cs", "C#", 5, 0, 0, 0, 0, 1, 1, 7
"c:\Users\chris\source\repos\Cell\Cell\obj\Debug\net8.0-windows\Cell_mx1p2ju5_wpftmp.sourcelink.json", "JSON", 0, 0, 0, 1, 0, 0, 0, 1
"c:\Users\chris\source\repos\Cell\Cell\obj\Debug\net8.0-windows\Cell_mxfet4b1_wpftmp.AssemblyInfo.cs", "C#", 11, 0, 0, 0, 0, 10, 5, 26
"c:\Users\chris\source\repos\Cell\Cell\obj\Debug\net8.0-windows\Cell_mxfet4b1_wpftmp.GeneratedMSBuildEditorConfig.editorconfig", "Properties", 0, 0, 0, 0, 21, 0, 1, 22
"c:\Users\chris\source\repos\Cell\Cell\obj\Debug\net8.0-windows\Cell_mxfet4b1_wpftmp.GlobalUsings.g.cs", "C#", 5, 0, 0, 0, 0, 1, 1, 7
"c:\Users\chris\source\repos\Cell\Cell\obj\Debug\net8.0-windows\Cell_mxfet4b1_wpftmp.sourcelink.json", "JSON", 0, 0, 0, 1, 0, 0, 0, 1
"c:\Users\chris\source\repos\Cell\Cell\obj\Debug\net8.0-windows\Cell_mxlfv3pk_wpftmp.AssemblyInfo.cs", "C#", 11, 0, 0, 0, 0, 10, 5, 26
"c:\Users\chris\source\repos\Cell\Cell\obj\Debug\net8.0-windows\Cell_mxlfv3pk_wpftmp.GeneratedMSBuildEditorConfig.editorconfig", "Properties", 0, 0, 0, 0, 21, 0, 1, 22
"c:\Users\chris\source\repos\Cell\Cell\obj\Debug\net8.0-windows\Cell_mxlfv3pk_wpftmp.GlobalUsings.g.cs", "C#", 5, 0, 0, 0, 0, 1, 1, 7
"c:\Users\chris\source\repos\Cell\Cell\obj\Debug\net8.0-windows\Cell_mxlfv3pk_wpftmp.sourcelink.json", "JSON", 0, 0, 0, 1, 0, 0, 0, 1
"c:\Users\chris\source\repos\Cell\Cell\obj\Debug\net8.0-windows\Cell_myegrjfp_wpftmp.AssemblyInfo.cs", "C#", 11, 0, 0, 0, 0, 10, 5, 26
"c:\Users\chris\source\repos\Cell\Cell\obj\Debug\net8.0-windows\Cell_myegrjfp_wpftmp.GeneratedMSBuildEditorConfig.editorconfig", "Properties", 0, 0, 0, 0, 21, 0, 1, 22
"c:\Users\chris\source\repos\Cell\Cell\obj\Debug\net8.0-windows\Cell_myegrjfp_wpftmp.GlobalUsings.g.cs", "C#", 5, 0, 0, 0, 0, 1, 1, 7
"c:\Users\chris\source\repos\Cell\Cell\obj\Debug\net8.0-windows\Cell_myegrjfp_wpftmp.sourcelink.json", "JSON", 0, 0, 0, 1, 0, 0, 0, 1
"c:\Users\chris\source\repos\Cell\Cell\obj\Debug\net8.0-windows\Cell_mywkm1an_wpftmp.AssemblyInfo.cs", "C#", 11, 0, 0, 0, 0, 10, 5, 26
"c:\Users\chris\source\repos\Cell\Cell\obj\Debug\net8.0-windows\Cell_mywkm1an_wpftmp.GeneratedMSBuildEditorConfig.editorconfig", "Properties", 0, 0, 0, 0, 21, 0, 1, 22
"c:\Users\chris\source\repos\Cell\Cell\obj\Debug\net8.0-windows\Cell_mywkm1an_wpftmp.GlobalUsings.g.cs", "C#", 5, 0, 0, 0, 0, 1, 1, 7
"c:\Users\chris\source\repos\Cell\Cell\obj\Debug\net8.0-windows\Cell_mywkm1an_wpftmp.sourcelink.json", "JSON", 0, 0, 0, 1, 0, 0, 0, 1
"c:\Users\chris\source\repos\Cell\Cell\obj\Debug\net8.0-windows\Cell_mzrtiqpq_wpftmp.AssemblyInfo.cs", "C#", 11, 0, 0, 0, 0, 10, 5, 26
"c:\Users\chris\source\repos\Cell\Cell\obj\Debug\net8.0-windows\Cell_mzrtiqpq_wpftmp.GeneratedMSBuildEditorConfig.editorconfig", "Properties", 0, 0, 0, 0, 21, 0, 1, 22
"c:\Users\chris\source\repos\Cell\Cell\obj\Debug\net8.0-windows\Cell_mzrtiqpq_wpftmp.GlobalUsings.g.cs", "C#", 5, 0, 0, 0, 0, 1, 1, 7
"c:\Users\chris\source\repos\Cell\Cell\obj\Debug\net8.0-windows\Cell_mzrtiqpq_wpftmp.sourcelink.json", "JSON", 0, 0, 0, 1, 0, 0, 0, 1
"c:\Users\chris\source\repos\Cell\Cell\obj\Debug\net8.0-windows\Cell_n0aeab3o_wpftmp.AssemblyInfo.cs", "C#", 11, 0, 0, 0, 0, 10, 5, 26
"c:\Users\chris\source\repos\Cell\Cell\obj\Debug\net8.0-windows\Cell_n0aeab3o_wpftmp.GeneratedMSBuildEditorConfig.editorconfig", "Properties", 0, 0, 0, 0, 21, 0, 1, 22
"c:\Users\chris\source\repos\Cell\Cell\obj\Debug\net8.0-windows\Cell_n0aeab3o_wpftmp.GlobalUsings.g.cs", "C#", 5, 0, 0, 0, 0, 1, 1, 7
"c:\Users\chris\source\repos\Cell\Cell\obj\Debug\net8.0-windows\Cell_n0aeab3o_wpftmp.sourcelink.json", "JSON", 0, 0, 0, 1, 0, 0, 0, 1
"c:\Users\chris\source\repos\Cell\Cell\obj\Debug\net8.0-windows\Cell_n1r0ymwj_wpftmp.AssemblyInfo.cs", "C#", 11, 0, 0, 0, 0, 10, 5, 26
"c:\Users\chris\source\repos\Cell\Cell\obj\Debug\net8.0-windows\Cell_n1r0ymwj_wpftmp.GeneratedMSBuildEditorConfig.editorconfig", "Properties", 0, 0, 0, 0, 13, 0, 1, 14
"c:\Users\chris\source\repos\Cell\Cell\obj\Debug\net8.0-windows\Cell_n1r0ymwj_wpftmp.GlobalUsings.g.cs", "C#", 5, 0, 0, 0, 0, 1, 1, 7
"c:\Users\chris\source\repos\Cell\Cell\obj\Debug\net8.0-windows\Cell_n1y4lfrf_wpftmp.AssemblyInfo.cs", "C#", 11, 0, 0, 0, 0, 10, 5, 26
"c:\Users\chris\source\repos\Cell\Cell\obj\Debug\net8.0-windows\Cell_n1y4lfrf_wpftmp.GeneratedMSBuildEditorConfig.editorconfig", "Properties", 0, 0, 0, 0, 21, 0, 1, 22
"c:\Users\chris\source\repos\Cell\Cell\obj\Debug\net8.0-windows\Cell_n1y4lfrf_wpftmp.GlobalUsings.g.cs", "C#", 5, 0, 0, 0, 0, 1, 1, 7
"c:\Users\chris\source\repos\Cell\Cell\obj\Debug\net8.0-windows\Cell_n1y4lfrf_wpftmp.sourcelink.json", "JSON", 0, 0, 0, 1, 0, 0, 0, 1
"c:\Users\chris\source\repos\Cell\Cell\obj\Debug\net8.0-windows\Cell_n2gkbzgm_wpftmp.AssemblyInfo.cs", "C#", 11, 0, 0, 0, 0, 10, 5, 26
"c:\Users\chris\source\repos\Cell\Cell\obj\Debug\net8.0-windows\Cell_n2gkbzgm_wpftmp.GeneratedMSBuildEditorConfig.editorconfig", "Properties", 0, 0, 0, 0, 21, 0, 1, 22
"c:\Users\chris\source\repos\Cell\Cell\obj\Debug\net8.0-windows\Cell_n2gkbzgm_wpftmp.GlobalUsings.g.cs", "C#", 5, 0, 0, 0, 0, 1, 1, 7
"c:\Users\chris\source\repos\Cell\Cell\obj\Debug\net8.0-windows\Cell_n2gkbzgm_wpftmp.sourcelink.json", "JSON", 0, 0, 0, 1, 0, 0, 0, 1
"c:\Users\chris\source\repos\Cell\Cell\obj\Debug\net8.0-windows\Cell_n2wsazfr_wpftmp.AssemblyInfo.cs", "C#", 11, 0, 0, 0, 0, 10, 5, 26
"c:\Users\chris\source\repos\Cell\Cell\obj\Debug\net8.0-windows\Cell_n2wsazfr_wpftmp.GeneratedMSBuildEditorConfig.editorconfig", "Properties", 0, 0, 0, 0, 13, 0, 1, 14
"c:\Users\chris\source\repos\Cell\Cell\obj\Debug\net8.0-windows\Cell_n2wsazfr_wpftmp.GlobalUsings.g.cs", "C#", 5, 0, 0, 0, 0, 1, 1, 7
"c:\Users\chris\source\repos\Cell\Cell\obj\Debug\net8.0-windows\Cell_n3lu55bs_wpftmp.AssemblyInfo.cs", "C#", 11, 0, 0, 0, 0, 10, 5, 26
"c:\Users\chris\source\repos\Cell\Cell\obj\Debug\net8.0-windows\Cell_n3lu55bs_wpftmp.GeneratedMSBuildEditorConfig.editorconfig", "Properties", 0, 0, 0, 0, 21, 0, 1, 22
"c:\Users\chris\source\repos\Cell\Cell\obj\Debug\net8.0-windows\Cell_n3lu55bs_wpftmp.GlobalUsings.g.cs", "C#", 5, 0, 0, 0, 0, 1, 1, 7
"c:\Users\chris\source\repos\Cell\Cell\obj\Debug\net8.0-windows\Cell_n3n21zbj_wpftmp.AssemblyInfo.cs", "C#", 11, 0, 0, 0, 0, 10, 5, 26
"c:\Users\chris\source\repos\Cell\Cell\obj\Debug\net8.0-windows\Cell_n3n21zbj_wpftmp.GeneratedMSBuildEditorConfig.editorconfig", "Properties", 0, 0, 0, 0, 13, 0, 1, 14
"c:\Users\chris\source\repos\Cell\Cell\obj\Debug\net8.0-windows\Cell_n3n21zbj_wpftmp.GlobalUsings.g.cs", "C#", 5, 0, 0, 0, 0, 1, 1, 7
"c:\Users\chris\source\repos\Cell\Cell\obj\Debug\net8.0-windows\Cell_n3ti3xej_wpftmp.AssemblyInfo.cs", "C#", 11, 0, 0, 0, 0, 10, 5, 26
"c:\Users\chris\source\repos\Cell\Cell\obj\Debug\net8.0-windows\Cell_n3ti3xej_wpftmp.GeneratedMSBuildEditorConfig.editorconfig", "Properties", 0, 0, 0, 0, 21, 0, 1, 22
"c:\Users\chris\source\repos\Cell\Cell\obj\Debug\net8.0-windows\Cell_n3ti3xej_wpftmp.GlobalUsings.g.cs", "C#", 5, 0, 0, 0, 0, 1, 1, 7
"c:\Users\chris\source\repos\Cell\Cell\obj\Debug\net8.0-windows\Cell_n3ti3xej_wpftmp.sourcelink.json", "JSON", 0, 0, 0, 1, 0, 0, 0, 1
"c:\Users\chris\source\repos\Cell\Cell\obj\Debug\net8.0-windows\Cell_n5u3f0xz_wpftmp.AssemblyInfo.cs", "C#", 11, 0, 0, 0, 0, 10, 5, 26
"c:\Users\chris\source\repos\Cell\Cell\obj\Debug\net8.0-windows\Cell_n5u3f0xz_wpftmp.GeneratedMSBuildEditorConfig.editorconfig", "Properties", 0, 0, 0, 0, 21, 0, 1, 22
"c:\Users\chris\source\repos\Cell\Cell\obj\Debug\net8.0-windows\Cell_n5u3f0xz_wpftmp.GlobalUsings.g.cs", "C#", 5, 0, 0, 0, 0, 1, 1, 7
"c:\Users\chris\source\repos\Cell\Cell\obj\Debug\net8.0-windows\Cell_n5u3f0xz_wpftmp.sourcelink.json", "JSON", 0, 0, 0, 1, 0, 0, 0, 1
"c:\Users\chris\source\repos\Cell\Cell\obj\Debug\net8.0-windows\Cell_nadxfosn_wpftmp.AssemblyInfo.cs", "C#", 11, 0, 0, 0, 0, 10, 5, 26
"c:\Users\chris\source\repos\Cell\Cell\obj\Debug\net8.0-windows\Cell_nadxfosn_wpftmp.GeneratedMSBuildEditorConfig.editorconfig", "Properties", 0, 0, 0, 0, 21, 0, 1, 22
"c:\Users\chris\source\repos\Cell\Cell\obj\Debug\net8.0-windows\Cell_nadxfosn_wpftmp.GlobalUsings.g.cs", "C#", 5, 0, 0, 0, 0, 1, 1, 7
"c:\Users\chris\source\repos\Cell\Cell\obj\Debug\net8.0-windows\Cell_nadxfosn_wpftmp.sourcelink.json", "JSON", 0, 0, 0, 1, 0, 0, 0, 1
"c:\Users\chris\source\repos\Cell\Cell\obj\Debug\net8.0-windows\Cell_nb5tdydt_wpftmp.AssemblyInfo.cs", "C#", 11, 0, 0, 0, 0, 10, 5, 26
"c:\Users\chris\source\repos\Cell\Cell\obj\Debug\net8.0-windows\Cell_nb5tdydt_wpftmp.GeneratedMSBuildEditorConfig.editorconfig", "Properties", 0, 0, 0, 0, 21, 0, 1, 22
"c:\Users\chris\source\repos\Cell\Cell\obj\Debug\net8.0-windows\Cell_nb5tdydt_wpftmp.GlobalUsings.g.cs", "C#", 5, 0, 0, 0, 0, 1, 1, 7
"c:\Users\chris\source\repos\Cell\Cell\obj\Debug\net8.0-windows\Cell_nb5tdydt_wpftmp.sourcelink.json", "JSON", 0, 0, 0, 1, 0, 0, 0, 1
"c:\Users\chris\source\repos\Cell\Cell\obj\Debug\net8.0-windows\Cell_nc1fwaoe_wpftmp.AssemblyInfo.cs", "C#", 11, 0, 0, 0, 0, 10, 5, 26
"c:\Users\chris\source\repos\Cell\Cell\obj\Debug\net8.0-windows\Cell_nc1fwaoe_wpftmp.GeneratedMSBuildEditorConfig.editorconfig", "Properties", 0, 0, 0, 0, 21, 0, 1, 22
"c:\Users\chris\source\repos\Cell\Cell\obj\Debug\net8.0-windows\Cell_nc1fwaoe_wpftmp.GlobalUsings.g.cs", "C#", 5, 0, 0, 0, 0, 1, 1, 7
"c:\Users\chris\source\repos\Cell\Cell\obj\Debug\net8.0-windows\Cell_nc1fwaoe_wpftmp.sourcelink.json", "JSON", 0, 0, 0, 1, 0, 0, 0, 1
"c:\Users\chris\source\repos\Cell\Cell\obj\Debug\net8.0-windows\Cell_ncj0fyvn_wpftmp.AssemblyInfo.cs", "C#", 11, 0, 0, 0, 0, 10, 5, 26
"c:\Users\chris\source\repos\Cell\Cell\obj\Debug\net8.0-windows\Cell_ncj0fyvn_wpftmp.GeneratedMSBuildEditorConfig.editorconfig", "Properties", 0, 0, 0, 0, 21, 0, 1, 22
"c:\Users\chris\source\repos\Cell\Cell\obj\Debug\net8.0-windows\Cell_ncj0fyvn_wpftmp.GlobalUsings.g.cs", "C#", 5, 0, 0, 0, 0, 1, 1, 7
"c:\Users\chris\source\repos\Cell\Cell\obj\Debug\net8.0-windows\Cell_ncj0fyvn_wpftmp.sourcelink.json", "JSON", 0, 0, 0, 1, 0, 0, 0, 1
"c:\Users\chris\source\repos\Cell\Cell\obj\Debug\net8.0-windows\Cell_ncjeoprc_wpftmp.AssemblyInfo.cs", "C#", 11, 0, 0, 0, 0, 10, 5, 26
"c:\Users\chris\source\repos\Cell\Cell\obj\Debug\net8.0-windows\Cell_ncjeoprc_wpftmp.GeneratedMSBuildEditorConfig.editorconfig", "Properties", 0, 0, 0, 0, 21, 0, 1, 22
"c:\Users\chris\source\repos\Cell\Cell\obj\Debug\net8.0-windows\Cell_ncjeoprc_wpftmp.GlobalUsings.g.cs", "C#", 5, 0, 0, 0, 0, 1, 1, 7
"c:\Users\chris\source\repos\Cell\Cell\obj\Debug\net8.0-windows\Cell_ncjeoprc_wpftmp.sourcelink.json", "JSON", 0, 0, 0, 1, 0, 0, 0, 1
"c:\Users\chris\source\repos\Cell\Cell\obj\Debug\net8.0-windows\Cell_ncpqneat_wpftmp.AssemblyInfo.cs", "C#", 11, 0, 0, 0, 0, 10, 5, 26
"c:\Users\chris\source\repos\Cell\Cell\obj\Debug\net8.0-windows\Cell_ncpqneat_wpftmp.GeneratedMSBuildEditorConfig.editorconfig", "Properties", 0, 0, 0, 0, 21, 0, 1, 22
"c:\Users\chris\source\repos\Cell\Cell\obj\Debug\net8.0-windows\Cell_ncpqneat_wpftmp.GlobalUsings.g.cs", "C#", 5, 0, 0, 0, 0, 1, 1, 7
"c:\Users\chris\source\repos\Cell\Cell\obj\Debug\net8.0-windows\Cell_ncpqneat_wpftmp.sourcelink.json", "JSON", 0, 0, 0, 1, 0, 0, 0, 1
"c:\Users\chris\source\repos\Cell\Cell\obj\Debug\net8.0-windows\Cell_ncrelxus_wpftmp.AssemblyInfo.cs", "C#", 11, 0, 0, 0, 0, 10, 5, 26
"c:\Users\chris\source\repos\Cell\Cell\obj\Debug\net8.0-windows\Cell_ncrelxus_wpftmp.GeneratedMSBuildEditorConfig.editorconfig", "Properties", 0, 0, 0, 0, 21, 0, 1, 22
"c:\Users\chris\source\repos\Cell\Cell\obj\Debug\net8.0-windows\Cell_ncrelxus_wpftmp.GlobalUsings.g.cs", "C#", 5, 0, 0, 0, 0, 1, 1, 7
"c:\Users\chris\source\repos\Cell\Cell\obj\Debug\net8.0-windows\Cell_ncrelxus_wpftmp.sourcelink.json", "JSON", 0, 0, 0, 1, 0, 0, 0, 1
"c:\Users\chris\source\repos\Cell\Cell\obj\Debug\net8.0-windows\Cell_ncytf2xg_wpftmp.AssemblyInfo.cs", "C#", 11, 0, 0, 0, 0, 10, 5, 26
"c:\Users\chris\source\repos\Cell\Cell\obj\Debug\net8.0-windows\Cell_ncytf2xg_wpftmp.GeneratedMSBuildEditorConfig.editorconfig", "Properties", 0, 0, 0, 0, 21, 0, 1, 22
"c:\Users\chris\source\repos\Cell\Cell\obj\Debug\net8.0-windows\Cell_ncytf2xg_wpftmp.GlobalUsings.g.cs", "C#", 5, 0, 0, 0, 0, 1, 1, 7
"c:\Users\chris\source\repos\Cell\Cell\obj\Debug\net8.0-windows\Cell_ncytf2xg_wpftmp.sourcelink.json", "JSON", 0, 0, 0, 1, 0, 0, 0, 1
"c:\Users\chris\source\repos\Cell\Cell\obj\Debug\net8.0-windows\Cell_nczr2tu4_wpftmp.AssemblyInfo.cs", "C#", 11, 0, 0, 0, 0, 10, 5, 26
"c:\Users\chris\source\repos\Cell\Cell\obj\Debug\net8.0-windows\Cell_nczr2tu4_wpftmp.GeneratedMSBuildEditorConfig.editorconfig", "Properties", 0, 0, 0, 0, 21, 0, 1, 22
"c:\Users\chris\source\repos\Cell\Cell\obj\Debug\net8.0-windows\Cell_nczr2tu4_wpftmp.GlobalUsings.g.cs", "C#", 5, 0, 0, 0, 0, 1, 1, 7
"c:\Users\chris\source\repos\Cell\Cell\obj\Debug\net8.0-windows\Cell_nczr2tu4_wpftmp.sourcelink.json", "JSON", 0, 0, 0, 1, 0, 0, 0, 1
"c:\Users\chris\source\repos\Cell\Cell\obj\Debug\net8.0-windows\Cell_nd1pjg1a_wpftmp.AssemblyInfo.cs", "C#", 11, 0, 0, 0, 0, 10, 5, 26
"c:\Users\chris\source\repos\Cell\Cell\obj\Debug\net8.0-windows\Cell_nd1pjg1a_wpftmp.GeneratedMSBuildEditorConfig.editorconfig", "Properties", 0, 0, 0, 0, 21, 0, 1, 22
"c:\Users\chris\source\repos\Cell\Cell\obj\Debug\net8.0-windows\Cell_nd1pjg1a_wpftmp.GlobalUsings.g.cs", "C#", 5, 0, 0, 0, 0, 1, 1, 7
"c:\Users\chris\source\repos\Cell\Cell\obj\Debug\net8.0-windows\Cell_nd1pjg1a_wpftmp.sourcelink.json", "JSON", 0, 0, 0, 1, 0, 0, 0, 1
"c:\Users\chris\source\repos\Cell\Cell\obj\Debug\net8.0-windows\Cell_ndi1vvfk_wpftmp.AssemblyInfo.cs", "C#", 11, 0, 0, 0, 0, 10, 5, 26
"c:\Users\chris\source\repos\Cell\Cell\obj\Debug\net8.0-windows\Cell_ndi1vvfk_wpftmp.GeneratedMSBuildEditorConfig.editorconfig", "Properties", 0, 0, 0, 0, 21, 0, 1, 22
"c:\Users\chris\source\repos\Cell\Cell\obj\Debug\net8.0-windows\Cell_ndi1vvfk_wpftmp.GlobalUsings.g.cs", "C#", 5, 0, 0, 0, 0, 1, 1, 7
"c:\Users\chris\source\repos\Cell\Cell\obj\Debug\net8.0-windows\Cell_ndi1vvfk_wpftmp.sourcelink.json", "JSON", 0, 0, 0, 1, 0, 0, 0, 1
"c:\Users\chris\source\repos\Cell\Cell\obj\Debug\net8.0-windows\Cell_ndrvgagh_wpftmp.AssemblyInfo.cs", "C#", 11, 0, 0, 0, 0, 10, 5, 26
"c:\Users\chris\source\repos\Cell\Cell\obj\Debug\net8.0-windows\Cell_ndrvgagh_wpftmp.GeneratedMSBuildEditorConfig.editorconfig", "Properties", 0, 0, 0, 0, 21, 0, 1, 22
"c:\Users\chris\source\repos\Cell\Cell\obj\Debug\net8.0-windows\Cell_ndrvgagh_wpftmp.GlobalUsings.g.cs", "C#", 5, 0, 0, 0, 0, 1, 1, 7
"c:\Users\chris\source\repos\Cell\Cell\obj\Debug\net8.0-windows\Cell_ndrvgagh_wpftmp.sourcelink.json", "JSON", 0, 0, 0, 1, 0, 0, 0, 1
"c:\Users\chris\source\repos\Cell\Cell\obj\Debug\net8.0-windows\Cell_nejfuuuv_wpftmp.AssemblyInfo.cs", "C#", 11, 0, 0, 0, 0, 10, 5, 26
"c:\Users\chris\source\repos\Cell\Cell\obj\Debug\net8.0-windows\Cell_nejfuuuv_wpftmp.GeneratedMSBuildEditorConfig.editorconfig", "Properties", 0, 0, 0, 0, 21, 0, 1, 22
"c:\Users\chris\source\repos\Cell\Cell\obj\Debug\net8.0-windows\Cell_nejfuuuv_wpftmp.GlobalUsings.g.cs", "C#", 5, 0, 0, 0, 0, 1, 1, 7
"c:\Users\chris\source\repos\Cell\Cell\obj\Debug\net8.0-windows\Cell_nejfuuuv_wpftmp.sourcelink.json", "JSON", 0, 0, 0, 1, 0, 0, 0, 1
"c:\Users\chris\source\repos\Cell\Cell\obj\Debug\net8.0-windows\Cell_ngpoyvsq_wpftmp.AssemblyInfo.cs", "C#", 11, 0, 0, 0, 0, 10, 5, 26
"c:\Users\chris\source\repos\Cell\Cell\obj\Debug\net8.0-windows\Cell_ngpoyvsq_wpftmp.GeneratedMSBuildEditorConfig.editorconfig", "Properties", 0, 0, 0, 0, 21, 0, 1, 22
"c:\Users\chris\source\repos\Cell\Cell\obj\Debug\net8.0-windows\Cell_ngpoyvsq_wpftmp.GlobalUsings.g.cs", "C#", 5, 0, 0, 0, 0, 1, 1, 7
"c:\Users\chris\source\repos\Cell\Cell\obj\Debug\net8.0-windows\Cell_ngpoyvsq_wpftmp.sourcelink.json", "JSON", 0, 0, 0, 1, 0, 0, 0, 1
"c:\Users\chris\source\repos\Cell\Cell\obj\Debug\net8.0-windows\Cell_ngxkg2ov_wpftmp.AssemblyInfo.cs", "C#", 11, 0, 0, 0, 0, 10, 5, 26
"c:\Users\chris\source\repos\Cell\Cell\obj\Debug\net8.0-windows\Cell_ngxkg2ov_wpftmp.GeneratedMSBuildEditorConfig.editorconfig", "Properties", 0, 0, 0, 0, 21, 0, 1, 22
"c:\Users\chris\source\repos\Cell\Cell\obj\Debug\net8.0-windows\Cell_ngxkg2ov_wpftmp.GlobalUsings.g.cs", "C#", 5, 0, 0, 0, 0, 1, 1, 7
"c:\Users\chris\source\repos\Cell\Cell\obj\Debug\net8.0-windows\Cell_ngxkg2ov_wpftmp.sourcelink.json", "JSON", 0, 0, 0, 1, 0, 0, 0, 1
"c:\Users\chris\source\repos\Cell\Cell\obj\Debug\net8.0-windows\Cell_nhaahtf5_wpftmp.AssemblyInfo.cs", "C#", 11, 0, 0, 0, 0, 10, 5, 26
"c:\Users\chris\source\repos\Cell\Cell\obj\Debug\net8.0-windows\Cell_nhaahtf5_wpftmp.GeneratedMSBuildEditorConfig.editorconfig", "Properties", 0, 0, 0, 0, 21, 0, 1, 22
"c:\Users\chris\source\repos\Cell\Cell\obj\Debug\net8.0-windows\Cell_nhaahtf5_wpftmp.GlobalUsings.g.cs", "C#", 5, 0, 0, 0, 0, 1, 1, 7
"c:\Users\chris\source\repos\Cell\Cell\obj\Debug\net8.0-windows\Cell_nhaahtf5_wpftmp.sourcelink.json", "JSON", 0, 0, 0, 1, 0, 0, 0, 1
"c:\Users\chris\source\repos\Cell\Cell\obj\Debug\net8.0-windows\Cell_nhqlksiu_wpftmp.AssemblyInfo.cs", "C#", 11, 0, 0, 0, 0, 10, 5, 26
"c:\Users\chris\source\repos\Cell\Cell\obj\Debug\net8.0-windows\Cell_nhqlksiu_wpftmp.GeneratedMSBuildEditorConfig.editorconfig", "Properties", 0, 0, 0, 0, 21, 0, 1, 22
"c:\Users\chris\source\repos\Cell\Cell\obj\Debug\net8.0-windows\Cell_nhqlksiu_wpftmp.GlobalUsings.g.cs", "C#", 5, 0, 0, 0, 0, 1, 1, 7
"c:\Users\chris\source\repos\Cell\Cell\obj\Debug\net8.0-windows\Cell_nhqlksiu_wpftmp.sourcelink.json", "JSON", 0, 0, 0, 1, 0, 0, 0, 1
"c:\Users\chris\source\repos\Cell\Cell\obj\Debug\net8.0-windows\Cell_nijzrjax_wpftmp.AssemblyInfo.cs", "C#", 11, 0, 0, 0, 0, 10, 5, 26
"c:\Users\chris\source\repos\Cell\Cell\obj\Debug\net8.0-windows\Cell_nijzrjax_wpftmp.GeneratedMSBuildEditorConfig.editorconfig", "Properties", 0, 0, 0, 0, 13, 0, 1, 14
"c:\Users\chris\source\repos\Cell\Cell\obj\Debug\net8.0-windows\Cell_nijzrjax_wpftmp.GlobalUsings.g.cs", "C#", 5, 0, 0, 0, 0, 1, 1, 7
"c:\Users\chris\source\repos\Cell\Cell\obj\Debug\net8.0-windows\Cell_nivfk32y_wpftmp.AssemblyInfo.cs", "C#", 11, 0, 0, 0, 0, 10, 5, 26
"c:\Users\chris\source\repos\Cell\Cell\obj\Debug\net8.0-windows\Cell_nivfk32y_wpftmp.GeneratedMSBuildEditorConfig.editorconfig", "Properties", 0, 0, 0, 0, 21, 0, 1, 22
"c:\Users\chris\source\repos\Cell\Cell\obj\Debug\net8.0-windows\Cell_nivfk32y_wpftmp.GlobalUsings.g.cs", "C#", 5, 0, 0, 0, 0, 1, 1, 7
"c:\Users\chris\source\repos\Cell\Cell\obj\Debug\net8.0-windows\Cell_nivfk32y_wpftmp.sourcelink.json", "JSON", 0, 0, 0, 1, 0, 0, 0, 1
"c:\Users\chris\source\repos\Cell\Cell\obj\Debug\net8.0-windows\Cell_nk4354as_wpftmp.AssemblyInfo.cs", "C#", 11, 0, 0, 0, 0, 10, 5, 26
"c:\Users\chris\source\repos\Cell\Cell\obj\Debug\net8.0-windows\Cell_nk4354as_wpftmp.GeneratedMSBuildEditorConfig.editorconfig", "Properties", 0, 0, 0, 0, 21, 0, 1, 22
"c:\Users\chris\source\repos\Cell\Cell\obj\Debug\net8.0-windows\Cell_nk4354as_wpftmp.GlobalUsings.g.cs", "C#", 5, 0, 0, 0, 0, 1, 1, 7
"c:\Users\chris\source\repos\Cell\Cell\obj\Debug\net8.0-windows\Cell_nkbqaosg_wpftmp.AssemblyInfo.cs", "C#", 11, 0, 0, 0, 0, 10, 5, 26
"c:\Users\chris\source\repos\Cell\Cell\obj\Debug\net8.0-windows\Cell_nkbqaosg_wpftmp.GeneratedMSBuildEditorConfig.editorconfig", "Properties", 0, 0, 0, 0, 13, 0, 1, 14
"c:\Users\chris\source\repos\Cell\Cell\obj\Debug\net8.0-windows\Cell_nkbqaosg_wpftmp.GlobalUsings.g.cs", "C#", 5, 0, 0, 0, 0, 1, 1, 7
"c:\Users\chris\source\repos\Cell\Cell\obj\Debug\net8.0-windows\Cell_nkwrnaoh_wpftmp.AssemblyInfo.cs", "C#", 11, 0, 0, 0, 0, 10, 5, 26
"c:\Users\chris\source\repos\Cell\Cell\obj\Debug\net8.0-windows\Cell_nkwrnaoh_wpftmp.GeneratedMSBuildEditorConfig.editorconfig", "Properties", 0, 0, 0, 0, 21, 0, 1, 22
"c:\Users\chris\source\repos\Cell\Cell\obj\Debug\net8.0-windows\Cell_nkwrnaoh_wpftmp.GlobalUsings.g.cs", "C#", 5, 0, 0, 0, 0, 1, 1, 7
"c:\Users\chris\source\repos\Cell\Cell\obj\Debug\net8.0-windows\Cell_nkwrnaoh_wpftmp.sourcelink.json", "JSON", 0, 0, 0, 1, 0, 0, 0, 1
"c:\Users\chris\source\repos\Cell\Cell\obj\Debug\net8.0-windows\Cell_nlffhfyz_wpftmp.AssemblyInfo.cs", "C#", 11, 0, 0, 0, 0, 10, 5, 26
"c:\Users\chris\source\repos\Cell\Cell\obj\Debug\net8.0-windows\Cell_nlffhfyz_wpftmp.GeneratedMSBuildEditorConfig.editorconfig", "Properties", 0, 0, 0, 0, 21, 0, 1, 22
"c:\Users\chris\source\repos\Cell\Cell\obj\Debug\net8.0-windows\Cell_nlffhfyz_wpftmp.GlobalUsings.g.cs", "C#", 5, 0, 0, 0, 0, 1, 1, 7
"c:\Users\chris\source\repos\Cell\Cell\obj\Debug\net8.0-windows\Cell_nlffhfyz_wpftmp.sourcelink.json", "JSON", 0, 0, 0, 1, 0, 0, 0, 1
"c:\Users\chris\source\repos\Cell\Cell\obj\Debug\net8.0-windows\Cell_nlvgle3a_wpftmp.AssemblyInfo.cs", "C#", 11, 0, 0, 0, 0, 10, 5, 26
"c:\Users\chris\source\repos\Cell\Cell\obj\Debug\net8.0-windows\Cell_nlvgle3a_wpftmp.GeneratedMSBuildEditorConfig.editorconfig", "Properties", 0, 0, 0, 0, 13, 0, 1, 14
"c:\Users\chris\source\repos\Cell\Cell\obj\Debug\net8.0-windows\Cell_nlvgle3a_wpftmp.GlobalUsings.g.cs", "C#", 5, 0, 0, 0, 0, 1, 1, 7
"c:\Users\chris\source\repos\Cell\Cell\obj\Debug\net8.0-windows\Cell_nmh0kdvp_wpftmp.AssemblyInfo.cs", "C#", 11, 0, 0, 0, 0, 10, 5, 26
"c:\Users\chris\source\repos\Cell\Cell\obj\Debug\net8.0-windows\Cell_nmh0kdvp_wpftmp.GeneratedMSBuildEditorConfig.editorconfig", "Properties", 0, 0, 0, 0, 21, 0, 1, 22
"c:\Users\chris\source\repos\Cell\Cell\obj\Debug\net8.0-windows\Cell_nmh0kdvp_wpftmp.GlobalUsings.g.cs", "C#", 5, 0, 0, 0, 0, 1, 1, 7
"c:\Users\chris\source\repos\Cell\Cell\obj\Debug\net8.0-windows\Cell_nmh0kdvp_wpftmp.sourcelink.json", "JSON", 0, 0, 0, 1, 0, 0, 0, 1
"c:\Users\chris\source\repos\Cell\Cell\obj\Debug\net8.0-windows\Cell_nnbeoeld_wpftmp.AssemblyInfo.cs", "C#", 11, 0, 0, 0, 0, 10, 5, 26
"c:\Users\chris\source\repos\Cell\Cell\obj\Debug\net8.0-windows\Cell_nnbeoeld_wpftmp.GeneratedMSBuildEditorConfig.editorconfig", "Properties", 0, 0, 0, 0, 21, 0, 1, 22
"c:\Users\chris\source\repos\Cell\Cell\obj\Debug\net8.0-windows\Cell_nnbeoeld_wpftmp.GlobalUsings.g.cs", "C#", 5, 0, 0, 0, 0, 1, 1, 7
"c:\Users\chris\source\repos\Cell\Cell\obj\Debug\net8.0-windows\Cell_nnbeoeld_wpftmp.sourcelink.json", "JSON", 0, 0, 0, 1, 0, 0, 0, 1
"c:\Users\chris\source\repos\Cell\Cell\obj\Debug\net8.0-windows\Cell_nnjqqfkb_wpftmp.AssemblyInfo.cs", "C#", 11, 0, 0, 0, 0, 10, 5, 26
"c:\Users\chris\source\repos\Cell\Cell\obj\Debug\net8.0-windows\Cell_nnjqqfkb_wpftmp.GeneratedMSBuildEditorConfig.editorconfig", "Properties", 0, 0, 0, 0, 21, 0, 1, 22
"c:\Users\chris\source\repos\Cell\Cell\obj\Debug\net8.0-windows\Cell_nnjqqfkb_wpftmp.GlobalUsings.g.cs", "C#", 5, 0, 0, 0, 0, 1, 1, 7
"c:\Users\chris\source\repos\Cell\Cell\obj\Debug\net8.0-windows\Cell_nnjqqfkb_wpftmp.sourcelink.json", "JSON", 0, 0, 0, 1, 0, 0, 0, 1
"c:\Users\chris\source\repos\Cell\Cell\obj\Debug\net8.0-windows\Cell_nnjsqo30_wpftmp.AssemblyInfo.cs", "C#", 11, 0, 0, 0, 0, 10, 5, 26
"c:\Users\chris\source\repos\Cell\Cell\obj\Debug\net8.0-windows\Cell_nnjsqo30_wpftmp.GeneratedMSBuildEditorConfig.editorconfig", "Properties", 0, 0, 0, 0, 21, 0, 1, 22
"c:\Users\chris\source\repos\Cell\Cell\obj\Debug\net8.0-windows\Cell_nnjsqo30_wpftmp.GlobalUsings.g.cs", "C#", 5, 0, 0, 0, 0, 1, 1, 7
"c:\Users\chris\source\repos\Cell\Cell\obj\Debug\net8.0-windows\Cell_nnjsqo30_wpftmp.sourcelink.json", "JSON", 0, 0, 0, 1, 0, 0, 0, 1
"c:\Users\chris\source\repos\Cell\Cell\obj\Debug\net8.0-windows\Cell_nort0dil_wpftmp.AssemblyInfo.cs", "C#", 11, 0, 0, 0, 0, 10, 5, 26
"c:\Users\chris\source\repos\Cell\Cell\obj\Debug\net8.0-windows\Cell_nort0dil_wpftmp.GeneratedMSBuildEditorConfig.editorconfig", "Properties", 0, 0, 0, 0, 21, 0, 1, 22
"c:\Users\chris\source\repos\Cell\Cell\obj\Debug\net8.0-windows\Cell_nort0dil_wpftmp.GlobalUsings.g.cs", "C#", 5, 0, 0, 0, 0, 1, 1, 7
"c:\Users\chris\source\repos\Cell\Cell\obj\Debug\net8.0-windows\Cell_nort0dil_wpftmp.sourcelink.json", "JSON", 0, 0, 0, 1, 0, 0, 0, 1
"c:\Users\chris\source\repos\Cell\Cell\obj\Debug\net8.0-windows\Cell_noy0i3pe_wpftmp.AssemblyInfo.cs", "C#", 11, 0, 0, 0, 0, 10, 5, 26
"c:\Users\chris\source\repos\Cell\Cell\obj\Debug\net8.0-windows\Cell_noy0i3pe_wpftmp.GeneratedMSBuildEditorConfig.editorconfig", "Properties", 0, 0, 0, 0, 13, 0, 1, 14
"c:\Users\chris\source\repos\Cell\Cell\obj\Debug\net8.0-windows\Cell_noy0i3pe_wpftmp.GlobalUsings.g.cs", "C#", 5, 0, 0, 0, 0, 1, 1, 7
"c:\Users\chris\source\repos\Cell\Cell\obj\Debug\net8.0-windows\Cell_npbjbwif_wpftmp.AssemblyInfo.cs", "C#", 11, 0, 0, 0, 0, 10, 5, 26
"c:\Users\chris\source\repos\Cell\Cell\obj\Debug\net8.0-windows\Cell_npbjbwif_wpftmp.GeneratedMSBuildEditorConfig.editorconfig", "Properties", 0, 0, 0, 0, 21, 0, 1, 22
"c:\Users\chris\source\repos\Cell\Cell\obj\Debug\net8.0-windows\Cell_npbjbwif_wpftmp.GlobalUsings.g.cs", "C#", 5, 0, 0, 0, 0, 1, 1, 7
"c:\Users\chris\source\repos\Cell\Cell\obj\Debug\net8.0-windows\Cell_npbjbwif_wpftmp.sourcelink.json", "JSON", 0, 0, 0, 1, 0, 0, 0, 1
"c:\Users\chris\source\repos\Cell\Cell\obj\Debug\net8.0-windows\Cell_npqdbo1f_wpftmp.AssemblyInfo.cs", "C#", 11, 0, 0, 0, 0, 10, 5, 26
"c:\Users\chris\source\repos\Cell\Cell\obj\Debug\net8.0-windows\Cell_npqdbo1f_wpftmp.GeneratedMSBuildEditorConfig.editorconfig", "Properties", 0, 0, 0, 0, 21, 0, 1, 22
"c:\Users\chris\source\repos\Cell\Cell\obj\Debug\net8.0-windows\Cell_npqdbo1f_wpftmp.GlobalUsings.g.cs", "C#", 5, 0, 0, 0, 0, 1, 1, 7
"c:\Users\chris\source\repos\Cell\Cell\obj\Debug\net8.0-windows\Cell_npqdbo1f_wpftmp.sourcelink.json", "JSON", 0, 0, 0, 1, 0, 0, 0, 1
"c:\Users\chris\source\repos\Cell\Cell\obj\Debug\net8.0-windows\Cell_ntwbon5g_wpftmp.AssemblyInfo.cs", "C#", 11, 0, 0, 0, 0, 10, 5, 26
"c:\Users\chris\source\repos\Cell\Cell\obj\Debug\net8.0-windows\Cell_ntwbon5g_wpftmp.GeneratedMSBuildEditorConfig.editorconfig", "Properties", 0, 0, 0, 0, 21, 0, 1, 22
"c:\Users\chris\source\repos\Cell\Cell\obj\Debug\net8.0-windows\Cell_ntwbon5g_wpftmp.GlobalUsings.g.cs", "C#", 5, 0, 0, 0, 0, 1, 1, 7
"c:\Users\chris\source\repos\Cell\Cell\obj\Debug\net8.0-windows\Cell_ntwbon5g_wpftmp.sourcelink.json", "JSON", 0, 0, 0, 1, 0, 0, 0, 1
"c:\Users\chris\source\repos\Cell\Cell\obj\Debug\net8.0-windows\Cell_nu5ee2ri_wpftmp.AssemblyInfo.cs", "C#", 11, 0, 0, 0, 0, 10, 5, 26
"c:\Users\chris\source\repos\Cell\Cell\obj\Debug\net8.0-windows\Cell_nu5ee2ri_wpftmp.GeneratedMSBuildEditorConfig.editorconfig", "Properties", 0, 0, 0, 0, 21, 0, 1, 22
"c:\Users\chris\source\repos\Cell\Cell\obj\Debug\net8.0-windows\Cell_nu5ee2ri_wpftmp.GlobalUsings.g.cs", "C#", 5, 0, 0, 0, 0, 1, 1, 7
"c:\Users\chris\source\repos\Cell\Cell\obj\Debug\net8.0-windows\Cell_nu5ee2ri_wpftmp.sourcelink.json", "JSON", 0, 0, 0, 1, 0, 0, 0, 1
"c:\Users\chris\source\repos\Cell\Cell\obj\Debug\net8.0-windows\Cell_nuqabnmi_wpftmp.AssemblyInfo.cs", "C#", 11, 0, 0, 0, 0, 10, 5, 26
"c:\Users\chris\source\repos\Cell\Cell\obj\Debug\net8.0-windows\Cell_nuqabnmi_wpftmp.GeneratedMSBuildEditorConfig.editorconfig", "Properties", 0, 0, 0, 0, 21, 0, 1, 22
"c:\Users\chris\source\repos\Cell\Cell\obj\Debug\net8.0-windows\Cell_nuqabnmi_wpftmp.GlobalUsings.g.cs", "C#", 5, 0, 0, 0, 0, 1, 1, 7
"c:\Users\chris\source\repos\Cell\Cell\obj\Debug\net8.0-windows\Cell_nuqabnmi_wpftmp.sourcelink.json", "JSON", 0, 0, 0, 1, 0, 0, 0, 1
"c:\Users\chris\source\repos\Cell\Cell\obj\Debug\net8.0-windows\Cell_nuuxyghs_wpftmp.AssemblyInfo.cs", "C#", 11, 0, 0, 0, 0, 10, 5, 26
"c:\Users\chris\source\repos\Cell\Cell\obj\Debug\net8.0-windows\Cell_nuuxyghs_wpftmp.GeneratedMSBuildEditorConfig.editorconfig", "Properties", 0, 0, 0, 0, 21, 0, 1, 22
"c:\Users\chris\source\repos\Cell\Cell\obj\Debug\net8.0-windows\Cell_nuuxyghs_wpftmp.GlobalUsings.g.cs", "C#", 5, 0, 0, 0, 0, 1, 1, 7
"c:\Users\chris\source\repos\Cell\Cell\obj\Debug\net8.0-windows\Cell_nuuxyghs_wpftmp.sourcelink.json", "JSON", 0, 0, 0, 1, 0, 0, 0, 1
"c:\Users\chris\source\repos\Cell\Cell\obj\Debug\net8.0-windows\Cell_nw43indk_wpftmp.AssemblyInfo.cs", "C#", 11, 0, 0, 0, 0, 10, 5, 26
"c:\Users\chris\source\repos\Cell\Cell\obj\Debug\net8.0-windows\Cell_nw43indk_wpftmp.GeneratedMSBuildEditorConfig.editorconfig", "Properties", 0, 0, 0, 0, 21, 0, 1, 22
"c:\Users\chris\source\repos\Cell\Cell\obj\Debug\net8.0-windows\Cell_nw43indk_wpftmp.GlobalUsings.g.cs", "C#", 5, 0, 0, 0, 0, 1, 1, 7
"c:\Users\chris\source\repos\Cell\Cell\obj\Debug\net8.0-windows\Cell_nw43indk_wpftmp.sourcelink.json", "JSON", 0, 0, 0, 1, 0, 0, 0, 1
"c:\Users\chris\source\repos\Cell\Cell\obj\Debug\net8.0-windows\Cell_nx10hma0_wpftmp.AssemblyInfo.cs", "C#", 11, 0, 0, 0, 0, 10, 5, 26
"c:\Users\chris\source\repos\Cell\Cell\obj\Debug\net8.0-windows\Cell_nx10hma0_wpftmp.GeneratedMSBuildEditorConfig.editorconfig", "Properties", 0, 0, 0, 0, 21, 0, 1, 22
"c:\Users\chris\source\repos\Cell\Cell\obj\Debug\net8.0-windows\Cell_nx10hma0_wpftmp.GlobalUsings.g.cs", "C#", 5, 0, 0, 0, 0, 1, 1, 7
"c:\Users\chris\source\repos\Cell\Cell\obj\Debug\net8.0-windows\Cell_nx10hma0_wpftmp.sourcelink.json", "JSON", 0, 0, 0, 1, 0, 0, 0, 1
"c:\Users\chris\source\repos\Cell\Cell\obj\Debug\net8.0-windows\Cell_nxvi5p3q_wpftmp.AssemblyInfo.cs", "C#", 11, 0, 0, 0, 0, 10, 5, 26
"c:\Users\chris\source\repos\Cell\Cell\obj\Debug\net8.0-windows\Cell_nxvi5p3q_wpftmp.GeneratedMSBuildEditorConfig.editorconfig", "Properties", 0, 0, 0, 0, 21, 0, 1, 22
"c:\Users\chris\source\repos\Cell\Cell\obj\Debug\net8.0-windows\Cell_nxvi5p3q_wpftmp.GlobalUsings.g.cs", "C#", 5, 0, 0, 0, 0, 1, 1, 7
"c:\Users\chris\source\repos\Cell\Cell\obj\Debug\net8.0-windows\Cell_nxvi5p3q_wpftmp.sourcelink.json", "JSON", 0, 0, 0, 1, 0, 0, 0, 1
"c:\Users\chris\source\repos\Cell\Cell\obj\Debug\net8.0-windows\Cell_o0c3hjlf_wpftmp.AssemblyInfo.cs", "C#", 11, 0, 0, 0, 0, 10, 5, 26
"c:\Users\chris\source\repos\Cell\Cell\obj\Debug\net8.0-windows\Cell_o0c3hjlf_wpftmp.GeneratedMSBuildEditorConfig.editorconfig", "Properties", 0, 0, 0, 0, 21, 0, 1, 22
"c:\Users\chris\source\repos\Cell\Cell\obj\Debug\net8.0-windows\Cell_o0c3hjlf_wpftmp.GlobalUsings.g.cs", "C#", 5, 0, 0, 0, 0, 1, 1, 7
"c:\Users\chris\source\repos\Cell\Cell\obj\Debug\net8.0-windows\Cell_o0c3hjlf_wpftmp.sourcelink.json", "JSON", 0, 0, 0, 1, 0, 0, 0, 1
"c:\Users\chris\source\repos\Cell\Cell\obj\Debug\net8.0-windows\Cell_o0ljeeef_wpftmp.AssemblyInfo.cs", "C#", 11, 0, 0, 0, 0, 10, 5, 26
"c:\Users\chris\source\repos\Cell\Cell\obj\Debug\net8.0-windows\Cell_o0ljeeef_wpftmp.GeneratedMSBuildEditorConfig.editorconfig", "Properties", 0, 0, 0, 0, 13, 0, 1, 14
"c:\Users\chris\source\repos\Cell\Cell\obj\Debug\net8.0-windows\Cell_o0ljeeef_wpftmp.GlobalUsings.g.cs", "C#", 5, 0, 0, 0, 0, 1, 1, 7
"c:\Users\chris\source\repos\Cell\Cell\obj\Debug\net8.0-windows\Cell_o0zmbavh_wpftmp.AssemblyInfo.cs", "C#", 11, 0, 0, 0, 0, 10, 5, 26
"c:\Users\chris\source\repos\Cell\Cell\obj\Debug\net8.0-windows\Cell_o0zmbavh_wpftmp.GeneratedMSBuildEditorConfig.editorconfig", "Properties", 0, 0, 0, 0, 13, 0, 1, 14
"c:\Users\chris\source\repos\Cell\Cell\obj\Debug\net8.0-windows\Cell_o0zmbavh_wpftmp.GlobalUsings.g.cs", "C#", 5, 0, 0, 0, 0, 1, 1, 7
"c:\Users\chris\source\repos\Cell\Cell\obj\Debug\net8.0-windows\Cell_o2j4qwwl_wpftmp.AssemblyInfo.cs", "C#", 11, 0, 0, 0, 0, 10, 5, 26
"c:\Users\chris\source\repos\Cell\Cell\obj\Debug\net8.0-windows\Cell_o2j4qwwl_wpftmp.GeneratedMSBuildEditorConfig.editorconfig", "Properties", 0, 0, 0, 0, 21, 0, 1, 22
"c:\Users\chris\source\repos\Cell\Cell\obj\Debug\net8.0-windows\Cell_o2j4qwwl_wpftmp.GlobalUsings.g.cs", "C#", 5, 0, 0, 0, 0, 1, 1, 7
"c:\Users\chris\source\repos\Cell\Cell\obj\Debug\net8.0-windows\Cell_o2j4qwwl_wpftmp.sourcelink.json", "JSON", 0, 0, 0, 1, 0, 0, 0, 1
"c:\Users\chris\source\repos\Cell\Cell\obj\Debug\net8.0-windows\Cell_o2xdmkni_wpftmp.AssemblyInfo.cs", "C#", 11, 0, 0, 0, 0, 10, 5, 26
"c:\Users\chris\source\repos\Cell\Cell\obj\Debug\net8.0-windows\Cell_o2xdmkni_wpftmp.GeneratedMSBuildEditorConfig.editorconfig", "Properties", 0, 0, 0, 0, 21, 0, 1, 22
"c:\Users\chris\source\repos\Cell\Cell\obj\Debug\net8.0-windows\Cell_o2xdmkni_wpftmp.GlobalUsings.g.cs", "C#", 5, 0, 0, 0, 0, 1, 1, 7
"c:\Users\chris\source\repos\Cell\Cell\obj\Debug\net8.0-windows\Cell_o2xdmkni_wpftmp.sourcelink.json", "JSON", 0, 0, 0, 1, 0, 0, 0, 1
"c:\Users\chris\source\repos\Cell\Cell\obj\Debug\net8.0-windows\Cell_o3rp0lkj_wpftmp.AssemblyInfo.cs", "C#", 11, 0, 0, 0, 0, 10, 5, 26
"c:\Users\chris\source\repos\Cell\Cell\obj\Debug\net8.0-windows\Cell_o3rp0lkj_wpftmp.GeneratedMSBuildEditorConfig.editorconfig", "Properties", 0, 0, 0, 0, 13, 0, 1, 14
"c:\Users\chris\source\repos\Cell\Cell\obj\Debug\net8.0-windows\Cell_o3rp0lkj_wpftmp.GlobalUsings.g.cs", "C#", 5, 0, 0, 0, 0, 1, 1, 7
"c:\Users\chris\source\repos\Cell\Cell\obj\Debug\net8.0-windows\Cell_o5asmb2i_wpftmp.AssemblyInfo.cs", "C#", 11, 0, 0, 0, 0, 10, 5, 26
"c:\Users\chris\source\repos\Cell\Cell\obj\Debug\net8.0-windows\Cell_o5asmb2i_wpftmp.GeneratedMSBuildEditorConfig.editorconfig", "Properties", 0, 0, 0, 0, 21, 0, 1, 22
"c:\Users\chris\source\repos\Cell\Cell\obj\Debug\net8.0-windows\Cell_o5asmb2i_wpftmp.GlobalUsings.g.cs", "C#", 5, 0, 0, 0, 0, 1, 1, 7
"c:\Users\chris\source\repos\Cell\Cell\obj\Debug\net8.0-windows\Cell_o5asmb2i_wpftmp.sourcelink.json", "JSON", 0, 0, 0, 1, 0, 0, 0, 1
"c:\Users\chris\source\repos\Cell\Cell\obj\Debug\net8.0-windows\Cell_obik3oro_wpftmp.AssemblyInfo.cs", "C#", 11, 0, 0, 0, 0, 10, 5, 26
"c:\Users\chris\source\repos\Cell\Cell\obj\Debug\net8.0-windows\Cell_obik3oro_wpftmp.GeneratedMSBuildEditorConfig.editorconfig", "Properties", 0, 0, 0, 0, 21, 0, 1, 22
"c:\Users\chris\source\repos\Cell\Cell\obj\Debug\net8.0-windows\Cell_obik3oro_wpftmp.GlobalUsings.g.cs", "C#", 5, 0, 0, 0, 0, 1, 1, 7
"c:\Users\chris\source\repos\Cell\Cell\obj\Debug\net8.0-windows\Cell_obik3oro_wpftmp.sourcelink.json", "JSON", 0, 0, 0, 1, 0, 0, 0, 1
"c:\Users\chris\source\repos\Cell\Cell\obj\Debug\net8.0-windows\Cell_obkgqkti_wpftmp.AssemblyInfo.cs", "C#", 11, 0, 0, 0, 0, 10, 5, 26
"c:\Users\chris\source\repos\Cell\Cell\obj\Debug\net8.0-windows\Cell_obkgqkti_wpftmp.GeneratedMSBuildEditorConfig.editorconfig", "Properties", 0, 0, 0, 0, 21, 0, 1, 22
"c:\Users\chris\source\repos\Cell\Cell\obj\Debug\net8.0-windows\Cell_obkgqkti_wpftmp.GlobalUsings.g.cs", "C#", 5, 0, 0, 0, 0, 1, 1, 7
"c:\Users\chris\source\repos\Cell\Cell\obj\Debug\net8.0-windows\Cell_obkgqkti_wpftmp.sourcelink.json", "JSON", 0, 0, 0, 1, 0, 0, 0, 1
"c:\Users\chris\source\repos\Cell\Cell\obj\Debug\net8.0-windows\Cell_obm254bv_wpftmp.AssemblyInfo.cs", "C#", 11, 0, 0, 0, 0, 10, 5, 26
"c:\Users\chris\source\repos\Cell\Cell\obj\Debug\net8.0-windows\Cell_obm254bv_wpftmp.GeneratedMSBuildEditorConfig.editorconfig", "Properties", 0, 0, 0, 0, 21, 0, 1, 22
"c:\Users\chris\source\repos\Cell\Cell\obj\Debug\net8.0-windows\Cell_obm254bv_wpftmp.GlobalUsings.g.cs", "C#", 5, 0, 0, 0, 0, 1, 1, 7
"c:\Users\chris\source\repos\Cell\Cell\obj\Debug\net8.0-windows\Cell_obm254bv_wpftmp.sourcelink.json", "JSON", 0, 0, 0, 1, 0, 0, 0, 1
"c:\Users\chris\source\repos\Cell\Cell\obj\Debug\net8.0-windows\Cell_ocfsd2or_wpftmp.AssemblyInfo.cs", "C#", 11, 0, 0, 0, 0, 10, 5, 26
"c:\Users\chris\source\repos\Cell\Cell\obj\Debug\net8.0-windows\Cell_ocfsd2or_wpftmp.GeneratedMSBuildEditorConfig.editorconfig", "Properties", 0, 0, 0, 0, 21, 0, 1, 22
"c:\Users\chris\source\repos\Cell\Cell\obj\Debug\net8.0-windows\Cell_ocfsd2or_wpftmp.GlobalUsings.g.cs", "C#", 5, 0, 0, 0, 0, 1, 1, 7
"c:\Users\chris\source\repos\Cell\Cell\obj\Debug\net8.0-windows\Cell_ocfsd2or_wpftmp.sourcelink.json", "JSON", 0, 0, 0, 1, 0, 0, 0, 1
"c:\Users\chris\source\repos\Cell\Cell\obj\Debug\net8.0-windows\Cell_odefinld_wpftmp.AssemblyInfo.cs", "C#", 11, 0, 0, 0, 0, 10, 5, 26
"c:\Users\chris\source\repos\Cell\Cell\obj\Debug\net8.0-windows\Cell_odefinld_wpftmp.GeneratedMSBuildEditorConfig.editorconfig", "Properties", 0, 0, 0, 0, 13, 0, 1, 14
"c:\Users\chris\source\repos\Cell\Cell\obj\Debug\net8.0-windows\Cell_odefinld_wpftmp.GlobalUsings.g.cs", "C#", 5, 0, 0, 0, 0, 1, 1, 7
"c:\Users\chris\source\repos\Cell\Cell\obj\Debug\net8.0-windows\Cell_odls2m3b_wpftmp.AssemblyInfo.cs", "C#", 11, 0, 0, 0, 0, 10, 5, 26
"c:\Users\chris\source\repos\Cell\Cell\obj\Debug\net8.0-windows\Cell_odls2m3b_wpftmp.GeneratedMSBuildEditorConfig.editorconfig", "Properties", 0, 0, 0, 0, 21, 0, 1, 22
"c:\Users\chris\source\repos\Cell\Cell\obj\Debug\net8.0-windows\Cell_odls2m3b_wpftmp.GlobalUsings.g.cs", "C#", 5, 0, 0, 0, 0, 1, 1, 7
"c:\Users\chris\source\repos\Cell\Cell\obj\Debug\net8.0-windows\Cell_odls2m3b_wpftmp.sourcelink.json", "JSON", 0, 0, 0, 1, 0, 0, 0, 1
"c:\Users\chris\source\repos\Cell\Cell\obj\Debug\net8.0-windows\Cell_odsmdje2_wpftmp.AssemblyInfo.cs", "C#", 11, 0, 0, 0, 0, 10, 5, 26
"c:\Users\chris\source\repos\Cell\Cell\obj\Debug\net8.0-windows\Cell_odsmdje2_wpftmp.GeneratedMSBuildEditorConfig.editorconfig", "Properties", 0, 0, 0, 0, 21, 0, 1, 22
"c:\Users\chris\source\repos\Cell\Cell\obj\Debug\net8.0-windows\Cell_odsmdje2_wpftmp.GlobalUsings.g.cs", "C#", 5, 0, 0, 0, 0, 1, 1, 7
"c:\Users\chris\source\repos\Cell\Cell\obj\Debug\net8.0-windows\Cell_odsmdje2_wpftmp.sourcelink.json", "JSON", 0, 0, 0, 1, 0, 0, 0, 1
"c:\Users\chris\source\repos\Cell\Cell\obj\Debug\net8.0-windows\Cell_oe1xwh50_wpftmp.AssemblyInfo.cs", "C#", 11, 0, 0, 0, 0, 10, 5, 26
"c:\Users\chris\source\repos\Cell\Cell\obj\Debug\net8.0-windows\Cell_oe1xwh50_wpftmp.GeneratedMSBuildEditorConfig.editorconfig", "Properties", 0, 0, 0, 0, 21, 0, 1, 22
"c:\Users\chris\source\repos\Cell\Cell\obj\Debug\net8.0-windows\Cell_oe1xwh50_wpftmp.GlobalUsings.g.cs", "C#", 5, 0, 0, 0, 0, 1, 1, 7
"c:\Users\chris\source\repos\Cell\Cell\obj\Debug\net8.0-windows\Cell_oe1xwh50_wpftmp.sourcelink.json", "JSON", 0, 0, 0, 1, 0, 0, 0, 1
"c:\Users\chris\source\repos\Cell\Cell\obj\Debug\net8.0-windows\Cell_of5iydpd_wpftmp.AssemblyInfo.cs", "C#", 11, 0, 0, 0, 0, 10, 5, 26
"c:\Users\chris\source\repos\Cell\Cell\obj\Debug\net8.0-windows\Cell_of5iydpd_wpftmp.GeneratedMSBuildEditorConfig.editorconfig", "Properties", 0, 0, 0, 0, 13, 0, 1, 14
"c:\Users\chris\source\repos\Cell\Cell\obj\Debug\net8.0-windows\Cell_of5iydpd_wpftmp.GlobalUsings.g.cs", "C#", 5, 0, 0, 0, 0, 1, 1, 7
"c:\Users\chris\source\repos\Cell\Cell\obj\Debug\net8.0-windows\Cell_ogfoscqx_wpftmp.AssemblyInfo.cs", "C#", 11, 0, 0, 0, 0, 10, 5, 26
"c:\Users\chris\source\repos\Cell\Cell\obj\Debug\net8.0-windows\Cell_ogfoscqx_wpftmp.GeneratedMSBuildEditorConfig.editorconfig", "Properties", 0, 0, 0, 0, 21, 0, 1, 22
"c:\Users\chris\source\repos\Cell\Cell\obj\Debug\net8.0-windows\Cell_ogfoscqx_wpftmp.GlobalUsings.g.cs", "C#", 5, 0, 0, 0, 0, 1, 1, 7
"c:\Users\chris\source\repos\Cell\Cell\obj\Debug\net8.0-windows\Cell_ogfoscqx_wpftmp.sourcelink.json", "JSON", 0, 0, 0, 1, 0, 0, 0, 1
"c:\Users\chris\source\repos\Cell\Cell\obj\Debug\net8.0-windows\Cell_ojonneiu_wpftmp.AssemblyInfo.cs", "C#", 11, 0, 0, 0, 0, 10, 5, 26
"c:\Users\chris\source\repos\Cell\Cell\obj\Debug\net8.0-windows\Cell_ojonneiu_wpftmp.GeneratedMSBuildEditorConfig.editorconfig", "Properties", 0, 0, 0, 0, 13, 0, 1, 14
"c:\Users\chris\source\repos\Cell\Cell\obj\Debug\net8.0-windows\Cell_ojonneiu_wpftmp.GlobalUsings.g.cs", "C#", 5, 0, 0, 0, 0, 1, 1, 7
"c:\Users\chris\source\repos\Cell\Cell\obj\Debug\net8.0-windows\Cell_on5ynlun_wpftmp.AssemblyInfo.cs", "C#", 11, 0, 0, 0, 0, 10, 5, 26
"c:\Users\chris\source\repos\Cell\Cell\obj\Debug\net8.0-windows\Cell_on5ynlun_wpftmp.GeneratedMSBuildEditorConfig.editorconfig", "Properties", 0, 0, 0, 0, 21, 0, 1, 22
"c:\Users\chris\source\repos\Cell\Cell\obj\Debug\net8.0-windows\Cell_on5ynlun_wpftmp.GlobalUsings.g.cs", "C#", 5, 0, 0, 0, 0, 1, 1, 7
"c:\Users\chris\source\repos\Cell\Cell\obj\Debug\net8.0-windows\Cell_on5ynlun_wpftmp.sourcelink.json", "JSON", 0, 0, 0, 1, 0, 0, 0, 1
"c:\Users\chris\source\repos\Cell\Cell\obj\Debug\net8.0-windows\Cell_onn2yapk_wpftmp.AssemblyInfo.cs", "C#", 11, 0, 0, 0, 0, 10, 5, 26
"c:\Users\chris\source\repos\Cell\Cell\obj\Debug\net8.0-windows\Cell_onn2yapk_wpftmp.GeneratedMSBuildEditorConfig.editorconfig", "Properties", 0, 0, 0, 0, 21, 0, 1, 22
"c:\Users\chris\source\repos\Cell\Cell\obj\Debug\net8.0-windows\Cell_onn2yapk_wpftmp.GlobalUsings.g.cs", "C#", 5, 0, 0, 0, 0, 1, 1, 7
"c:\Users\chris\source\repos\Cell\Cell\obj\Debug\net8.0-windows\Cell_onn2yapk_wpftmp.sourcelink.json", "JSON", 0, 0, 0, 1, 0, 0, 0, 1
"c:\Users\chris\source\repos\Cell\Cell\obj\Debug\net8.0-windows\Cell_op4ekfss_wpftmp.AssemblyInfo.cs", "C#", 11, 0, 0, 0, 0, 10, 5, 26
"c:\Users\chris\source\repos\Cell\Cell\obj\Debug\net8.0-windows\Cell_op4ekfss_wpftmp.GeneratedMSBuildEditorConfig.editorconfig", "Properties", 0, 0, 0, 0, 21, 0, 1, 22
"c:\Users\chris\source\repos\Cell\Cell\obj\Debug\net8.0-windows\Cell_op4ekfss_wpftmp.GlobalUsings.g.cs", "C#", 5, 0, 0, 0, 0, 1, 1, 7
"c:\Users\chris\source\repos\Cell\Cell\obj\Debug\net8.0-windows\Cell_op4ekfss_wpftmp.sourcelink.json", "JSON", 0, 0, 0, 1, 0, 0, 0, 1
"c:\Users\chris\source\repos\Cell\Cell\obj\Debug\net8.0-windows\Cell_oq1qaove_wpftmp.AssemblyInfo.cs", "C#", 11, 0, 0, 0, 0, 10, 5, 26
"c:\Users\chris\source\repos\Cell\Cell\obj\Debug\net8.0-windows\Cell_oq1qaove_wpftmp.GeneratedMSBuildEditorConfig.editorconfig", "Properties", 0, 0, 0, 0, 21, 0, 1, 22
"c:\Users\chris\source\repos\Cell\Cell\obj\Debug\net8.0-windows\Cell_oq1qaove_wpftmp.GlobalUsings.g.cs", "C#", 5, 0, 0, 0, 0, 1, 1, 7
"c:\Users\chris\source\repos\Cell\Cell\obj\Debug\net8.0-windows\Cell_oq1qaove_wpftmp.sourcelink.json", "JSON", 0, 0, 0, 1, 0, 0, 0, 1
"c:\Users\chris\source\repos\Cell\Cell\obj\Debug\net8.0-windows\Cell_orjssuq0_wpftmp.AssemblyInfo.cs", "C#", 11, 0, 0, 0, 0, 10, 5, 26
"c:\Users\chris\source\repos\Cell\Cell\obj\Debug\net8.0-windows\Cell_orjssuq0_wpftmp.GeneratedMSBuildEditorConfig.editorconfig", "Properties", 0, 0, 0, 0, 21, 0, 1, 22
"c:\Users\chris\source\repos\Cell\Cell\obj\Debug\net8.0-windows\Cell_orjssuq0_wpftmp.GlobalUsings.g.cs", "C#", 5, 0, 0, 0, 0, 1, 1, 7
"c:\Users\chris\source\repos\Cell\Cell\obj\Debug\net8.0-windows\Cell_orjssuq0_wpftmp.sourcelink.json", "JSON", 0, 0, 0, 1, 0, 0, 0, 1
"c:\Users\chris\source\repos\Cell\Cell\obj\Debug\net8.0-windows\Cell_orkyoatv_wpftmp.AssemblyInfo.cs", "C#", 11, 0, 0, 0, 0, 10, 5, 26
"c:\Users\chris\source\repos\Cell\Cell\obj\Debug\net8.0-windows\Cell_orkyoatv_wpftmp.GeneratedMSBuildEditorConfig.editorconfig", "Properties", 0, 0, 0, 0, 21, 0, 1, 22
"c:\Users\chris\source\repos\Cell\Cell\obj\Debug\net8.0-windows\Cell_orkyoatv_wpftmp.GlobalUsings.g.cs", "C#", 5, 0, 0, 0, 0, 1, 1, 7
"c:\Users\chris\source\repos\Cell\Cell\obj\Debug\net8.0-windows\Cell_orkyoatv_wpftmp.sourcelink.json", "JSON", 0, 0, 0, 1, 0, 0, 0, 1
"c:\Users\chris\source\repos\Cell\Cell\obj\Debug\net8.0-windows\Cell_os1lv3se_wpftmp.AssemblyInfo.cs", "C#", 11, 0, 0, 0, 0, 10, 5, 26
"c:\Users\chris\source\repos\Cell\Cell\obj\Debug\net8.0-windows\Cell_os1lv3se_wpftmp.GeneratedMSBuildEditorConfig.editorconfig", "Properties", 0, 0, 0, 0, 21, 0, 1, 22
"c:\Users\chris\source\repos\Cell\Cell\obj\Debug\net8.0-windows\Cell_os1lv3se_wpftmp.GlobalUsings.g.cs", "C#", 5, 0, 0, 0, 0, 1, 1, 7
"c:\Users\chris\source\repos\Cell\Cell\obj\Debug\net8.0-windows\Cell_os1lv3se_wpftmp.sourcelink.json", "JSON", 0, 0, 0, 1, 0, 0, 0, 1
"c:\Users\chris\source\repos\Cell\Cell\obj\Debug\net8.0-windows\Cell_otdg3off_wpftmp.AssemblyInfo.cs", "C#", 11, 0, 0, 0, 0, 10, 5, 26
"c:\Users\chris\source\repos\Cell\Cell\obj\Debug\net8.0-windows\Cell_otdg3off_wpftmp.GeneratedMSBuildEditorConfig.editorconfig", "Properties", 0, 0, 0, 0, 21, 0, 1, 22
"c:\Users\chris\source\repos\Cell\Cell\obj\Debug\net8.0-windows\Cell_otdg3off_wpftmp.GlobalUsings.g.cs", "C#", 5, 0, 0, 0, 0, 1, 1, 7
"c:\Users\chris\source\repos\Cell\Cell\obj\Debug\net8.0-windows\Cell_otdg3off_wpftmp.sourcelink.json", "JSON", 0, 0, 0, 1, 0, 0, 0, 1
"c:\Users\chris\source\repos\Cell\Cell\obj\Debug\net8.0-windows\Cell_otgzavzz_wpftmp.AssemblyInfo.cs", "C#", 11, 0, 0, 0, 0, 10, 5, 26
"c:\Users\chris\source\repos\Cell\Cell\obj\Debug\net8.0-windows\Cell_otgzavzz_wpftmp.GeneratedMSBuildEditorConfig.editorconfig", "Properties", 0, 0, 0, 0, 13, 0, 1, 14
"c:\Users\chris\source\repos\Cell\Cell\obj\Debug\net8.0-windows\Cell_otgzavzz_wpftmp.GlobalUsings.g.cs", "C#", 5, 0, 0, 0, 0, 1, 1, 7
"c:\Users\chris\source\repos\Cell\Cell\obj\Debug\net8.0-windows\Cell_otmqmqx0_wpftmp.AssemblyInfo.cs", "C#", 11, 0, 0, 0, 0, 10, 5, 26
"c:\Users\chris\source\repos\Cell\Cell\obj\Debug\net8.0-windows\Cell_otmqmqx0_wpftmp.GeneratedMSBuildEditorConfig.editorconfig", "Properties", 0, 0, 0, 0, 21, 0, 1, 22
"c:\Users\chris\source\repos\Cell\Cell\obj\Debug\net8.0-windows\Cell_otmqmqx0_wpftmp.GlobalUsings.g.cs", "C#", 5, 0, 0, 0, 0, 1, 1, 7
"c:\Users\chris\source\repos\Cell\Cell\obj\Debug\net8.0-windows\Cell_otmqmqx0_wpftmp.sourcelink.json", "JSON", 0, 0, 0, 1, 0, 0, 0, 1
"c:\Users\chris\source\repos\Cell\Cell\obj\Debug\net8.0-windows\Cell_oufyno4q_wpftmp.AssemblyInfo.cs", "C#", 11, 0, 0, 0, 0, 10, 5, 26
"c:\Users\chris\source\repos\Cell\Cell\obj\Debug\net8.0-windows\Cell_oufyno4q_wpftmp.GeneratedMSBuildEditorConfig.editorconfig", "Properties", 0, 0, 0, 0, 21, 0, 1, 22
"c:\Users\chris\source\repos\Cell\Cell\obj\Debug\net8.0-windows\Cell_oufyno4q_wpftmp.GlobalUsings.g.cs", "C#", 5, 0, 0, 0, 0, 1, 1, 7
"c:\Users\chris\source\repos\Cell\Cell\obj\Debug\net8.0-windows\Cell_oufyno4q_wpftmp.sourcelink.json", "JSON", 0, 0, 0, 1, 0, 0, 0, 1
"c:\Users\chris\source\repos\Cell\Cell\obj\Debug\net8.0-windows\Cell_ouh4tlex_wpftmp.AssemblyInfo.cs", "C#", 11, 0, 0, 0, 0, 10, 5, 26
"c:\Users\chris\source\repos\Cell\Cell\obj\Debug\net8.0-windows\Cell_ouh4tlex_wpftmp.GeneratedMSBuildEditorConfig.editorconfig", "Properties", 0, 0, 0, 0, 21, 0, 1, 22
"c:\Users\chris\source\repos\Cell\Cell\obj\Debug\net8.0-windows\Cell_ouh4tlex_wpftmp.GlobalUsings.g.cs", "C#", 5, 0, 0, 0, 0, 1, 1, 7
"c:\Users\chris\source\repos\Cell\Cell\obj\Debug\net8.0-windows\Cell_ouh4tlex_wpftmp.sourcelink.json", "JSON", 0, 0, 0, 1, 0, 0, 0, 1
"c:\Users\chris\source\repos\Cell\Cell\obj\Debug\net8.0-windows\Cell_ouq3wajp_wpftmp.AssemblyInfo.cs", "C#", 11, 0, 0, 0, 0, 10, 5, 26
"c:\Users\chris\source\repos\Cell\Cell\obj\Debug\net8.0-windows\Cell_ouq3wajp_wpftmp.GeneratedMSBuildEditorConfig.editorconfig", "Properties", 0, 0, 0, 0, 21, 0, 1, 22
"c:\Users\chris\source\repos\Cell\Cell\obj\Debug\net8.0-windows\Cell_ouq3wajp_wpftmp.GlobalUsings.g.cs", "C#", 5, 0, 0, 0, 0, 1, 1, 7
"c:\Users\chris\source\repos\Cell\Cell\obj\Debug\net8.0-windows\Cell_ouq3wajp_wpftmp.sourcelink.json", "JSON", 0, 0, 0, 1, 0, 0, 0, 1
"c:\Users\chris\source\repos\Cell\Cell\obj\Debug\net8.0-windows\Cell_ous0p1t3_wpftmp.AssemblyInfo.cs", "C#", 11, 0, 0, 0, 0, 10, 5, 26
"c:\Users\chris\source\repos\Cell\Cell\obj\Debug\net8.0-windows\Cell_ous0p1t3_wpftmp.GeneratedMSBuildEditorConfig.editorconfig", "Properties", 0, 0, 0, 0, 21, 0, 1, 22
"c:\Users\chris\source\repos\Cell\Cell\obj\Debug\net8.0-windows\Cell_ous0p1t3_wpftmp.GlobalUsings.g.cs", "C#", 5, 0, 0, 0, 0, 1, 1, 7
"c:\Users\chris\source\repos\Cell\Cell\obj\Debug\net8.0-windows\Cell_ous0p1t3_wpftmp.sourcelink.json", "JSON", 0, 0, 0, 1, 0, 0, 0, 1
"c:\Users\chris\source\repos\Cell\Cell\obj\Debug\net8.0-windows\Cell_ouvy1zb4_wpftmp.AssemblyInfo.cs", "C#", 11, 0, 0, 0, 0, 10, 5, 26
"c:\Users\chris\source\repos\Cell\Cell\obj\Debug\net8.0-windows\Cell_ouvy1zb4_wpftmp.GeneratedMSBuildEditorConfig.editorconfig", "Properties", 0, 0, 0, 0, 13, 0, 1, 14
"c:\Users\chris\source\repos\Cell\Cell\obj\Debug\net8.0-windows\Cell_ouvy1zb4_wpftmp.GlobalUsings.g.cs", "C#", 5, 0, 0, 0, 0, 1, 1, 7
"c:\Users\chris\source\repos\Cell\Cell\obj\Debug\net8.0-windows\Cell_ouzq4bfw_wpftmp.AssemblyInfo.cs", "C#", 11, 0, 0, 0, 0, 10, 5, 26
"c:\Users\chris\source\repos\Cell\Cell\obj\Debug\net8.0-windows\Cell_ouzq4bfw_wpftmp.GeneratedMSBuildEditorConfig.editorconfig", "Properties", 0, 0, 0, 0, 21, 0, 1, 22
"c:\Users\chris\source\repos\Cell\Cell\obj\Debug\net8.0-windows\Cell_ouzq4bfw_wpftmp.GlobalUsings.g.cs", "C#", 5, 0, 0, 0, 0, 1, 1, 7
"c:\Users\chris\source\repos\Cell\Cell\obj\Debug\net8.0-windows\Cell_ouzq4bfw_wpftmp.sourcelink.json", "JSON", 0, 0, 0, 1, 0, 0, 0, 1
"c:\Users\chris\source\repos\Cell\Cell\obj\Debug\net8.0-windows\Cell_ov10vxep_wpftmp.AssemblyInfo.cs", "C#", 11, 0, 0, 0, 0, 10, 5, 26
"c:\Users\chris\source\repos\Cell\Cell\obj\Debug\net8.0-windows\Cell_ov10vxep_wpftmp.GeneratedMSBuildEditorConfig.editorconfig", "Properties", 0, 0, 0, 0, 21, 0, 1, 22
"c:\Users\chris\source\repos\Cell\Cell\obj\Debug\net8.0-windows\Cell_ov10vxep_wpftmp.GlobalUsings.g.cs", "C#", 5, 0, 0, 0, 0, 1, 1, 7
"c:\Users\chris\source\repos\Cell\Cell\obj\Debug\net8.0-windows\Cell_ov10vxep_wpftmp.sourcelink.json", "JSON", 0, 0, 0, 1, 0, 0, 0, 1
"c:\Users\chris\source\repos\Cell\Cell\obj\Debug\net8.0-windows\Cell_ovppmz3x_wpftmp.AssemblyInfo.cs", "C#", 11, 0, 0, 0, 0, 10, 5, 26
"c:\Users\chris\source\repos\Cell\Cell\obj\Debug\net8.0-windows\Cell_ovppmz3x_wpftmp.GeneratedMSBuildEditorConfig.editorconfig", "Properties", 0, 0, 0, 0, 21, 0, 1, 22
"c:\Users\chris\source\repos\Cell\Cell\obj\Debug\net8.0-windows\Cell_ovppmz3x_wpftmp.GlobalUsings.g.cs", "C#", 5, 0, 0, 0, 0, 1, 1, 7
"c:\Users\chris\source\repos\Cell\Cell\obj\Debug\net8.0-windows\Cell_ovppmz3x_wpftmp.sourcelink.json", "JSON", 0, 0, 0, 1, 0, 0, 0, 1
"c:\Users\chris\source\repos\Cell\Cell\obj\Debug\net8.0-windows\Cell_ovqd1ppr_wpftmp.AssemblyInfo.cs", "C#", 11, 0, 0, 0, 0, 10, 5, 26
"c:\Users\chris\source\repos\Cell\Cell\obj\Debug\net8.0-windows\Cell_ovqd1ppr_wpftmp.GeneratedMSBuildEditorConfig.editorconfig", "Properties", 0, 0, 0, 0, 13, 0, 1, 14
"c:\Users\chris\source\repos\Cell\Cell\obj\Debug\net8.0-windows\Cell_ovqd1ppr_wpftmp.GlobalUsings.g.cs", "C#", 5, 0, 0, 0, 0, 1, 1, 7
"c:\Users\chris\source\repos\Cell\Cell\obj\Debug\net8.0-windows\Cell_ovtzultd_wpftmp.AssemblyInfo.cs", "C#", 11, 0, 0, 0, 0, 10, 5, 26
"c:\Users\chris\source\repos\Cell\Cell\obj\Debug\net8.0-windows\Cell_ovtzultd_wpftmp.GeneratedMSBuildEditorConfig.editorconfig", "Properties", 0, 0, 0, 0, 13, 0, 1, 14
"c:\Users\chris\source\repos\Cell\Cell\obj\Debug\net8.0-windows\Cell_ovtzultd_wpftmp.GlobalUsings.g.cs", "C#", 5, 0, 0, 0, 0, 1, 1, 7
"c:\Users\chris\source\repos\Cell\Cell\obj\Debug\net8.0-windows\Cell_ovy5tjih_wpftmp.AssemblyInfo.cs", "C#", 11, 0, 0, 0, 0, 10, 5, 26
"c:\Users\chris\source\repos\Cell\Cell\obj\Debug\net8.0-windows\Cell_ovy5tjih_wpftmp.GeneratedMSBuildEditorConfig.editorconfig", "Properties", 0, 0, 0, 0, 21, 0, 1, 22
"c:\Users\chris\source\repos\Cell\Cell\obj\Debug\net8.0-windows\Cell_ovy5tjih_wpftmp.GlobalUsings.g.cs", "C#", 5, 0, 0, 0, 0, 1, 1, 7
"c:\Users\chris\source\repos\Cell\Cell\obj\Debug\net8.0-windows\Cell_ovy5tjih_wpftmp.sourcelink.json", "JSON", 0, 0, 0, 1, 0, 0, 0, 1
"c:\Users\chris\source\repos\Cell\Cell\obj\Debug\net8.0-windows\Cell_ow1crdqj_wpftmp.AssemblyInfo.cs", "C#", 11, 0, 0, 0, 0, 10, 5, 26
"c:\Users\chris\source\repos\Cell\Cell\obj\Debug\net8.0-windows\Cell_ow1crdqj_wpftmp.GeneratedMSBuildEditorConfig.editorconfig", "Properties", 0, 0, 0, 0, 21, 0, 1, 22
"c:\Users\chris\source\repos\Cell\Cell\obj\Debug\net8.0-windows\Cell_ow1crdqj_wpftmp.GlobalUsings.g.cs", "C#", 5, 0, 0, 0, 0, 1, 1, 7
"c:\Users\chris\source\repos\Cell\Cell\obj\Debug\net8.0-windows\Cell_ow1crdqj_wpftmp.sourcelink.json", "JSON", 0, 0, 0, 1, 0, 0, 0, 1
"c:\Users\chris\source\repos\Cell\Cell\obj\Debug\net8.0-windows\Cell_oxwlkaox_wpftmp.AssemblyInfo.cs", "C#", 11, 0, 0, 0, 0, 10, 5, 26
"c:\Users\chris\source\repos\Cell\Cell\obj\Debug\net8.0-windows\Cell_oxwlkaox_wpftmp.GeneratedMSBuildEditorConfig.editorconfig", "Properties", 0, 0, 0, 0, 21, 0, 1, 22
"c:\Users\chris\source\repos\Cell\Cell\obj\Debug\net8.0-windows\Cell_oxwlkaox_wpftmp.GlobalUsings.g.cs", "C#", 5, 0, 0, 0, 0, 1, 1, 7
"c:\Users\chris\source\repos\Cell\Cell\obj\Debug\net8.0-windows\Cell_oxwlkaox_wpftmp.sourcelink.json", "JSON", 0, 0, 0, 1, 0, 0, 0, 1
"c:\Users\chris\source\repos\Cell\Cell\obj\Debug\net8.0-windows\Cell_oycqh2qm_wpftmp.AssemblyInfo.cs", "C#", 11, 0, 0, 0, 0, 10, 5, 26
"c:\Users\chris\source\repos\Cell\Cell\obj\Debug\net8.0-windows\Cell_oycqh2qm_wpftmp.GeneratedMSBuildEditorConfig.editorconfig", "Properties", 0, 0, 0, 0, 21, 0, 1, 22
"c:\Users\chris\source\repos\Cell\Cell\obj\Debug\net8.0-windows\Cell_oycqh2qm_wpftmp.GlobalUsings.g.cs", "C#", 5, 0, 0, 0, 0, 1, 1, 7
"c:\Users\chris\source\repos\Cell\Cell\obj\Debug\net8.0-windows\Cell_oycqh2qm_wpftmp.sourcelink.json", "JSON", 0, 0, 0, 1, 0, 0, 0, 1
"c:\Users\chris\source\repos\Cell\Cell\obj\Debug\net8.0-windows\Cell_oye4u3d0_wpftmp.AssemblyInfo.cs", "C#", 11, 0, 0, 0, 0, 10, 5, 26
"c:\Users\chris\source\repos\Cell\Cell\obj\Debug\net8.0-windows\Cell_oye4u3d0_wpftmp.GeneratedMSBuildEditorConfig.editorconfig", "Properties", 0, 0, 0, 0, 21, 0, 1, 22
"c:\Users\chris\source\repos\Cell\Cell\obj\Debug\net8.0-windows\Cell_oye4u3d0_wpftmp.GlobalUsings.g.cs", "C#", 5, 0, 0, 0, 0, 1, 1, 7
"c:\Users\chris\source\repos\Cell\Cell\obj\Debug\net8.0-windows\Cell_ozctrrmm_wpftmp.AssemblyInfo.cs", "C#", 11, 0, 0, 0, 0, 10, 5, 26
"c:\Users\chris\source\repos\Cell\Cell\obj\Debug\net8.0-windows\Cell_ozctrrmm_wpftmp.GeneratedMSBuildEditorConfig.editorconfig", "Properties", 0, 0, 0, 0, 21, 0, 1, 22
"c:\Users\chris\source\repos\Cell\Cell\obj\Debug\net8.0-windows\Cell_ozctrrmm_wpftmp.GlobalUsings.g.cs", "C#", 5, 0, 0, 0, 0, 1, 1, 7
"c:\Users\chris\source\repos\Cell\Cell\obj\Debug\net8.0-windows\Cell_ozctrrmm_wpftmp.sourcelink.json", "JSON", 0, 0, 0, 1, 0, 0, 0, 1
"c:\Users\chris\source\repos\Cell\Cell\obj\Debug\net8.0-windows\Cell_p01ugthb_wpftmp.AssemblyInfo.cs", "C#", 11, 0, 0, 0, 0, 10, 5, 26
"c:\Users\chris\source\repos\Cell\Cell\obj\Debug\net8.0-windows\Cell_p01ugthb_wpftmp.GeneratedMSBuildEditorConfig.editorconfig", "Properties", 0, 0, 0, 0, 21, 0, 1, 22
"c:\Users\chris\source\repos\Cell\Cell\obj\Debug\net8.0-windows\Cell_p01ugthb_wpftmp.GlobalUsings.g.cs", "C#", 5, 0, 0, 0, 0, 1, 1, 7
"c:\Users\chris\source\repos\Cell\Cell\obj\Debug\net8.0-windows\Cell_p11hvqo3_wpftmp.AssemblyInfo.cs", "C#", 11, 0, 0, 0, 0, 10, 5, 26
"c:\Users\chris\source\repos\Cell\Cell\obj\Debug\net8.0-windows\Cell_p11hvqo3_wpftmp.GeneratedMSBuildEditorConfig.editorconfig", "Properties", 0, 0, 0, 0, 21, 0, 1, 22
"c:\Users\chris\source\repos\Cell\Cell\obj\Debug\net8.0-windows\Cell_p11hvqo3_wpftmp.GlobalUsings.g.cs", "C#", 5, 0, 0, 0, 0, 1, 1, 7
"c:\Users\chris\source\repos\Cell\Cell\obj\Debug\net8.0-windows\Cell_p11hvqo3_wpftmp.sourcelink.json", "JSON", 0, 0, 0, 1, 0, 0, 0, 1
"c:\Users\chris\source\repos\Cell\Cell\obj\Debug\net8.0-windows\Cell_p1em0vhg_wpftmp.AssemblyInfo.cs", "C#", 11, 0, 0, 0, 0, 10, 5, 26
"c:\Users\chris\source\repos\Cell\Cell\obj\Debug\net8.0-windows\Cell_p1em0vhg_wpftmp.GeneratedMSBuildEditorConfig.editorconfig", "Properties", 0, 0, 0, 0, 21, 0, 1, 22
"c:\Users\chris\source\repos\Cell\Cell\obj\Debug\net8.0-windows\Cell_p1em0vhg_wpftmp.GlobalUsings.g.cs", "C#", 5, 0, 0, 0, 0, 1, 1, 7
"c:\Users\chris\source\repos\Cell\Cell\obj\Debug\net8.0-windows\Cell_p1em0vhg_wpftmp.sourcelink.json", "JSON", 0, 0, 0, 1, 0, 0, 0, 1
"c:\Users\chris\source\repos\Cell\Cell\obj\Debug\net8.0-windows\Cell_p1fbnmck_wpftmp.AssemblyInfo.cs", "C#", 11, 0, 0, 0, 0, 10, 5, 26
"c:\Users\chris\source\repos\Cell\Cell\obj\Debug\net8.0-windows\Cell_p1fbnmck_wpftmp.GeneratedMSBuildEditorConfig.editorconfig", "Properties", 0, 0, 0, 0, 21, 0, 1, 22
"c:\Users\chris\source\repos\Cell\Cell\obj\Debug\net8.0-windows\Cell_p1fbnmck_wpftmp.GlobalUsings.g.cs", "C#", 5, 0, 0, 0, 0, 1, 1, 7
"c:\Users\chris\source\repos\Cell\Cell\obj\Debug\net8.0-windows\Cell_p1fbnmck_wpftmp.sourcelink.json", "JSON", 0, 0, 0, 1, 0, 0, 0, 1
"c:\Users\chris\source\repos\Cell\Cell\obj\Debug\net8.0-windows\Cell_p1gntrq4_wpftmp.AssemblyInfo.cs", "C#", 11, 0, 0, 0, 0, 10, 5, 26
"c:\Users\chris\source\repos\Cell\Cell\obj\Debug\net8.0-windows\Cell_p1gntrq4_wpftmp.GeneratedMSBuildEditorConfig.editorconfig", "Properties", 0, 0, 0, 0, 21, 0, 1, 22
"c:\Users\chris\source\repos\Cell\Cell\obj\Debug\net8.0-windows\Cell_p1gntrq4_wpftmp.GlobalUsings.g.cs", "C#", 5, 0, 0, 0, 0, 1, 1, 7
"c:\Users\chris\source\repos\Cell\Cell\obj\Debug\net8.0-windows\Cell_p1gntrq4_wpftmp.sourcelink.json", "JSON", 0, 0, 0, 1, 0, 0, 0, 1
"c:\Users\chris\source\repos\Cell\Cell\obj\Debug\net8.0-windows\Cell_p1jdvgcf_wpftmp.AssemblyInfo.cs", "C#", 11, 0, 0, 0, 0, 10, 5, 26
"c:\Users\chris\source\repos\Cell\Cell\obj\Debug\net8.0-windows\Cell_p1jdvgcf_wpftmp.GeneratedMSBuildEditorConfig.editorconfig", "Properties", 0, 0, 0, 0, 21, 0, 1, 22
"c:\Users\chris\source\repos\Cell\Cell\obj\Debug\net8.0-windows\Cell_p1jdvgcf_wpftmp.GlobalUsings.g.cs", "C#", 5, 0, 0, 0, 0, 1, 1, 7
"c:\Users\chris\source\repos\Cell\Cell\obj\Debug\net8.0-windows\Cell_p1jdvgcf_wpftmp.sourcelink.json", "JSON", 0, 0, 0, 1, 0, 0, 0, 1
"c:\Users\chris\source\repos\Cell\Cell\obj\Debug\net8.0-windows\Cell_p1tnibn1_wpftmp.AssemblyInfo.cs", "C#", 11, 0, 0, 0, 0, 10, 5, 26
"c:\Users\chris\source\repos\Cell\Cell\obj\Debug\net8.0-windows\Cell_p1tnibn1_wpftmp.GeneratedMSBuildEditorConfig.editorconfig", "Properties", 0, 0, 0, 0, 21, 0, 1, 22
"c:\Users\chris\source\repos\Cell\Cell\obj\Debug\net8.0-windows\Cell_p1tnibn1_wpftmp.GlobalUsings.g.cs", "C#", 5, 0, 0, 0, 0, 1, 1, 7
"c:\Users\chris\source\repos\Cell\Cell\obj\Debug\net8.0-windows\Cell_p1tnibn1_wpftmp.sourcelink.json", "JSON", 0, 0, 0, 1, 0, 0, 0, 1
"c:\Users\chris\source\repos\Cell\Cell\obj\Debug\net8.0-windows\Cell_p2mqkxuu_wpftmp.AssemblyInfo.cs", "C#", 11, 0, 0, 0, 0, 10, 5, 26
"c:\Users\chris\source\repos\Cell\Cell\obj\Debug\net8.0-windows\Cell_p2mqkxuu_wpftmp.GeneratedMSBuildEditorConfig.editorconfig", "Properties", 0, 0, 0, 0, 21, 0, 1, 22
"c:\Users\chris\source\repos\Cell\Cell\obj\Debug\net8.0-windows\Cell_p2mqkxuu_wpftmp.GlobalUsings.g.cs", "C#", 5, 0, 0, 0, 0, 1, 1, 7
"c:\Users\chris\source\repos\Cell\Cell\obj\Debug\net8.0-windows\Cell_p2mqkxuu_wpftmp.sourcelink.json", "JSON", 0, 0, 0, 1, 0, 0, 0, 1
"c:\Users\chris\source\repos\Cell\Cell\obj\Debug\net8.0-windows\Cell_p2wjtr33_wpftmp.AssemblyInfo.cs", "C#", 11, 0, 0, 0, 0, 10, 5, 26
"c:\Users\chris\source\repos\Cell\Cell\obj\Debug\net8.0-windows\Cell_p2wjtr33_wpftmp.GeneratedMSBuildEditorConfig.editorconfig", "Properties", 0, 0, 0, 0, 13, 0, 1, 14
"c:\Users\chris\source\repos\Cell\Cell\obj\Debug\net8.0-windows\Cell_p2wjtr33_wpftmp.GlobalUsings.g.cs", "C#", 5, 0, 0, 0, 0, 1, 1, 7
"c:\Users\chris\source\repos\Cell\Cell\obj\Debug\net8.0-windows\Cell_p321ctxa_wpftmp.AssemblyInfo.cs", "C#", 11, 0, 0, 0, 0, 10, 5, 26
"c:\Users\chris\source\repos\Cell\Cell\obj\Debug\net8.0-windows\Cell_p321ctxa_wpftmp.GeneratedMSBuildEditorConfig.editorconfig", "Properties", 0, 0, 0, 0, 21, 0, 1, 22
"c:\Users\chris\source\repos\Cell\Cell\obj\Debug\net8.0-windows\Cell_p321ctxa_wpftmp.GlobalUsings.g.cs", "C#", 5, 0, 0, 0, 0, 1, 1, 7
"c:\Users\chris\source\repos\Cell\Cell\obj\Debug\net8.0-windows\Cell_p321ctxa_wpftmp.sourcelink.json", "JSON", 0, 0, 0, 1, 0, 0, 0, 1
"c:\Users\chris\source\repos\Cell\Cell\obj\Debug\net8.0-windows\Cell_p3rftrei_wpftmp.AssemblyInfo.cs", "C#", 11, 0, 0, 0, 0, 10, 5, 26
"c:\Users\chris\source\repos\Cell\Cell\obj\Debug\net8.0-windows\Cell_p3rftrei_wpftmp.GeneratedMSBuildEditorConfig.editorconfig", "Properties", 0, 0, 0, 0, 21, 0, 1, 22
"c:\Users\chris\source\repos\Cell\Cell\obj\Debug\net8.0-windows\Cell_p3rftrei_wpftmp.GlobalUsings.g.cs", "C#", 5, 0, 0, 0, 0, 1, 1, 7
"c:\Users\chris\source\repos\Cell\Cell\obj\Debug\net8.0-windows\Cell_p3rftrei_wpftmp.sourcelink.json", "JSON", 0, 0, 0, 1, 0, 0, 0, 1
"c:\Users\chris\source\repos\Cell\Cell\obj\Debug\net8.0-windows\Cell_p3xvhdb1_wpftmp.AssemblyInfo.cs", "C#", 11, 0, 0, 0, 0, 10, 5, 26
"c:\Users\chris\source\repos\Cell\Cell\obj\Debug\net8.0-windows\Cell_p3xvhdb1_wpftmp.GeneratedMSBuildEditorConfig.editorconfig", "Properties", 0, 0, 0, 0, 21, 0, 1, 22
"c:\Users\chris\source\repos\Cell\Cell\obj\Debug\net8.0-windows\Cell_p3xvhdb1_wpftmp.GlobalUsings.g.cs", "C#", 5, 0, 0, 0, 0, 1, 1, 7
"c:\Users\chris\source\repos\Cell\Cell\obj\Debug\net8.0-windows\Cell_p3xvhdb1_wpftmp.sourcelink.json", "JSON", 0, 0, 0, 1, 0, 0, 0, 1
"c:\Users\chris\source\repos\Cell\Cell\obj\Debug\net8.0-windows\Cell_p3yifl1x_wpftmp.AssemblyInfo.cs", "C#", 11, 0, 0, 0, 0, 10, 5, 26
"c:\Users\chris\source\repos\Cell\Cell\obj\Debug\net8.0-windows\Cell_p3yifl1x_wpftmp.GeneratedMSBuildEditorConfig.editorconfig", "Properties", 0, 0, 0, 0, 21, 0, 1, 22
"c:\Users\chris\source\repos\Cell\Cell\obj\Debug\net8.0-windows\Cell_p3yifl1x_wpftmp.GlobalUsings.g.cs", "C#", 5, 0, 0, 0, 0, 1, 1, 7
"c:\Users\chris\source\repos\Cell\Cell\obj\Debug\net8.0-windows\Cell_p3yifl1x_wpftmp.sourcelink.json", "JSON", 0, 0, 0, 1, 0, 0, 0, 1
"c:\Users\chris\source\repos\Cell\Cell\obj\Debug\net8.0-windows\Cell_p5lkt4pv_wpftmp.AssemblyInfo.cs", "C#", 11, 0, 0, 0, 0, 10, 5, 26
"c:\Users\chris\source\repos\Cell\Cell\obj\Debug\net8.0-windows\Cell_p5lkt4pv_wpftmp.GeneratedMSBuildEditorConfig.editorconfig", "Properties", 0, 0, 0, 0, 13, 0, 1, 14
"c:\Users\chris\source\repos\Cell\Cell\obj\Debug\net8.0-windows\Cell_p5lkt4pv_wpftmp.GlobalUsings.g.cs", "C#", 5, 0, 0, 0, 0, 1, 1, 7
"c:\Users\chris\source\repos\Cell\Cell\obj\Debug\net8.0-windows\Cell_p5v45xnh_wpftmp.AssemblyInfo.cs", "C#", 11, 0, 0, 0, 0, 10, 5, 26
"c:\Users\chris\source\repos\Cell\Cell\obj\Debug\net8.0-windows\Cell_p5v45xnh_wpftmp.GeneratedMSBuildEditorConfig.editorconfig", "Properties", 0, 0, 0, 0, 13, 0, 1, 14
"c:\Users\chris\source\repos\Cell\Cell\obj\Debug\net8.0-windows\Cell_p5v45xnh_wpftmp.GlobalUsings.g.cs", "C#", 5, 0, 0, 0, 0, 1, 1, 7
"c:\Users\chris\source\repos\Cell\Cell\obj\Debug\net8.0-windows\Cell_pbv3wyz5_wpftmp.AssemblyInfo.cs", "C#", 11, 0, 0, 0, 0, 10, 5, 26
"c:\Users\chris\source\repos\Cell\Cell\obj\Debug\net8.0-windows\Cell_pbv3wyz5_wpftmp.GeneratedMSBuildEditorConfig.editorconfig", "Properties", 0, 0, 0, 0, 21, 0, 1, 22
"c:\Users\chris\source\repos\Cell\Cell\obj\Debug\net8.0-windows\Cell_pbv3wyz5_wpftmp.GlobalUsings.g.cs", "C#", 5, 0, 0, 0, 0, 1, 1, 7
"c:\Users\chris\source\repos\Cell\Cell\obj\Debug\net8.0-windows\Cell_pbv3wyz5_wpftmp.sourcelink.json", "JSON", 0, 0, 0, 1, 0, 0, 0, 1
"c:\Users\chris\source\repos\Cell\Cell\obj\Debug\net8.0-windows\Cell_pbwvkirx_wpftmp.AssemblyInfo.cs", "C#", 11, 0, 0, 0, 0, 10, 5, 26
"c:\Users\chris\source\repos\Cell\Cell\obj\Debug\net8.0-windows\Cell_pbwvkirx_wpftmp.GeneratedMSBuildEditorConfig.editorconfig", "Properties", 0, 0, 0, 0, 21, 0, 1, 22
"c:\Users\chris\source\repos\Cell\Cell\obj\Debug\net8.0-windows\Cell_pbwvkirx_wpftmp.GlobalUsings.g.cs", "C#", 5, 0, 0, 0, 0, 1, 1, 7
"c:\Users\chris\source\repos\Cell\Cell\obj\Debug\net8.0-windows\Cell_pbwvkirx_wpftmp.sourcelink.json", "JSON", 0, 0, 0, 1, 0, 0, 0, 1
"c:\Users\chris\source\repos\Cell\Cell\obj\Debug\net8.0-windows\Cell_pcntxfyy_wpftmp.AssemblyInfo.cs", "C#", 11, 0, 0, 0, 0, 10, 5, 26
"c:\Users\chris\source\repos\Cell\Cell\obj\Debug\net8.0-windows\Cell_pcntxfyy_wpftmp.GeneratedMSBuildEditorConfig.editorconfig", "Properties", 0, 0, 0, 0, 21, 0, 1, 22
"c:\Users\chris\source\repos\Cell\Cell\obj\Debug\net8.0-windows\Cell_pcntxfyy_wpftmp.GlobalUsings.g.cs", "C#", 5, 0, 0, 0, 0, 1, 1, 7
"c:\Users\chris\source\repos\Cell\Cell\obj\Debug\net8.0-windows\Cell_pcntxfyy_wpftmp.sourcelink.json", "JSON", 0, 0, 0, 1, 0, 0, 0, 1
"c:\Users\chris\source\repos\Cell\Cell\obj\Debug\net8.0-windows\Cell_pd1ba2vz_wpftmp.AssemblyInfo.cs", "C#", 11, 0, 0, 0, 0, 10, 5, 26
"c:\Users\chris\source\repos\Cell\Cell\obj\Debug\net8.0-windows\Cell_pd1ba2vz_wpftmp.GeneratedMSBuildEditorConfig.editorconfig", "Properties", 0, 0, 0, 0, 21, 0, 1, 22
"c:\Users\chris\source\repos\Cell\Cell\obj\Debug\net8.0-windows\Cell_pd1ba2vz_wpftmp.GlobalUsings.g.cs", "C#", 5, 0, 0, 0, 0, 1, 1, 7
"c:\Users\chris\source\repos\Cell\Cell\obj\Debug\net8.0-windows\Cell_pd1ba2vz_wpftmp.sourcelink.json", "JSON", 0, 0, 0, 1, 0, 0, 0, 1
"c:\Users\chris\source\repos\Cell\Cell\obj\Debug\net8.0-windows\Cell_pdpw1gw5_wpftmp.AssemblyInfo.cs", "C#", 11, 0, 0, 0, 0, 10, 5, 26
"c:\Users\chris\source\repos\Cell\Cell\obj\Debug\net8.0-windows\Cell_pdpw1gw5_wpftmp.GeneratedMSBuildEditorConfig.editorconfig", "Properties", 0, 0, 0, 0, 21, 0, 1, 22
"c:\Users\chris\source\repos\Cell\Cell\obj\Debug\net8.0-windows\Cell_pdpw1gw5_wpftmp.GlobalUsings.g.cs", "C#", 5, 0, 0, 0, 0, 1, 1, 7
"c:\Users\chris\source\repos\Cell\Cell\obj\Debug\net8.0-windows\Cell_pdpw1gw5_wpftmp.sourcelink.json", "JSON", 0, 0, 0, 1, 0, 0, 0, 1
"c:\Users\chris\source\repos\Cell\Cell\obj\Debug\net8.0-windows\Cell_pe1sxsiw_wpftmp.AssemblyInfo.cs", "C#", 11, 0, 0, 0, 0, 10, 5, 26
"c:\Users\chris\source\repos\Cell\Cell\obj\Debug\net8.0-windows\Cell_pe1sxsiw_wpftmp.GeneratedMSBuildEditorConfig.editorconfig", "Properties", 0, 0, 0, 0, 21, 0, 1, 22
"c:\Users\chris\source\repos\Cell\Cell\obj\Debug\net8.0-windows\Cell_pe1sxsiw_wpftmp.GlobalUsings.g.cs", "C#", 5, 0, 0, 0, 0, 1, 1, 7
"c:\Users\chris\source\repos\Cell\Cell\obj\Debug\net8.0-windows\Cell_pe1sxsiw_wpftmp.sourcelink.json", "JSON", 0, 0, 0, 1, 0, 0, 0, 1
"c:\Users\chris\source\repos\Cell\Cell\obj\Debug\net8.0-windows\Cell_pefpns04_wpftmp.AssemblyInfo.cs", "C#", 11, 0, 0, 0, 0, 10, 5, 26
"c:\Users\chris\source\repos\Cell\Cell\obj\Debug\net8.0-windows\Cell_pefpns04_wpftmp.GeneratedMSBuildEditorConfig.editorconfig", "Properties", 0, 0, 0, 0, 21, 0, 1, 22
"c:\Users\chris\source\repos\Cell\Cell\obj\Debug\net8.0-windows\Cell_pefpns04_wpftmp.GlobalUsings.g.cs", "C#", 5, 0, 0, 0, 0, 1, 1, 7
"c:\Users\chris\source\repos\Cell\Cell\obj\Debug\net8.0-windows\Cell_pefpns04_wpftmp.sourcelink.json", "JSON", 0, 0, 0, 1, 0, 0, 0, 1
"c:\Users\chris\source\repos\Cell\Cell\obj\Debug\net8.0-windows\Cell_peogv1tz_wpftmp.AssemblyInfo.cs", "C#", 11, 0, 0, 0, 0, 10, 5, 26
"c:\Users\chris\source\repos\Cell\Cell\obj\Debug\net8.0-windows\Cell_peogv1tz_wpftmp.GeneratedMSBuildEditorConfig.editorconfig", "Properties", 0, 0, 0, 0, 21, 0, 1, 22
"c:\Users\chris\source\repos\Cell\Cell\obj\Debug\net8.0-windows\Cell_peogv1tz_wpftmp.GlobalUsings.g.cs", "C#", 5, 0, 0, 0, 0, 1, 1, 7
"c:\Users\chris\source\repos\Cell\Cell\obj\Debug\net8.0-windows\Cell_peogv1tz_wpftmp.sourcelink.json", "JSON", 0, 0, 0, 1, 0, 0, 0, 1
"c:\Users\chris\source\repos\Cell\Cell\obj\Debug\net8.0-windows\Cell_pfa5zh2g_wpftmp.AssemblyInfo.cs", "C#", 11, 0, 0, 0, 0, 10, 5, 26
"c:\Users\chris\source\repos\Cell\Cell\obj\Debug\net8.0-windows\Cell_pfa5zh2g_wpftmp.GeneratedMSBuildEditorConfig.editorconfig", "Properties", 0, 0, 0, 0, 13, 0, 1, 14
"c:\Users\chris\source\repos\Cell\Cell\obj\Debug\net8.0-windows\Cell_pfa5zh2g_wpftmp.GlobalUsings.g.cs", "C#", 5, 0, 0, 0, 0, 1, 1, 7
"c:\Users\chris\source\repos\Cell\Cell\obj\Debug\net8.0-windows\Cell_pfw3f2p3_wpftmp.AssemblyInfo.cs", "C#", 11, 0, 0, 0, 0, 10, 5, 26
"c:\Users\chris\source\repos\Cell\Cell\obj\Debug\net8.0-windows\Cell_pfw3f2p3_wpftmp.GeneratedMSBuildEditorConfig.editorconfig", "Properties", 0, 0, 0, 0, 21, 0, 1, 22
"c:\Users\chris\source\repos\Cell\Cell\obj\Debug\net8.0-windows\Cell_pfw3f2p3_wpftmp.GlobalUsings.g.cs", "C#", 5, 0, 0, 0, 0, 1, 1, 7
"c:\Users\chris\source\repos\Cell\Cell\obj\Debug\net8.0-windows\Cell_pfw3f2p3_wpftmp.sourcelink.json", "JSON", 0, 0, 0, 1, 0, 0, 0, 1
"c:\Users\chris\source\repos\Cell\Cell\obj\Debug\net8.0-windows\Cell_pguejxpi_wpftmp.AssemblyInfo.cs", "C#", 11, 0, 0, 0, 0, 10, 5, 26
"c:\Users\chris\source\repos\Cell\Cell\obj\Debug\net8.0-windows\Cell_pguejxpi_wpftmp.GeneratedMSBuildEditorConfig.editorconfig", "Properties", 0, 0, 0, 0, 21, 0, 1, 22
"c:\Users\chris\source\repos\Cell\Cell\obj\Debug\net8.0-windows\Cell_pguejxpi_wpftmp.GlobalUsings.g.cs", "C#", 5, 0, 0, 0, 0, 1, 1, 7
"c:\Users\chris\source\repos\Cell\Cell\obj\Debug\net8.0-windows\Cell_pguejxpi_wpftmp.sourcelink.json", "JSON", 0, 0, 0, 1, 0, 0, 0, 1
"c:\Users\chris\source\repos\Cell\Cell\obj\Debug\net8.0-windows\Cell_phayacg0_wpftmp.AssemblyInfo.cs", "C#", 11, 0, 0, 0, 0, 10, 5, 26
"c:\Users\chris\source\repos\Cell\Cell\obj\Debug\net8.0-windows\Cell_phayacg0_wpftmp.GeneratedMSBuildEditorConfig.editorconfig", "Properties", 0, 0, 0, 0, 21, 0, 1, 22
"c:\Users\chris\source\repos\Cell\Cell\obj\Debug\net8.0-windows\Cell_phayacg0_wpftmp.GlobalUsings.g.cs", "C#", 5, 0, 0, 0, 0, 1, 1, 7
"c:\Users\chris\source\repos\Cell\Cell\obj\Debug\net8.0-windows\Cell_phayacg0_wpftmp.sourcelink.json", "JSON", 0, 0, 0, 1, 0, 0, 0, 1
"c:\Users\chris\source\repos\Cell\Cell\obj\Debug\net8.0-windows\Cell_phpa2gdh_wpftmp.AssemblyInfo.cs", "C#", 11, 0, 0, 0, 0, 10, 5, 26
"c:\Users\chris\source\repos\Cell\Cell\obj\Debug\net8.0-windows\Cell_phpa2gdh_wpftmp.GeneratedMSBuildEditorConfig.editorconfig", "Properties", 0, 0, 0, 0, 21, 0, 1, 22
"c:\Users\chris\source\repos\Cell\Cell\obj\Debug\net8.0-windows\Cell_phpa2gdh_wpftmp.GlobalUsings.g.cs", "C#", 5, 0, 0, 0, 0, 1, 1, 7
"c:\Users\chris\source\repos\Cell\Cell\obj\Debug\net8.0-windows\Cell_phpa2gdh_wpftmp.sourcelink.json", "JSON", 0, 0, 0, 1, 0, 0, 0, 1
"c:\Users\chris\source\repos\Cell\Cell\obj\Debug\net8.0-windows\Cell_pi130dh5_wpftmp.AssemblyInfo.cs", "C#", 11, 0, 0, 0, 0, 10, 5, 26
"c:\Users\chris\source\repos\Cell\Cell\obj\Debug\net8.0-windows\Cell_pi130dh5_wpftmp.GeneratedMSBuildEditorConfig.editorconfig", "Properties", 0, 0, 0, 0, 21, 0, 1, 22
"c:\Users\chris\source\repos\Cell\Cell\obj\Debug\net8.0-windows\Cell_pi130dh5_wpftmp.GlobalUsings.g.cs", "C#", 5, 0, 0, 0, 0, 1, 1, 7
"c:\Users\chris\source\repos\Cell\Cell\obj\Debug\net8.0-windows\Cell_pi130dh5_wpftmp.sourcelink.json", "JSON", 0, 0, 0, 1, 0, 0, 0, 1
"c:\Users\chris\source\repos\Cell\Cell\obj\Debug\net8.0-windows\Cell_pjck3vs5_wpftmp.AssemblyInfo.cs", "C#", 11, 0, 0, 0, 0, 10, 5, 26
"c:\Users\chris\source\repos\Cell\Cell\obj\Debug\net8.0-windows\Cell_pjck3vs5_wpftmp.GeneratedMSBuildEditorConfig.editorconfig", "Properties", 0, 0, 0, 0, 21, 0, 1, 22
"c:\Users\chris\source\repos\Cell\Cell\obj\Debug\net8.0-windows\Cell_pjck3vs5_wpftmp.GlobalUsings.g.cs", "C#", 5, 0, 0, 0, 0, 1, 1, 7
"c:\Users\chris\source\repos\Cell\Cell\obj\Debug\net8.0-windows\Cell_pjck3vs5_wpftmp.sourcelink.json", "JSON", 0, 0, 0, 1, 0, 0, 0, 1
"c:\Users\chris\source\repos\Cell\Cell\obj\Debug\net8.0-windows\Cell_pkwz4iy5_wpftmp.AssemblyInfo.cs", "C#", 11, 0, 0, 0, 0, 10, 5, 26
"c:\Users\chris\source\repos\Cell\Cell\obj\Debug\net8.0-windows\Cell_pkwz4iy5_wpftmp.GeneratedMSBuildEditorConfig.editorconfig", "Properties", 0, 0, 0, 0, 21, 0, 1, 22
"c:\Users\chris\source\repos\Cell\Cell\obj\Debug\net8.0-windows\Cell_pkwz4iy5_wpftmp.GlobalUsings.g.cs", "C#", 5, 0, 0, 0, 0, 1, 1, 7
"c:\Users\chris\source\repos\Cell\Cell\obj\Debug\net8.0-windows\Cell_pkwz4iy5_wpftmp.sourcelink.json", "JSON", 0, 0, 0, 1, 0, 0, 0, 1
"c:\Users\chris\source\repos\Cell\Cell\obj\Debug\net8.0-windows\Cell_plxnsv2l_wpftmp.AssemblyInfo.cs", "C#", 11, 0, 0, 0, 0, 10, 5, 26
"c:\Users\chris\source\repos\Cell\Cell\obj\Debug\net8.0-windows\Cell_plxnsv2l_wpftmp.GeneratedMSBuildEditorConfig.editorconfig", "Properties", 0, 0, 0, 0, 13, 0, 1, 14
"c:\Users\chris\source\repos\Cell\Cell\obj\Debug\net8.0-windows\Cell_plxnsv2l_wpftmp.GlobalUsings.g.cs", "C#", 5, 0, 0, 0, 0, 1, 1, 7
"c:\Users\chris\source\repos\Cell\Cell\obj\Debug\net8.0-windows\Cell_pm0v5twv_wpftmp.AssemblyInfo.cs", "C#", 11, 0, 0, 0, 0, 10, 5, 26
"c:\Users\chris\source\repos\Cell\Cell\obj\Debug\net8.0-windows\Cell_pm0v5twv_wpftmp.GeneratedMSBuildEditorConfig.editorconfig", "Properties", 0, 0, 0, 0, 21, 0, 1, 22
"c:\Users\chris\source\repos\Cell\Cell\obj\Debug\net8.0-windows\Cell_pm0v5twv_wpftmp.GlobalUsings.g.cs", "C#", 5, 0, 0, 0, 0, 1, 1, 7
"c:\Users\chris\source\repos\Cell\Cell\obj\Debug\net8.0-windows\Cell_pm0v5twv_wpftmp.sourcelink.json", "JSON", 0, 0, 0, 1, 0, 0, 0, 1
"c:\Users\chris\source\repos\Cell\Cell\obj\Debug\net8.0-windows\Cell_pm51tlid_wpftmp.AssemblyInfo.cs", "C#", 11, 0, 0, 0, 0, 10, 5, 26
"c:\Users\chris\source\repos\Cell\Cell\obj\Debug\net8.0-windows\Cell_pm51tlid_wpftmp.GeneratedMSBuildEditorConfig.editorconfig", "Properties", 0, 0, 0, 0, 21, 0, 1, 22
"c:\Users\chris\source\repos\Cell\Cell\obj\Debug\net8.0-windows\Cell_pm51tlid_wpftmp.GlobalUsings.g.cs", "C#", 5, 0, 0, 0, 0, 1, 1, 7
"c:\Users\chris\source\repos\Cell\Cell\obj\Debug\net8.0-windows\Cell_pmdbk2mw_wpftmp.AssemblyInfo.cs", "C#", 11, 0, 0, 0, 0, 10, 5, 26
"c:\Users\chris\source\repos\Cell\Cell\obj\Debug\net8.0-windows\Cell_pmdbk2mw_wpftmp.GeneratedMSBuildEditorConfig.editorconfig", "Properties", 0, 0, 0, 0, 21, 0, 1, 22
"c:\Users\chris\source\repos\Cell\Cell\obj\Debug\net8.0-windows\Cell_pmdbk2mw_wpftmp.GlobalUsings.g.cs", "C#", 5, 0, 0, 0, 0, 1, 1, 7
"c:\Users\chris\source\repos\Cell\Cell\obj\Debug\net8.0-windows\Cell_pmdbk2mw_wpftmp.sourcelink.json", "JSON", 0, 0, 0, 1, 0, 0, 0, 1
"c:\Users\chris\source\repos\Cell\Cell\obj\Debug\net8.0-windows\Cell_pmhlqgqo_wpftmp.AssemblyInfo.cs", "C#", 11, 0, 0, 0, 0, 10, 5, 26
"c:\Users\chris\source\repos\Cell\Cell\obj\Debug\net8.0-windows\Cell_pmhlqgqo_wpftmp.GeneratedMSBuildEditorConfig.editorconfig", "Properties", 0, 0, 0, 0, 21, 0, 1, 22
"c:\Users\chris\source\repos\Cell\Cell\obj\Debug\net8.0-windows\Cell_pmhlqgqo_wpftmp.GlobalUsings.g.cs", "C#", 5, 0, 0, 0, 0, 1, 1, 7
"c:\Users\chris\source\repos\Cell\Cell\obj\Debug\net8.0-windows\Cell_pmhlqgqo_wpftmp.sourcelink.json", "JSON", 0, 0, 0, 1, 0, 0, 0, 1
"c:\Users\chris\source\repos\Cell\Cell\obj\Debug\net8.0-windows\Cell_pmk41dks_wpftmp.AssemblyInfo.cs", "C#", 11, 0, 0, 0, 0, 10, 5, 26
"c:\Users\chris\source\repos\Cell\Cell\obj\Debug\net8.0-windows\Cell_pmk41dks_wpftmp.GeneratedMSBuildEditorConfig.editorconfig", "Properties", 0, 0, 0, 0, 21, 0, 1, 22
"c:\Users\chris\source\repos\Cell\Cell\obj\Debug\net8.0-windows\Cell_pmk41dks_wpftmp.GlobalUsings.g.cs", "C#", 5, 0, 0, 0, 0, 1, 1, 7
"c:\Users\chris\source\repos\Cell\Cell\obj\Debug\net8.0-windows\Cell_pmk41dks_wpftmp.sourcelink.json", "JSON", 0, 0, 0, 1, 0, 0, 0, 1
"c:\Users\chris\source\repos\Cell\Cell\obj\Debug\net8.0-windows\Cell_pmtg0fs0_wpftmp.AssemblyInfo.cs", "C#", 11, 0, 0, 0, 0, 10, 5, 26
"c:\Users\chris\source\repos\Cell\Cell\obj\Debug\net8.0-windows\Cell_pmtg0fs0_wpftmp.GeneratedMSBuildEditorConfig.editorconfig", "Properties", 0, 0, 0, 0, 21, 0, 1, 22
"c:\Users\chris\source\repos\Cell\Cell\obj\Debug\net8.0-windows\Cell_pmtg0fs0_wpftmp.GlobalUsings.g.cs", "C#", 5, 0, 0, 0, 0, 1, 1, 7
"c:\Users\chris\source\repos\Cell\Cell\obj\Debug\net8.0-windows\Cell_pmtg0fs0_wpftmp.sourcelink.json", "JSON", 0, 0, 0, 1, 0, 0, 0, 1
"c:\Users\chris\source\repos\Cell\Cell\obj\Debug\net8.0-windows\Cell_po2xkax4_wpftmp.AssemblyInfo.cs", "C#", 11, 0, 0, 0, 0, 10, 5, 26
"c:\Users\chris\source\repos\Cell\Cell\obj\Debug\net8.0-windows\Cell_po2xkax4_wpftmp.GeneratedMSBuildEditorConfig.editorconfig", "Properties", 0, 0, 0, 0, 21, 0, 1, 22
"c:\Users\chris\source\repos\Cell\Cell\obj\Debug\net8.0-windows\Cell_po2xkax4_wpftmp.GlobalUsings.g.cs", "C#", 5, 0, 0, 0, 0, 1, 1, 7
"c:\Users\chris\source\repos\Cell\Cell\obj\Debug\net8.0-windows\Cell_po2xkax4_wpftmp.sourcelink.json", "JSON", 0, 0, 0, 1, 0, 0, 0, 1
"c:\Users\chris\source\repos\Cell\Cell\obj\Debug\net8.0-windows\Cell_pojn4wyh_wpftmp.AssemblyInfo.cs", "C#", 11, 0, 0, 0, 0, 10, 5, 26
"c:\Users\chris\source\repos\Cell\Cell\obj\Debug\net8.0-windows\Cell_pojn4wyh_wpftmp.GeneratedMSBuildEditorConfig.editorconfig", "Properties", 0, 0, 0, 0, 21, 0, 1, 22
"c:\Users\chris\source\repos\Cell\Cell\obj\Debug\net8.0-windows\Cell_pojn4wyh_wpftmp.GlobalUsings.g.cs", "C#", 5, 0, 0, 0, 0, 1, 1, 7
"c:\Users\chris\source\repos\Cell\Cell\obj\Debug\net8.0-windows\Cell_pojn4wyh_wpftmp.sourcelink.json", "JSON", 0, 0, 0, 1, 0, 0, 0, 1
"c:\Users\chris\source\repos\Cell\Cell\obj\Debug\net8.0-windows\Cell_ppbiulwb_wpftmp.AssemblyInfo.cs", "C#", 11, 0, 0, 0, 0, 10, 5, 26
"c:\Users\chris\source\repos\Cell\Cell\obj\Debug\net8.0-windows\Cell_ppbiulwb_wpftmp.GeneratedMSBuildEditorConfig.editorconfig", "Properties", 0, 0, 0, 0, 21, 0, 1, 22
"c:\Users\chris\source\repos\Cell\Cell\obj\Debug\net8.0-windows\Cell_ppbiulwb_wpftmp.GlobalUsings.g.cs", "C#", 5, 0, 0, 0, 0, 1, 1, 7
"c:\Users\chris\source\repos\Cell\Cell\obj\Debug\net8.0-windows\Cell_ppbiulwb_wpftmp.sourcelink.json", "JSON", 0, 0, 0, 1, 0, 0, 0, 1
"c:\Users\chris\source\repos\Cell\Cell\obj\Debug\net8.0-windows\Cell_pqsmx2mx_wpftmp.AssemblyInfo.cs", "C#", 11, 0, 0, 0, 0, 10, 5, 26
"c:\Users\chris\source\repos\Cell\Cell\obj\Debug\net8.0-windows\Cell_pqsmx2mx_wpftmp.GeneratedMSBuildEditorConfig.editorconfig", "Properties", 0, 0, 0, 0, 21, 0, 1, 22
"c:\Users\chris\source\repos\Cell\Cell\obj\Debug\net8.0-windows\Cell_pqsmx2mx_wpftmp.GlobalUsings.g.cs", "C#", 5, 0, 0, 0, 0, 1, 1, 7
"c:\Users\chris\source\repos\Cell\Cell\obj\Debug\net8.0-windows\Cell_pqsmx2mx_wpftmp.sourcelink.json", "JSON", 0, 0, 0, 1, 0, 0, 0, 1
"c:\Users\chris\source\repos\Cell\Cell\obj\Debug\net8.0-windows\Cell_przycsmg_wpftmp.AssemblyInfo.cs", "C#", 11, 0, 0, 0, 0, 10, 5, 26
"c:\Users\chris\source\repos\Cell\Cell\obj\Debug\net8.0-windows\Cell_przycsmg_wpftmp.GeneratedMSBuildEditorConfig.editorconfig", "Properties", 0, 0, 0, 0, 21, 0, 1, 22
"c:\Users\chris\source\repos\Cell\Cell\obj\Debug\net8.0-windows\Cell_przycsmg_wpftmp.GlobalUsings.g.cs", "C#", 5, 0, 0, 0, 0, 1, 1, 7
"c:\Users\chris\source\repos\Cell\Cell\obj\Debug\net8.0-windows\Cell_przycsmg_wpftmp.sourcelink.json", "JSON", 0, 0, 0, 1, 0, 0, 0, 1
"c:\Users\chris\source\repos\Cell\Cell\obj\Debug\net8.0-windows\Cell_psls3kfy_wpftmp.AssemblyInfo.cs", "C#", 11, 0, 0, 0, 0, 10, 5, 26
"c:\Users\chris\source\repos\Cell\Cell\obj\Debug\net8.0-windows\Cell_psls3kfy_wpftmp.GeneratedMSBuildEditorConfig.editorconfig", "Properties", 0, 0, 0, 0, 13, 0, 1, 14
"c:\Users\chris\source\repos\Cell\Cell\obj\Debug\net8.0-windows\Cell_psls3kfy_wpftmp.GlobalUsings.g.cs", "C#", 5, 0, 0, 0, 0, 1, 1, 7
"c:\Users\chris\source\repos\Cell\Cell\obj\Debug\net8.0-windows\Cell_pt2mwkew_wpftmp.AssemblyInfo.cs", "C#", 11, 0, 0, 0, 0, 10, 5, 26
"c:\Users\chris\source\repos\Cell\Cell\obj\Debug\net8.0-windows\Cell_pt2mwkew_wpftmp.GeneratedMSBuildEditorConfig.editorconfig", "Properties", 0, 0, 0, 0, 21, 0, 1, 22
"c:\Users\chris\source\repos\Cell\Cell\obj\Debug\net8.0-windows\Cell_pt2mwkew_wpftmp.GlobalUsings.g.cs", "C#", 5, 0, 0, 0, 0, 1, 1, 7
"c:\Users\chris\source\repos\Cell\Cell\obj\Debug\net8.0-windows\Cell_pt2mwkew_wpftmp.sourcelink.json", "JSON", 0, 0, 0, 1, 0, 0, 0, 1
"c:\Users\chris\source\repos\Cell\Cell\obj\Debug\net8.0-windows\Cell_pwbzyxbs_wpftmp.AssemblyInfo.cs", "C#", 11, 0, 0, 0, 0, 10, 5, 26
"c:\Users\chris\source\repos\Cell\Cell\obj\Debug\net8.0-windows\Cell_pwbzyxbs_wpftmp.GeneratedMSBuildEditorConfig.editorconfig", "Properties", 0, 0, 0, 0, 21, 0, 1, 22
"c:\Users\chris\source\repos\Cell\Cell\obj\Debug\net8.0-windows\Cell_pwbzyxbs_wpftmp.GlobalUsings.g.cs", "C#", 5, 0, 0, 0, 0, 1, 1, 7
"c:\Users\chris\source\repos\Cell\Cell\obj\Debug\net8.0-windows\Cell_pwbzyxbs_wpftmp.sourcelink.json", "JSON", 0, 0, 0, 1, 0, 0, 0, 1
"c:\Users\chris\source\repos\Cell\Cell\obj\Debug\net8.0-windows\Cell_pwffzboi_wpftmp.AssemblyInfo.cs", "C#", 11, 0, 0, 0, 0, 10, 5, 26
"c:\Users\chris\source\repos\Cell\Cell\obj\Debug\net8.0-windows\Cell_pwffzboi_wpftmp.GeneratedMSBuildEditorConfig.editorconfig", "Properties", 0, 0, 0, 0, 21, 0, 1, 22
"c:\Users\chris\source\repos\Cell\Cell\obj\Debug\net8.0-windows\Cell_pwffzboi_wpftmp.GlobalUsings.g.cs", "C#", 5, 0, 0, 0, 0, 1, 1, 7
"c:\Users\chris\source\repos\Cell\Cell\obj\Debug\net8.0-windows\Cell_pwffzboi_wpftmp.sourcelink.json", "JSON", 0, 0, 0, 1, 0, 0, 0, 1
"c:\Users\chris\source\repos\Cell\Cell\obj\Debug\net8.0-windows\Cell_pwkvqccs_wpftmp.AssemblyInfo.cs", "C#", 11, 0, 0, 0, 0, 10, 5, 26
"c:\Users\chris\source\repos\Cell\Cell\obj\Debug\net8.0-windows\Cell_pwkvqccs_wpftmp.GeneratedMSBuildEditorConfig.editorconfig", "Properties", 0, 0, 0, 0, 21, 0, 1, 22
"c:\Users\chris\source\repos\Cell\Cell\obj\Debug\net8.0-windows\Cell_pwkvqccs_wpftmp.GlobalUsings.g.cs", "C#", 5, 0, 0, 0, 0, 1, 1, 7
"c:\Users\chris\source\repos\Cell\Cell\obj\Debug\net8.0-windows\Cell_pwkvqccs_wpftmp.sourcelink.json", "JSON", 0, 0, 0, 1, 0, 0, 0, 1
"c:\Users\chris\source\repos\Cell\Cell\obj\Debug\net8.0-windows\Cell_pwyskcvf_wpftmp.AssemblyInfo.cs", "C#", 11, 0, 0, 0, 0, 10, 5, 26
"c:\Users\chris\source\repos\Cell\Cell\obj\Debug\net8.0-windows\Cell_pwyskcvf_wpftmp.GeneratedMSBuildEditorConfig.editorconfig", "Properties", 0, 0, 0, 0, 21, 0, 1, 22
"c:\Users\chris\source\repos\Cell\Cell\obj\Debug\net8.0-windows\Cell_pwyskcvf_wpftmp.GlobalUsings.g.cs", "C#", 5, 0, 0, 0, 0, 1, 1, 7
"c:\Users\chris\source\repos\Cell\Cell\obj\Debug\net8.0-windows\Cell_pwyskcvf_wpftmp.sourcelink.json", "JSON", 0, 0, 0, 1, 0, 0, 0, 1
"c:\Users\chris\source\repos\Cell\Cell\obj\Debug\net8.0-windows\Cell_pxcoc3b5_wpftmp.AssemblyInfo.cs", "C#", 11, 0, 0, 0, 0, 10, 5, 26
"c:\Users\chris\source\repos\Cell\Cell\obj\Debug\net8.0-windows\Cell_pxcoc3b5_wpftmp.GeneratedMSBuildEditorConfig.editorconfig", "Properties", 0, 0, 0, 0, 21, 0, 1, 22
"c:\Users\chris\source\repos\Cell\Cell\obj\Debug\net8.0-windows\Cell_pxcoc3b5_wpftmp.GlobalUsings.g.cs", "C#", 5, 0, 0, 0, 0, 1, 1, 7
"c:\Users\chris\source\repos\Cell\Cell\obj\Debug\net8.0-windows\Cell_pxcoc3b5_wpftmp.sourcelink.json", "JSON", 0, 0, 0, 1, 0, 0, 0, 1
"c:\Users\chris\source\repos\Cell\Cell\obj\Debug\net8.0-windows\Cell_pythisgv_wpftmp.AssemblyInfo.cs", "C#", 11, 0, 0, 0, 0, 10, 5, 26
"c:\Users\chris\source\repos\Cell\Cell\obj\Debug\net8.0-windows\Cell_pythisgv_wpftmp.GeneratedMSBuildEditorConfig.editorconfig", "Properties", 0, 0, 0, 0, 21, 0, 1, 22
"c:\Users\chris\source\repos\Cell\Cell\obj\Debug\net8.0-windows\Cell_pythisgv_wpftmp.GlobalUsings.g.cs", "C#", 5, 0, 0, 0, 0, 1, 1, 7
"c:\Users\chris\source\repos\Cell\Cell\obj\Debug\net8.0-windows\Cell_pythisgv_wpftmp.sourcelink.json", "JSON", 0, 0, 0, 1, 0, 0, 0, 1
"c:\Users\chris\source\repos\Cell\Cell\obj\Debug\net8.0-windows\Cell_q0c3muiy_wpftmp.AssemblyInfo.cs", "C#", 11, 0, 0, 0, 0, 10, 5, 26
"c:\Users\chris\source\repos\Cell\Cell\obj\Debug\net8.0-windows\Cell_q0c3muiy_wpftmp.GeneratedMSBuildEditorConfig.editorconfig", "Properties", 0, 0, 0, 0, 21, 0, 1, 22
"c:\Users\chris\source\repos\Cell\Cell\obj\Debug\net8.0-windows\Cell_q0c3muiy_wpftmp.GlobalUsings.g.cs", "C#", 5, 0, 0, 0, 0, 1, 1, 7
"c:\Users\chris\source\repos\Cell\Cell\obj\Debug\net8.0-windows\Cell_q0c3muiy_wpftmp.sourcelink.json", "JSON", 0, 0, 0, 1, 0, 0, 0, 1
"c:\Users\chris\source\repos\Cell\Cell\obj\Debug\net8.0-windows\Cell_q23d503z_wpftmp.AssemblyInfo.cs", "C#", 11, 0, 0, 0, 0, 10, 5, 26
"c:\Users\chris\source\repos\Cell\Cell\obj\Debug\net8.0-windows\Cell_q23d503z_wpftmp.GeneratedMSBuildEditorConfig.editorconfig", "Properties", 0, 0, 0, 0, 21, 0, 1, 22
"c:\Users\chris\source\repos\Cell\Cell\obj\Debug\net8.0-windows\Cell_q23d503z_wpftmp.GlobalUsings.g.cs", "C#", 5, 0, 0, 0, 0, 1, 1, 7
"c:\Users\chris\source\repos\Cell\Cell\obj\Debug\net8.0-windows\Cell_q23d503z_wpftmp.sourcelink.json", "JSON", 0, 0, 0, 1, 0, 0, 0, 1
"c:\Users\chris\source\repos\Cell\Cell\obj\Debug\net8.0-windows\Cell_q2adcart_wpftmp.AssemblyInfo.cs", "C#", 11, 0, 0, 0, 0, 10, 5, 26
"c:\Users\chris\source\repos\Cell\Cell\obj\Debug\net8.0-windows\Cell_q2adcart_wpftmp.GeneratedMSBuildEditorConfig.editorconfig", "Properties", 0, 0, 0, 0, 21, 0, 1, 22
"c:\Users\chris\source\repos\Cell\Cell\obj\Debug\net8.0-windows\Cell_q2adcart_wpftmp.GlobalUsings.g.cs", "C#", 5, 0, 0, 0, 0, 1, 1, 7
"c:\Users\chris\source\repos\Cell\Cell\obj\Debug\net8.0-windows\Cell_q2adcart_wpftmp.sourcelink.json", "JSON", 0, 0, 0, 1, 0, 0, 0, 1
"c:\Users\chris\source\repos\Cell\Cell\obj\Debug\net8.0-windows\Cell_q2pftyvm_wpftmp.AssemblyInfo.cs", "C#", 11, 0, 0, 0, 0, 10, 5, 26
"c:\Users\chris\source\repos\Cell\Cell\obj\Debug\net8.0-windows\Cell_q2pftyvm_wpftmp.GeneratedMSBuildEditorConfig.editorconfig", "Properties", 0, 0, 0, 0, 21, 0, 1, 22
"c:\Users\chris\source\repos\Cell\Cell\obj\Debug\net8.0-windows\Cell_q2pftyvm_wpftmp.GlobalUsings.g.cs", "C#", 5, 0, 0, 0, 0, 1, 1, 7
"c:\Users\chris\source\repos\Cell\Cell\obj\Debug\net8.0-windows\Cell_q2pftyvm_wpftmp.sourcelink.json", "JSON", 0, 0, 0, 1, 0, 0, 0, 1
"c:\Users\chris\source\repos\Cell\Cell\obj\Debug\net8.0-windows\Cell_q2zupzem_wpftmp.AssemblyInfo.cs", "C#", 11, 0, 0, 0, 0, 10, 5, 26
"c:\Users\chris\source\repos\Cell\Cell\obj\Debug\net8.0-windows\Cell_q2zupzem_wpftmp.GeneratedMSBuildEditorConfig.editorconfig", "Properties", 0, 0, 0, 0, 21, 0, 1, 22
"c:\Users\chris\source\repos\Cell\Cell\obj\Debug\net8.0-windows\Cell_q2zupzem_wpftmp.GlobalUsings.g.cs", "C#", 5, 0, 0, 0, 0, 1, 1, 7
"c:\Users\chris\source\repos\Cell\Cell\obj\Debug\net8.0-windows\Cell_q2zupzem_wpftmp.sourcelink.json", "JSON", 0, 0, 0, 1, 0, 0, 0, 1
"c:\Users\chris\source\repos\Cell\Cell\obj\Debug\net8.0-windows\Cell_q3gn1xe5_wpftmp.AssemblyInfo.cs", "C#", 11, 0, 0, 0, 0, 10, 5, 26
"c:\Users\chris\source\repos\Cell\Cell\obj\Debug\net8.0-windows\Cell_q3gn1xe5_wpftmp.GeneratedMSBuildEditorConfig.editorconfig", "Properties", 0, 0, 0, 0, 13, 0, 1, 14
"c:\Users\chris\source\repos\Cell\Cell\obj\Debug\net8.0-windows\Cell_q3gn1xe5_wpftmp.GlobalUsings.g.cs", "C#", 5, 0, 0, 0, 0, 1, 1, 7
"c:\Users\chris\source\repos\Cell\Cell\obj\Debug\net8.0-windows\Cell_q3yejs4t_wpftmp.AssemblyInfo.cs", "C#", 11, 0, 0, 0, 0, 10, 5, 26
"c:\Users\chris\source\repos\Cell\Cell\obj\Debug\net8.0-windows\Cell_q3yejs4t_wpftmp.GeneratedMSBuildEditorConfig.editorconfig", "Properties", 0, 0, 0, 0, 21, 0, 1, 22
"c:\Users\chris\source\repos\Cell\Cell\obj\Debug\net8.0-windows\Cell_q3yejs4t_wpftmp.GlobalUsings.g.cs", "C#", 5, 0, 0, 0, 0, 1, 1, 7
"c:\Users\chris\source\repos\Cell\Cell\obj\Debug\net8.0-windows\Cell_q3yejs4t_wpftmp.sourcelink.json", "JSON", 0, 0, 0, 1, 0, 0, 0, 1
"c:\Users\chris\source\repos\Cell\Cell\obj\Debug\net8.0-windows\Cell_q45hipl4_wpftmp.AssemblyInfo.cs", "C#", 11, 0, 0, 0, 0, 10, 5, 26
"c:\Users\chris\source\repos\Cell\Cell\obj\Debug\net8.0-windows\Cell_q45hipl4_wpftmp.GeneratedMSBuildEditorConfig.editorconfig", "Properties", 0, 0, 0, 0, 21, 0, 1, 22
"c:\Users\chris\source\repos\Cell\Cell\obj\Debug\net8.0-windows\Cell_q45hipl4_wpftmp.GlobalUsings.g.cs", "C#", 5, 0, 0, 0, 0, 1, 1, 7
"c:\Users\chris\source\repos\Cell\Cell\obj\Debug\net8.0-windows\Cell_q45hipl4_wpftmp.sourcelink.json", "JSON", 0, 0, 0, 1, 0, 0, 0, 1
"c:\Users\chris\source\repos\Cell\Cell\obj\Debug\net8.0-windows\Cell_q4lotdss_wpftmp.AssemblyInfo.cs", "C#", 11, 0, 0, 0, 0, 10, 5, 26
"c:\Users\chris\source\repos\Cell\Cell\obj\Debug\net8.0-windows\Cell_q4lotdss_wpftmp.GeneratedMSBuildEditorConfig.editorconfig", "Properties", 0, 0, 0, 0, 13, 0, 1, 14
"c:\Users\chris\source\repos\Cell\Cell\obj\Debug\net8.0-windows\Cell_q4lotdss_wpftmp.GlobalUsings.g.cs", "C#", 5, 0, 0, 0, 0, 1, 1, 7
"c:\Users\chris\source\repos\Cell\Cell\obj\Debug\net8.0-windows\Cell_q4nifita_wpftmp.AssemblyInfo.cs", "C#", 11, 0, 0, 0, 0, 10, 5, 26
"c:\Users\chris\source\repos\Cell\Cell\obj\Debug\net8.0-windows\Cell_q4nifita_wpftmp.GeneratedMSBuildEditorConfig.editorconfig", "Properties", 0, 0, 0, 0, 21, 0, 1, 22
"c:\Users\chris\source\repos\Cell\Cell\obj\Debug\net8.0-windows\Cell_q4nifita_wpftmp.GlobalUsings.g.cs", "C#", 5, 0, 0, 0, 0, 1, 1, 7
"c:\Users\chris\source\repos\Cell\Cell\obj\Debug\net8.0-windows\Cell_q4nifita_wpftmp.sourcelink.json", "JSON", 0, 0, 0, 1, 0, 0, 0, 1
"c:\Users\chris\source\repos\Cell\Cell\obj\Debug\net8.0-windows\Cell_qbdoe4aa_wpftmp.AssemblyInfo.cs", "C#", 11, 0, 0, 0, 0, 10, 5, 26
"c:\Users\chris\source\repos\Cell\Cell\obj\Debug\net8.0-windows\Cell_qbdoe4aa_wpftmp.GeneratedMSBuildEditorConfig.editorconfig", "Properties", 0, 0, 0, 0, 21, 0, 1, 22
"c:\Users\chris\source\repos\Cell\Cell\obj\Debug\net8.0-windows\Cell_qbdoe4aa_wpftmp.GlobalUsings.g.cs", "C#", 5, 0, 0, 0, 0, 1, 1, 7
"c:\Users\chris\source\repos\Cell\Cell\obj\Debug\net8.0-windows\Cell_qbdoe4aa_wpftmp.sourcelink.json", "JSON", 0, 0, 0, 1, 0, 0, 0, 1
"c:\Users\chris\source\repos\Cell\Cell\obj\Debug\net8.0-windows\Cell_qc4yxxuv_wpftmp.AssemblyInfo.cs", "C#", 11, 0, 0, 0, 0, 10, 5, 26
"c:\Users\chris\source\repos\Cell\Cell\obj\Debug\net8.0-windows\Cell_qc4yxxuv_wpftmp.GeneratedMSBuildEditorConfig.editorconfig", "Properties", 0, 0, 0, 0, 21, 0, 1, 22
"c:\Users\chris\source\repos\Cell\Cell\obj\Debug\net8.0-windows\Cell_qc4yxxuv_wpftmp.GlobalUsings.g.cs", "C#", 5, 0, 0, 0, 0, 1, 1, 7
"c:\Users\chris\source\repos\Cell\Cell\obj\Debug\net8.0-windows\Cell_qc4yxxuv_wpftmp.sourcelink.json", "JSON", 0, 0, 0, 1, 0, 0, 0, 1
"c:\Users\chris\source\repos\Cell\Cell\obj\Debug\net8.0-windows\Cell_qeggt5yw_wpftmp.AssemblyInfo.cs", "C#", 11, 0, 0, 0, 0, 10, 5, 26
"c:\Users\chris\source\repos\Cell\Cell\obj\Debug\net8.0-windows\Cell_qeggt5yw_wpftmp.GeneratedMSBuildEditorConfig.editorconfig", "Properties", 0, 0, 0, 0, 21, 0, 1, 22
"c:\Users\chris\source\repos\Cell\Cell\obj\Debug\net8.0-windows\Cell_qeggt5yw_wpftmp.GlobalUsings.g.cs", "C#", 5, 0, 0, 0, 0, 1, 1, 7
"c:\Users\chris\source\repos\Cell\Cell\obj\Debug\net8.0-windows\Cell_qeggt5yw_wpftmp.sourcelink.json", "JSON", 0, 0, 0, 1, 0, 0, 0, 1
"c:\Users\chris\source\repos\Cell\Cell\obj\Debug\net8.0-windows\Cell_qezvlnhj_wpftmp.AssemblyInfo.cs", "C#", 11, 0, 0, 0, 0, 10, 5, 26
"c:\Users\chris\source\repos\Cell\Cell\obj\Debug\net8.0-windows\Cell_qezvlnhj_wpftmp.GeneratedMSBuildEditorConfig.editorconfig", "Properties", 0, 0, 0, 0, 21, 0, 1, 22
"c:\Users\chris\source\repos\Cell\Cell\obj\Debug\net8.0-windows\Cell_qezvlnhj_wpftmp.GlobalUsings.g.cs", "C#", 5, 0, 0, 0, 0, 1, 1, 7
"c:\Users\chris\source\repos\Cell\Cell\obj\Debug\net8.0-windows\Cell_qezvlnhj_wpftmp.sourcelink.json", "JSON", 0, 0, 0, 1, 0, 0, 0, 1
"c:\Users\chris\source\repos\Cell\Cell\obj\Debug\net8.0-windows\Cell_qfk3vunl_wpftmp.AssemblyInfo.cs", "C#", 11, 0, 0, 0, 0, 10, 5, 26
"c:\Users\chris\source\repos\Cell\Cell\obj\Debug\net8.0-windows\Cell_qfk3vunl_wpftmp.GeneratedMSBuildEditorConfig.editorconfig", "Properties", 0, 0, 0, 0, 21, 0, 1, 22
"c:\Users\chris\source\repos\Cell\Cell\obj\Debug\net8.0-windows\Cell_qfk3vunl_wpftmp.GlobalUsings.g.cs", "C#", 5, 0, 0, 0, 0, 1, 1, 7
"c:\Users\chris\source\repos\Cell\Cell\obj\Debug\net8.0-windows\Cell_qfk3vunl_wpftmp.sourcelink.json", "JSON", 0, 0, 0, 1, 0, 0, 0, 1
"c:\Users\chris\source\repos\Cell\Cell\obj\Debug\net8.0-windows\Cell_qgjddbur_wpftmp.AssemblyInfo.cs", "C#", 11, 0, 0, 0, 0, 10, 5, 26
"c:\Users\chris\source\repos\Cell\Cell\obj\Debug\net8.0-windows\Cell_qgjddbur_wpftmp.GeneratedMSBuildEditorConfig.editorconfig", "Properties", 0, 0, 0, 0, 21, 0, 1, 22
"c:\Users\chris\source\repos\Cell\Cell\obj\Debug\net8.0-windows\Cell_qgjddbur_wpftmp.GlobalUsings.g.cs", "C#", 5, 0, 0, 0, 0, 1, 1, 7
"c:\Users\chris\source\repos\Cell\Cell\obj\Debug\net8.0-windows\Cell_qgjddbur_wpftmp.sourcelink.json", "JSON", 0, 0, 0, 1, 0, 0, 0, 1
"c:\Users\chris\source\repos\Cell\Cell\obj\Debug\net8.0-windows\Cell_qgwxgrug_wpftmp.AssemblyInfo.cs", "C#", 11, 0, 0, 0, 0, 10, 5, 26
"c:\Users\chris\source\repos\Cell\Cell\obj\Debug\net8.0-windows\Cell_qgwxgrug_wpftmp.GeneratedMSBuildEditorConfig.editorconfig", "Properties", 0, 0, 0, 0, 13, 0, 1, 14
"c:\Users\chris\source\repos\Cell\Cell\obj\Debug\net8.0-windows\Cell_qgwxgrug_wpftmp.GlobalUsings.g.cs", "C#", 5, 0, 0, 0, 0, 1, 1, 7
"c:\Users\chris\source\repos\Cell\Cell\obj\Debug\net8.0-windows\Cell_qh5hf50s_wpftmp.AssemblyInfo.cs", "C#", 11, 0, 0, 0, 0, 10, 5, 26
"c:\Users\chris\source\repos\Cell\Cell\obj\Debug\net8.0-windows\Cell_qh5hf50s_wpftmp.GeneratedMSBuildEditorConfig.editorconfig", "Properties", 0, 0, 0, 0, 13, 0, 1, 14
"c:\Users\chris\source\repos\Cell\Cell\obj\Debug\net8.0-windows\Cell_qh5hf50s_wpftmp.GlobalUsings.g.cs", "C#", 5, 0, 0, 0, 0, 1, 1, 7
"c:\Users\chris\source\repos\Cell\Cell\obj\Debug\net8.0-windows\Cell_qhduc5vr_wpftmp.AssemblyInfo.cs", "C#", 11, 0, 0, 0, 0, 10, 5, 26
"c:\Users\chris\source\repos\Cell\Cell\obj\Debug\net8.0-windows\Cell_qhduc5vr_wpftmp.GeneratedMSBuildEditorConfig.editorconfig", "Properties", 0, 0, 0, 0, 21, 0, 1, 22
"c:\Users\chris\source\repos\Cell\Cell\obj\Debug\net8.0-windows\Cell_qhduc5vr_wpftmp.GlobalUsings.g.cs", "C#", 5, 0, 0, 0, 0, 1, 1, 7
"c:\Users\chris\source\repos\Cell\Cell\obj\Debug\net8.0-windows\Cell_qhduc5vr_wpftmp.sourcelink.json", "JSON", 0, 0, 0, 1, 0, 0, 0, 1
"c:\Users\chris\source\repos\Cell\Cell\obj\Debug\net8.0-windows\Cell_qhnpxyld_wpftmp.AssemblyInfo.cs", "C#", 11, 0, 0, 0, 0, 10, 5, 26
"c:\Users\chris\source\repos\Cell\Cell\obj\Debug\net8.0-windows\Cell_qhnpxyld_wpftmp.GeneratedMSBuildEditorConfig.editorconfig", "Properties", 0, 0, 0, 0, 21, 0, 1, 22
"c:\Users\chris\source\repos\Cell\Cell\obj\Debug\net8.0-windows\Cell_qhnpxyld_wpftmp.GlobalUsings.g.cs", "C#", 5, 0, 0, 0, 0, 1, 1, 7
"c:\Users\chris\source\repos\Cell\Cell\obj\Debug\net8.0-windows\Cell_qhnpxyld_wpftmp.sourcelink.json", "JSON", 0, 0, 0, 1, 0, 0, 0, 1
"c:\Users\chris\source\repos\Cell\Cell\obj\Debug\net8.0-windows\Cell_qhqjgkad_wpftmp.AssemblyInfo.cs", "C#", 11, 0, 0, 0, 0, 10, 5, 26
"c:\Users\chris\source\repos\Cell\Cell\obj\Debug\net8.0-windows\Cell_qhqjgkad_wpftmp.GeneratedMSBuildEditorConfig.editorconfig", "Properties", 0, 0, 0, 0, 21, 0, 1, 22
"c:\Users\chris\source\repos\Cell\Cell\obj\Debug\net8.0-windows\Cell_qhqjgkad_wpftmp.GlobalUsings.g.cs", "C#", 5, 0, 0, 0, 0, 1, 1, 7
"c:\Users\chris\source\repos\Cell\Cell\obj\Debug\net8.0-windows\Cell_qhqjgkad_wpftmp.sourcelink.json", "JSON", 0, 0, 0, 1, 0, 0, 0, 1
"c:\Users\chris\source\repos\Cell\Cell\obj\Debug\net8.0-windows\Cell_qiq3wrrf_wpftmp.AssemblyInfo.cs", "C#", 11, 0, 0, 0, 0, 10, 5, 26
"c:\Users\chris\source\repos\Cell\Cell\obj\Debug\net8.0-windows\Cell_qiq3wrrf_wpftmp.GeneratedMSBuildEditorConfig.editorconfig", "Properties", 0, 0, 0, 0, 13, 0, 1, 14
"c:\Users\chris\source\repos\Cell\Cell\obj\Debug\net8.0-windows\Cell_qiq3wrrf_wpftmp.GlobalUsings.g.cs", "C#", 5, 0, 0, 0, 0, 1, 1, 7
"c:\Users\chris\source\repos\Cell\Cell\obj\Debug\net8.0-windows\Cell_qjcviy4d_wpftmp.AssemblyInfo.cs", "C#", 11, 0, 0, 0, 0, 10, 5, 26
"c:\Users\chris\source\repos\Cell\Cell\obj\Debug\net8.0-windows\Cell_qjcviy4d_wpftmp.GeneratedMSBuildEditorConfig.editorconfig", "Properties", 0, 0, 0, 0, 21, 0, 1, 22
"c:\Users\chris\source\repos\Cell\Cell\obj\Debug\net8.0-windows\Cell_qjcviy4d_wpftmp.GlobalUsings.g.cs", "C#", 5, 0, 0, 0, 0, 1, 1, 7
"c:\Users\chris\source\repos\Cell\Cell\obj\Debug\net8.0-windows\Cell_qjcviy4d_wpftmp.sourcelink.json", "JSON", 0, 0, 0, 1, 0, 0, 0, 1
"c:\Users\chris\source\repos\Cell\Cell\obj\Debug\net8.0-windows\Cell_qjpnqz1c_wpftmp.AssemblyInfo.cs", "C#", 11, 0, 0, 0, 0, 10, 5, 26
"c:\Users\chris\source\repos\Cell\Cell\obj\Debug\net8.0-windows\Cell_qjpnqz1c_wpftmp.GeneratedMSBuildEditorConfig.editorconfig", "Properties", 0, 0, 0, 0, 21, 0, 1, 22
"c:\Users\chris\source\repos\Cell\Cell\obj\Debug\net8.0-windows\Cell_qjpnqz1c_wpftmp.GlobalUsings.g.cs", "C#", 5, 0, 0, 0, 0, 1, 1, 7
"c:\Users\chris\source\repos\Cell\Cell\obj\Debug\net8.0-windows\Cell_qjpnqz1c_wpftmp.sourcelink.json", "JSON", 0, 0, 0, 1, 0, 0, 0, 1
"c:\Users\chris\source\repos\Cell\Cell\obj\Debug\net8.0-windows\Cell_qkpdkgjn_wpftmp.AssemblyInfo.cs", "C#", 11, 0, 0, 0, 0, 10, 5, 26
"c:\Users\chris\source\repos\Cell\Cell\obj\Debug\net8.0-windows\Cell_qkpdkgjn_wpftmp.GeneratedMSBuildEditorConfig.editorconfig", "Properties", 0, 0, 0, 0, 21, 0, 1, 22
"c:\Users\chris\source\repos\Cell\Cell\obj\Debug\net8.0-windows\Cell_qkpdkgjn_wpftmp.GlobalUsings.g.cs", "C#", 5, 0, 0, 0, 0, 1, 1, 7
"c:\Users\chris\source\repos\Cell\Cell\obj\Debug\net8.0-windows\Cell_qkpdkgjn_wpftmp.sourcelink.json", "JSON", 0, 0, 0, 1, 0, 0, 0, 1
"c:\Users\chris\source\repos\Cell\Cell\obj\Debug\net8.0-windows\Cell_qlp2iqmy_wpftmp.AssemblyInfo.cs", "C#", 11, 0, 0, 0, 0, 10, 5, 26
"c:\Users\chris\source\repos\Cell\Cell\obj\Debug\net8.0-windows\Cell_qlp2iqmy_wpftmp.GeneratedMSBuildEditorConfig.editorconfig", "Properties", 0, 0, 0, 0, 21, 0, 1, 22
"c:\Users\chris\source\repos\Cell\Cell\obj\Debug\net8.0-windows\Cell_qlp2iqmy_wpftmp.GlobalUsings.g.cs", "C#", 5, 0, 0, 0, 0, 1, 1, 7
"c:\Users\chris\source\repos\Cell\Cell\obj\Debug\net8.0-windows\Cell_qlp2iqmy_wpftmp.sourcelink.json", "JSON", 0, 0, 0, 1, 0, 0, 0, 1
"c:\Users\chris\source\repos\Cell\Cell\obj\Debug\net8.0-windows\Cell_qltgy22z_wpftmp.AssemblyInfo.cs", "C#", 11, 0, 0, 0, 0, 10, 5, 26
"c:\Users\chris\source\repos\Cell\Cell\obj\Debug\net8.0-windows\Cell_qltgy22z_wpftmp.GeneratedMSBuildEditorConfig.editorconfig", "Properties", 0, 0, 0, 0, 21, 0, 1, 22
"c:\Users\chris\source\repos\Cell\Cell\obj\Debug\net8.0-windows\Cell_qltgy22z_wpftmp.GlobalUsings.g.cs", "C#", 5, 0, 0, 0, 0, 1, 1, 7
"c:\Users\chris\source\repos\Cell\Cell\obj\Debug\net8.0-windows\Cell_qltgy22z_wpftmp.sourcelink.json", "JSON", 0, 0, 0, 1, 0, 0, 0, 1
"c:\Users\chris\source\repos\Cell\Cell\obj\Debug\net8.0-windows\Cell_qq31fqd0_wpftmp.AssemblyInfo.cs", "C#", 11, 0, 0, 0, 0, 10, 5, 26
"c:\Users\chris\source\repos\Cell\Cell\obj\Debug\net8.0-windows\Cell_qq31fqd0_wpftmp.GeneratedMSBuildEditorConfig.editorconfig", "Properties", 0, 0, 0, 0, 21, 0, 1, 22
"c:\Users\chris\source\repos\Cell\Cell\obj\Debug\net8.0-windows\Cell_qq31fqd0_wpftmp.GlobalUsings.g.cs", "C#", 5, 0, 0, 0, 0, 1, 1, 7
"c:\Users\chris\source\repos\Cell\Cell\obj\Debug\net8.0-windows\Cell_qq31fqd0_wpftmp.sourcelink.json", "JSON", 0, 0, 0, 1, 0, 0, 0, 1
"c:\Users\chris\source\repos\Cell\Cell\obj\Debug\net8.0-windows\Cell_qqgihsj2_wpftmp.AssemblyInfo.cs", "C#", 11, 0, 0, 0, 0, 10, 5, 26
"c:\Users\chris\source\repos\Cell\Cell\obj\Debug\net8.0-windows\Cell_qqgihsj2_wpftmp.GeneratedMSBuildEditorConfig.editorconfig", "Properties", 0, 0, 0, 0, 21, 0, 1, 22
"c:\Users\chris\source\repos\Cell\Cell\obj\Debug\net8.0-windows\Cell_qqgihsj2_wpftmp.GlobalUsings.g.cs", "C#", 5, 0, 0, 0, 0, 1, 1, 7
"c:\Users\chris\source\repos\Cell\Cell\obj\Debug\net8.0-windows\Cell_qqgihsj2_wpftmp.sourcelink.json", "JSON", 0, 0, 0, 1, 0, 0, 0, 1
"c:\Users\chris\source\repos\Cell\Cell\obj\Debug\net8.0-windows\Cell_qqvwhbul_wpftmp.AssemblyInfo.cs", "C#", 11, 0, 0, 0, 0, 10, 5, 26
"c:\Users\chris\source\repos\Cell\Cell\obj\Debug\net8.0-windows\Cell_qqvwhbul_wpftmp.GeneratedMSBuildEditorConfig.editorconfig", "Properties", 0, 0, 0, 0, 21, 0, 1, 22
"c:\Users\chris\source\repos\Cell\Cell\obj\Debug\net8.0-windows\Cell_qqvwhbul_wpftmp.GlobalUsings.g.cs", "C#", 5, 0, 0, 0, 0, 1, 1, 7
"c:\Users\chris\source\repos\Cell\Cell\obj\Debug\net8.0-windows\Cell_qqvwhbul_wpftmp.sourcelink.json", "JSON", 0, 0, 0, 1, 0, 0, 0, 1
"c:\Users\chris\source\repos\Cell\Cell\obj\Debug\net8.0-windows\Cell_qsfcj2tr_wpftmp.AssemblyInfo.cs", "C#", 11, 0, 0, 0, 0, 10, 5, 26
"c:\Users\chris\source\repos\Cell\Cell\obj\Debug\net8.0-windows\Cell_qsfcj2tr_wpftmp.GeneratedMSBuildEditorConfig.editorconfig", "Properties", 0, 0, 0, 0, 21, 0, 1, 22
"c:\Users\chris\source\repos\Cell\Cell\obj\Debug\net8.0-windows\Cell_qsfcj2tr_wpftmp.GlobalUsings.g.cs", "C#", 5, 0, 0, 0, 0, 1, 1, 7
"c:\Users\chris\source\repos\Cell\Cell\obj\Debug\net8.0-windows\Cell_qsfcj2tr_wpftmp.sourcelink.json", "JSON", 0, 0, 0, 1, 0, 0, 0, 1
"c:\Users\chris\source\repos\Cell\Cell\obj\Debug\net8.0-windows\Cell_qt1g5dng_wpftmp.AssemblyInfo.cs", "C#", 11, 0, 0, 0, 0, 10, 5, 26
"c:\Users\chris\source\repos\Cell\Cell\obj\Debug\net8.0-windows\Cell_qt1g5dng_wpftmp.GeneratedMSBuildEditorConfig.editorconfig", "Properties", 0, 0, 0, 0, 21, 0, 1, 22
"c:\Users\chris\source\repos\Cell\Cell\obj\Debug\net8.0-windows\Cell_qt1g5dng_wpftmp.GlobalUsings.g.cs", "C#", 5, 0, 0, 0, 0, 1, 1, 7
"c:\Users\chris\source\repos\Cell\Cell\obj\Debug\net8.0-windows\Cell_qt1g5dng_wpftmp.sourcelink.json", "JSON", 0, 0, 0, 1, 0, 0, 0, 1
"c:\Users\chris\source\repos\Cell\Cell\obj\Debug\net8.0-windows\Cell_qtflgzvy_wpftmp.AssemblyInfo.cs", "C#", 11, 0, 0, 0, 0, 10, 5, 26
"c:\Users\chris\source\repos\Cell\Cell\obj\Debug\net8.0-windows\Cell_qtflgzvy_wpftmp.GeneratedMSBuildEditorConfig.editorconfig", "Properties", 0, 0, 0, 0, 21, 0, 1, 22
"c:\Users\chris\source\repos\Cell\Cell\obj\Debug\net8.0-windows\Cell_qtflgzvy_wpftmp.GlobalUsings.g.cs", "C#", 5, 0, 0, 0, 0, 1, 1, 7
"c:\Users\chris\source\repos\Cell\Cell\obj\Debug\net8.0-windows\Cell_qtflgzvy_wpftmp.sourcelink.json", "JSON", 0, 0, 0, 1, 0, 0, 0, 1
"c:\Users\chris\source\repos\Cell\Cell\obj\Debug\net8.0-windows\Cell_qvdusxfn_wpftmp.AssemblyInfo.cs", "C#", 11, 0, 0, 0, 0, 10, 5, 26
"c:\Users\chris\source\repos\Cell\Cell\obj\Debug\net8.0-windows\Cell_qvdusxfn_wpftmp.GeneratedMSBuildEditorConfig.editorconfig", "Properties", 0, 0, 0, 0, 21, 0, 1, 22
"c:\Users\chris\source\repos\Cell\Cell\obj\Debug\net8.0-windows\Cell_qvdusxfn_wpftmp.GlobalUsings.g.cs", "C#", 5, 0, 0, 0, 0, 1, 1, 7
"c:\Users\chris\source\repos\Cell\Cell\obj\Debug\net8.0-windows\Cell_qvdusxfn_wpftmp.sourcelink.json", "JSON", 0, 0, 0, 1, 0, 0, 0, 1
"c:\Users\chris\source\repos\Cell\Cell\obj\Debug\net8.0-windows\Cell_qvx041oi_wpftmp.AssemblyInfo.cs", "C#", 11, 0, 0, 0, 0, 10, 5, 26
"c:\Users\chris\source\repos\Cell\Cell\obj\Debug\net8.0-windows\Cell_qvx041oi_wpftmp.GeneratedMSBuildEditorConfig.editorconfig", "Properties", 0, 0, 0, 0, 21, 0, 1, 22
"c:\Users\chris\source\repos\Cell\Cell\obj\Debug\net8.0-windows\Cell_qvx041oi_wpftmp.GlobalUsings.g.cs", "C#", 5, 0, 0, 0, 0, 1, 1, 7
"c:\Users\chris\source\repos\Cell\Cell\obj\Debug\net8.0-windows\Cell_qvx041oi_wpftmp.sourcelink.json", "JSON", 0, 0, 0, 1, 0, 0, 0, 1
"c:\Users\chris\source\repos\Cell\Cell\obj\Debug\net8.0-windows\Cell_qwe2jwhp_wpftmp.AssemblyInfo.cs", "C#", 11, 0, 0, 0, 0, 10, 5, 26
"c:\Users\chris\source\repos\Cell\Cell\obj\Debug\net8.0-windows\Cell_qwe2jwhp_wpftmp.GeneratedMSBuildEditorConfig.editorconfig", "Properties", 0, 0, 0, 0, 21, 0, 1, 22
"c:\Users\chris\source\repos\Cell\Cell\obj\Debug\net8.0-windows\Cell_qwe2jwhp_wpftmp.GlobalUsings.g.cs", "C#", 5, 0, 0, 0, 0, 1, 1, 7
"c:\Users\chris\source\repos\Cell\Cell\obj\Debug\net8.0-windows\Cell_qwe2jwhp_wpftmp.sourcelink.json", "JSON", 0, 0, 0, 1, 0, 0, 0, 1
"c:\Users\chris\source\repos\Cell\Cell\obj\Debug\net8.0-windows\Cell_qwevw1rg_wpftmp.AssemblyInfo.cs", "C#", 11, 0, 0, 0, 0, 10, 5, 26
"c:\Users\chris\source\repos\Cell\Cell\obj\Debug\net8.0-windows\Cell_qwevw1rg_wpftmp.GeneratedMSBuildEditorConfig.editorconfig", "Properties", 0, 0, 0, 0, 13, 0, 1, 14
"c:\Users\chris\source\repos\Cell\Cell\obj\Debug\net8.0-windows\Cell_qwevw1rg_wpftmp.GlobalUsings.g.cs", "C#", 5, 0, 0, 0, 0, 1, 1, 7
"c:\Users\chris\source\repos\Cell\Cell\obj\Debug\net8.0-windows\Cell_qwus3mrr_wpftmp.AssemblyInfo.cs", "C#", 11, 0, 0, 0, 0, 10, 5, 26
"c:\Users\chris\source\repos\Cell\Cell\obj\Debug\net8.0-windows\Cell_qwus3mrr_wpftmp.GeneratedMSBuildEditorConfig.editorconfig", "Properties", 0, 0, 0, 0, 21, 0, 1, 22
"c:\Users\chris\source\repos\Cell\Cell\obj\Debug\net8.0-windows\Cell_qwus3mrr_wpftmp.GlobalUsings.g.cs", "C#", 5, 0, 0, 0, 0, 1, 1, 7
"c:\Users\chris\source\repos\Cell\Cell\obj\Debug\net8.0-windows\Cell_qwus3mrr_wpftmp.sourcelink.json", "JSON", 0, 0, 0, 1, 0, 0, 0, 1
"c:\Users\chris\source\repos\Cell\Cell\obj\Debug\net8.0-windows\Cell_qzefib4v_wpftmp.AssemblyInfo.cs", "C#", 11, 0, 0, 0, 0, 10, 5, 26
"c:\Users\chris\source\repos\Cell\Cell\obj\Debug\net8.0-windows\Cell_qzefib4v_wpftmp.GeneratedMSBuildEditorConfig.editorconfig", "Properties", 0, 0, 0, 0, 21, 0, 1, 22
"c:\Users\chris\source\repos\Cell\Cell\obj\Debug\net8.0-windows\Cell_qzefib4v_wpftmp.GlobalUsings.g.cs", "C#", 5, 0, 0, 0, 0, 1, 1, 7
"c:\Users\chris\source\repos\Cell\Cell\obj\Debug\net8.0-windows\Cell_qzefib4v_wpftmp.sourcelink.json", "JSON", 0, 0, 0, 1, 0, 0, 0, 1
"c:\Users\chris\source\repos\Cell\Cell\obj\Debug\net8.0-windows\Cell_qzu1b0zg_wpftmp.AssemblyInfo.cs", "C#", 11, 0, 0, 0, 0, 10, 5, 26
"c:\Users\chris\source\repos\Cell\Cell\obj\Debug\net8.0-windows\Cell_qzu1b0zg_wpftmp.GeneratedMSBuildEditorConfig.editorconfig", "Properties", 0, 0, 0, 0, 21, 0, 1, 22
"c:\Users\chris\source\repos\Cell\Cell\obj\Debug\net8.0-windows\Cell_qzu1b0zg_wpftmp.GlobalUsings.g.cs", "C#", 5, 0, 0, 0, 0, 1, 1, 7
"c:\Users\chris\source\repos\Cell\Cell\obj\Debug\net8.0-windows\Cell_qzu1b0zg_wpftmp.sourcelink.json", "JSON", 0, 0, 0, 1, 0, 0, 0, 1
"c:\Users\chris\source\repos\Cell\Cell\obj\Debug\net8.0-windows\Cell_r0adj4kd_wpftmp.AssemblyInfo.cs", "C#", 11, 0, 0, 0, 0, 10, 5, 26
"c:\Users\chris\source\repos\Cell\Cell\obj\Debug\net8.0-windows\Cell_r0adj4kd_wpftmp.GeneratedMSBuildEditorConfig.editorconfig", "Properties", 0, 0, 0, 0, 13, 0, 1, 14
"c:\Users\chris\source\repos\Cell\Cell\obj\Debug\net8.0-windows\Cell_r0adj4kd_wpftmp.GlobalUsings.g.cs", "C#", 5, 0, 0, 0, 0, 1, 1, 7
"c:\Users\chris\source\repos\Cell\Cell\obj\Debug\net8.0-windows\Cell_r15ztaou_wpftmp.AssemblyInfo.cs", "C#", 11, 0, 0, 0, 0, 10, 5, 26
"c:\Users\chris\source\repos\Cell\Cell\obj\Debug\net8.0-windows\Cell_r15ztaou_wpftmp.GeneratedMSBuildEditorConfig.editorconfig", "Properties", 0, 0, 0, 0, 21, 0, 1, 22
"c:\Users\chris\source\repos\Cell\Cell\obj\Debug\net8.0-windows\Cell_r15ztaou_wpftmp.GlobalUsings.g.cs", "C#", 5, 0, 0, 0, 0, 1, 1, 7
"c:\Users\chris\source\repos\Cell\Cell\obj\Debug\net8.0-windows\Cell_r15ztaou_wpftmp.sourcelink.json", "JSON", 0, 0, 0, 1, 0, 0, 0, 1
"c:\Users\chris\source\repos\Cell\Cell\obj\Debug\net8.0-windows\Cell_r1rsyl1q_wpftmp.AssemblyInfo.cs", "C#", 11, 0, 0, 0, 0, 10, 5, 26
"c:\Users\chris\source\repos\Cell\Cell\obj\Debug\net8.0-windows\Cell_r1rsyl1q_wpftmp.GeneratedMSBuildEditorConfig.editorconfig", "Properties", 0, 0, 0, 0, 21, 0, 1, 22
"c:\Users\chris\source\repos\Cell\Cell\obj\Debug\net8.0-windows\Cell_r1rsyl1q_wpftmp.GlobalUsings.g.cs", "C#", 5, 0, 0, 0, 0, 1, 1, 7
"c:\Users\chris\source\repos\Cell\Cell\obj\Debug\net8.0-windows\Cell_r1rsyl1q_wpftmp.sourcelink.json", "JSON", 0, 0, 0, 1, 0, 0, 0, 1
"c:\Users\chris\source\repos\Cell\Cell\obj\Debug\net8.0-windows\Cell_r3encvvq_wpftmp.AssemblyInfo.cs", "C#", 11, 0, 0, 0, 0, 10, 5, 26
"c:\Users\chris\source\repos\Cell\Cell\obj\Debug\net8.0-windows\Cell_r3encvvq_wpftmp.GeneratedMSBuildEditorConfig.editorconfig", "Properties", 0, 0, 0, 0, 21, 0, 1, 22
"c:\Users\chris\source\repos\Cell\Cell\obj\Debug\net8.0-windows\Cell_r3encvvq_wpftmp.GlobalUsings.g.cs", "C#", 5, 0, 0, 0, 0, 1, 1, 7
"c:\Users\chris\source\repos\Cell\Cell\obj\Debug\net8.0-windows\Cell_r3encvvq_wpftmp.sourcelink.json", "JSON", 0, 0, 0, 1, 0, 0, 0, 1
"c:\Users\chris\source\repos\Cell\Cell\obj\Debug\net8.0-windows\Cell_r3suchxk_wpftmp.AssemblyInfo.cs", "C#", 11, 0, 0, 0, 0, 10, 5, 26
"c:\Users\chris\source\repos\Cell\Cell\obj\Debug\net8.0-windows\Cell_r3suchxk_wpftmp.GeneratedMSBuildEditorConfig.editorconfig", "Properties", 0, 0, 0, 0, 21, 0, 1, 22
"c:\Users\chris\source\repos\Cell\Cell\obj\Debug\net8.0-windows\Cell_r3suchxk_wpftmp.GlobalUsings.g.cs", "C#", 5, 0, 0, 0, 0, 1, 1, 7
"c:\Users\chris\source\repos\Cell\Cell\obj\Debug\net8.0-windows\Cell_r3suchxk_wpftmp.sourcelink.json", "JSON", 0, 0, 0, 1, 0, 0, 0, 1
"c:\Users\chris\source\repos\Cell\Cell\obj\Debug\net8.0-windows\Cell_r4ihvyps_wpftmp.AssemblyInfo.cs", "C#", 11, 0, 0, 0, 0, 10, 5, 26
"c:\Users\chris\source\repos\Cell\Cell\obj\Debug\net8.0-windows\Cell_r4ihvyps_wpftmp.GeneratedMSBuildEditorConfig.editorconfig", "Properties", 0, 0, 0, 0, 21, 0, 1, 22
"c:\Users\chris\source\repos\Cell\Cell\obj\Debug\net8.0-windows\Cell_r4ihvyps_wpftmp.GlobalUsings.g.cs", "C#", 5, 0, 0, 0, 0, 1, 1, 7
"c:\Users\chris\source\repos\Cell\Cell\obj\Debug\net8.0-windows\Cell_r4ihvyps_wpftmp.sourcelink.json", "JSON", 0, 0, 0, 1, 0, 0, 0, 1
"c:\Users\chris\source\repos\Cell\Cell\obj\Debug\net8.0-windows\Cell_r53443vc_wpftmp.AssemblyInfo.cs", "C#", 11, 0, 0, 0, 0, 10, 5, 26
"c:\Users\chris\source\repos\Cell\Cell\obj\Debug\net8.0-windows\Cell_r53443vc_wpftmp.GeneratedMSBuildEditorConfig.editorconfig", "Properties", 0, 0, 0, 0, 21, 0, 1, 22
"c:\Users\chris\source\repos\Cell\Cell\obj\Debug\net8.0-windows\Cell_r53443vc_wpftmp.GlobalUsings.g.cs", "C#", 5, 0, 0, 0, 0, 1, 1, 7
"c:\Users\chris\source\repos\Cell\Cell\obj\Debug\net8.0-windows\Cell_r53443vc_wpftmp.sourcelink.json", "JSON", 0, 0, 0, 1, 0, 0, 0, 1
"c:\Users\chris\source\repos\Cell\Cell\obj\Debug\net8.0-windows\Cell_r5slrs4f_wpftmp.AssemblyInfo.cs", "C#", 11, 0, 0, 0, 0, 10, 5, 26
"c:\Users\chris\source\repos\Cell\Cell\obj\Debug\net8.0-windows\Cell_r5slrs4f_wpftmp.GeneratedMSBuildEditorConfig.editorconfig", "Properties", 0, 0, 0, 0, 21, 0, 1, 22
"c:\Users\chris\source\repos\Cell\Cell\obj\Debug\net8.0-windows\Cell_r5slrs4f_wpftmp.GlobalUsings.g.cs", "C#", 5, 0, 0, 0, 0, 1, 1, 7
"c:\Users\chris\source\repos\Cell\Cell\obj\Debug\net8.0-windows\Cell_r5slrs4f_wpftmp.sourcelink.json", "JSON", 0, 0, 0, 1, 0, 0, 0, 1
"c:\Users\chris\source\repos\Cell\Cell\obj\Debug\net8.0-windows\Cell_r5zxr3lt_wpftmp.AssemblyInfo.cs", "C#", 11, 0, 0, 0, 0, 10, 5, 26
"c:\Users\chris\source\repos\Cell\Cell\obj\Debug\net8.0-windows\Cell_r5zxr3lt_wpftmp.GeneratedMSBuildEditorConfig.editorconfig", "Properties", 0, 0, 0, 0, 21, 0, 1, 22
"c:\Users\chris\source\repos\Cell\Cell\obj\Debug\net8.0-windows\Cell_r5zxr3lt_wpftmp.GlobalUsings.g.cs", "C#", 5, 0, 0, 0, 0, 1, 1, 7
"c:\Users\chris\source\repos\Cell\Cell\obj\Debug\net8.0-windows\Cell_r5zxr3lt_wpftmp.sourcelink.json", "JSON", 0, 0, 0, 1, 0, 0, 0, 1
"c:\Users\chris\source\repos\Cell\Cell\obj\Debug\net8.0-windows\Cell_ra5ml3fh_wpftmp.AssemblyInfo.cs", "C#", 11, 0, 0, 0, 0, 10, 5, 26
"c:\Users\chris\source\repos\Cell\Cell\obj\Debug\net8.0-windows\Cell_ra5ml3fh_wpftmp.GeneratedMSBuildEditorConfig.editorconfig", "Properties", 0, 0, 0, 0, 21, 0, 1, 22
"c:\Users\chris\source\repos\Cell\Cell\obj\Debug\net8.0-windows\Cell_ra5ml3fh_wpftmp.GlobalUsings.g.cs", "C#", 5, 0, 0, 0, 0, 1, 1, 7
"c:\Users\chris\source\repos\Cell\Cell\obj\Debug\net8.0-windows\Cell_ra5ml3fh_wpftmp.sourcelink.json", "JSON", 0, 0, 0, 1, 0, 0, 0, 1
"c:\Users\chris\source\repos\Cell\Cell\obj\Debug\net8.0-windows\Cell_rap43fct_wpftmp.AssemblyInfo.cs", "C#", 11, 0, 0, 0, 0, 10, 5, 26
"c:\Users\chris\source\repos\Cell\Cell\obj\Debug\net8.0-windows\Cell_rap43fct_wpftmp.GeneratedMSBuildEditorConfig.editorconfig", "Properties", 0, 0, 0, 0, 21, 0, 1, 22
"c:\Users\chris\source\repos\Cell\Cell\obj\Debug\net8.0-windows\Cell_rap43fct_wpftmp.GlobalUsings.g.cs", "C#", 5, 0, 0, 0, 0, 1, 1, 7
"c:\Users\chris\source\repos\Cell\Cell\obj\Debug\net8.0-windows\Cell_rap43fct_wpftmp.sourcelink.json", "JSON", 0, 0, 0, 1, 0, 0, 0, 1
"c:\Users\chris\source\repos\Cell\Cell\obj\Debug\net8.0-windows\Cell_rax3uvdc_wpftmp.AssemblyInfo.cs", "C#", 11, 0, 0, 0, 0, 10, 5, 26
"c:\Users\chris\source\repos\Cell\Cell\obj\Debug\net8.0-windows\Cell_rax3uvdc_wpftmp.GeneratedMSBuildEditorConfig.editorconfig", "Properties", 0, 0, 0, 0, 21, 0, 1, 22
"c:\Users\chris\source\repos\Cell\Cell\obj\Debug\net8.0-windows\Cell_rax3uvdc_wpftmp.GlobalUsings.g.cs", "C#", 5, 0, 0, 0, 0, 1, 1, 7
"c:\Users\chris\source\repos\Cell\Cell\obj\Debug\net8.0-windows\Cell_rax3uvdc_wpftmp.sourcelink.json", "JSON", 0, 0, 0, 1, 0, 0, 0, 1
"c:\Users\chris\source\repos\Cell\Cell\obj\Debug\net8.0-windows\Cell_rb0ixhk1_wpftmp.AssemblyInfo.cs", "C#", 11, 0, 0, 0, 0, 10, 5, 26
"c:\Users\chris\source\repos\Cell\Cell\obj\Debug\net8.0-windows\Cell_rb0ixhk1_wpftmp.GeneratedMSBuildEditorConfig.editorconfig", "Properties", 0, 0, 0, 0, 21, 0, 1, 22
"c:\Users\chris\source\repos\Cell\Cell\obj\Debug\net8.0-windows\Cell_rb0ixhk1_wpftmp.GlobalUsings.g.cs", "C#", 5, 0, 0, 0, 0, 1, 1, 7
"c:\Users\chris\source\repos\Cell\Cell\obj\Debug\net8.0-windows\Cell_rb0ixhk1_wpftmp.sourcelink.json", "JSON", 0, 0, 0, 1, 0, 0, 0, 1
"c:\Users\chris\source\repos\Cell\Cell\obj\Debug\net8.0-windows\Cell_rb2i0dit_wpftmp.AssemblyInfo.cs", "C#", 11, 0, 0, 0, 0, 10, 5, 26
"c:\Users\chris\source\repos\Cell\Cell\obj\Debug\net8.0-windows\Cell_rb2i0dit_wpftmp.GeneratedMSBuildEditorConfig.editorconfig", "Properties", 0, 0, 0, 0, 21, 0, 1, 22
"c:\Users\chris\source\repos\Cell\Cell\obj\Debug\net8.0-windows\Cell_rb2i0dit_wpftmp.GlobalUsings.g.cs", "C#", 5, 0, 0, 0, 0, 1, 1, 7
"c:\Users\chris\source\repos\Cell\Cell\obj\Debug\net8.0-windows\Cell_rb2i0dit_wpftmp.sourcelink.json", "JSON", 0, 0, 0, 1, 0, 0, 0, 1
"c:\Users\chris\source\repos\Cell\Cell\obj\Debug\net8.0-windows\Cell_rcfya5zd_wpftmp.AssemblyInfo.cs", "C#", 11, 0, 0, 0, 0, 10, 5, 26
"c:\Users\chris\source\repos\Cell\Cell\obj\Debug\net8.0-windows\Cell_rcfya5zd_wpftmp.GeneratedMSBuildEditorConfig.editorconfig", "Properties", 0, 0, 0, 0, 13, 0, 1, 14
"c:\Users\chris\source\repos\Cell\Cell\obj\Debug\net8.0-windows\Cell_rcfya5zd_wpftmp.GlobalUsings.g.cs", "C#", 5, 0, 0, 0, 0, 1, 1, 7
"c:\Users\chris\source\repos\Cell\Cell\obj\Debug\net8.0-windows\Cell_rd0x23x2_wpftmp.AssemblyInfo.cs", "C#", 11, 0, 0, 0, 0, 10, 5, 26
"c:\Users\chris\source\repos\Cell\Cell\obj\Debug\net8.0-windows\Cell_rd0x23x2_wpftmp.GeneratedMSBuildEditorConfig.editorconfig", "Properties", 0, 0, 0, 0, 21, 0, 1, 22
"c:\Users\chris\source\repos\Cell\Cell\obj\Debug\net8.0-windows\Cell_rd0x23x2_wpftmp.GlobalUsings.g.cs", "C#", 5, 0, 0, 0, 0, 1, 1, 7
"c:\Users\chris\source\repos\Cell\Cell\obj\Debug\net8.0-windows\Cell_rd0x23x2_wpftmp.sourcelink.json", "JSON", 0, 0, 0, 1, 0, 0, 0, 1
"c:\Users\chris\source\repos\Cell\Cell\obj\Debug\net8.0-windows\Cell_rdnu2wua_wpftmp.AssemblyInfo.cs", "C#", 11, 0, 0, 0, 0, 10, 5, 26
"c:\Users\chris\source\repos\Cell\Cell\obj\Debug\net8.0-windows\Cell_rdnu2wua_wpftmp.GeneratedMSBuildEditorConfig.editorconfig", "Properties", 0, 0, 0, 0, 21, 0, 1, 22
"c:\Users\chris\source\repos\Cell\Cell\obj\Debug\net8.0-windows\Cell_rdnu2wua_wpftmp.GlobalUsings.g.cs", "C#", 5, 0, 0, 0, 0, 1, 1, 7
"c:\Users\chris\source\repos\Cell\Cell\obj\Debug\net8.0-windows\Cell_rdnu2wua_wpftmp.sourcelink.json", "JSON", 0, 0, 0, 1, 0, 0, 0, 1
"c:\Users\chris\source\repos\Cell\Cell\obj\Debug\net8.0-windows\Cell_recixlid_wpftmp.AssemblyInfo.cs", "C#", 11, 0, 0, 0, 0, 10, 5, 26
"c:\Users\chris\source\repos\Cell\Cell\obj\Debug\net8.0-windows\Cell_recixlid_wpftmp.GeneratedMSBuildEditorConfig.editorconfig", "Properties", 0, 0, 0, 0, 21, 0, 1, 22
"c:\Users\chris\source\repos\Cell\Cell\obj\Debug\net8.0-windows\Cell_recixlid_wpftmp.GlobalUsings.g.cs", "C#", 5, 0, 0, 0, 0, 1, 1, 7
"c:\Users\chris\source\repos\Cell\Cell\obj\Debug\net8.0-windows\Cell_recixlid_wpftmp.sourcelink.json", "JSON", 0, 0, 0, 1, 0, 0, 0, 1
"c:\Users\chris\source\repos\Cell\Cell\obj\Debug\net8.0-windows\Cell_rezmr5cw_wpftmp.AssemblyInfo.cs", "C#", 11, 0, 0, 0, 0, 10, 5, 26
"c:\Users\chris\source\repos\Cell\Cell\obj\Debug\net8.0-windows\Cell_rezmr5cw_wpftmp.GeneratedMSBuildEditorConfig.editorconfig", "Properties", 0, 0, 0, 0, 21, 0, 1, 22
"c:\Users\chris\source\repos\Cell\Cell\obj\Debug\net8.0-windows\Cell_rezmr5cw_wpftmp.GlobalUsings.g.cs", "C#", 5, 0, 0, 0, 0, 1, 1, 7
"c:\Users\chris\source\repos\Cell\Cell\obj\Debug\net8.0-windows\Cell_rezmr5cw_wpftmp.sourcelink.json", "JSON", 0, 0, 0, 1, 0, 0, 0, 1
"c:\Users\chris\source\repos\Cell\Cell\obj\Debug\net8.0-windows\Cell_rfbq13hk_wpftmp.AssemblyInfo.cs", "C#", 11, 0, 0, 0, 0, 10, 5, 26
"c:\Users\chris\source\repos\Cell\Cell\obj\Debug\net8.0-windows\Cell_rfbq13hk_wpftmp.GeneratedMSBuildEditorConfig.editorconfig", "Properties", 0, 0, 0, 0, 21, 0, 1, 22
"c:\Users\chris\source\repos\Cell\Cell\obj\Debug\net8.0-windows\Cell_rfbq13hk_wpftmp.GlobalUsings.g.cs", "C#", 5, 0, 0, 0, 0, 1, 1, 7
"c:\Users\chris\source\repos\Cell\Cell\obj\Debug\net8.0-windows\Cell_rfbq13hk_wpftmp.sourcelink.json", "JSON", 0, 0, 0, 1, 0, 0, 0, 1
"c:\Users\chris\source\repos\Cell\Cell\obj\Debug\net8.0-windows\Cell_rfnrw11e_wpftmp.AssemblyInfo.cs", "C#", 11, 0, 0, 0, 0, 10, 5, 26
"c:\Users\chris\source\repos\Cell\Cell\obj\Debug\net8.0-windows\Cell_rfnrw11e_wpftmp.GeneratedMSBuildEditorConfig.editorconfig", "Properties", 0, 0, 0, 0, 21, 0, 1, 22
"c:\Users\chris\source\repos\Cell\Cell\obj\Debug\net8.0-windows\Cell_rfnrw11e_wpftmp.GlobalUsings.g.cs", "C#", 5, 0, 0, 0, 0, 1, 1, 7
"c:\Users\chris\source\repos\Cell\Cell\obj\Debug\net8.0-windows\Cell_rfnrw11e_wpftmp.sourcelink.json", "JSON", 0, 0, 0, 1, 0, 0, 0, 1
"c:\Users\chris\source\repos\Cell\Cell\obj\Debug\net8.0-windows\Cell_rh5tmp1r_wpftmp.AssemblyInfo.cs", "C#", 11, 0, 0, 0, 0, 10, 5, 26
"c:\Users\chris\source\repos\Cell\Cell\obj\Debug\net8.0-windows\Cell_rh5tmp1r_wpftmp.GeneratedMSBuildEditorConfig.editorconfig", "Properties", 0, 0, 0, 0, 13, 0, 1, 14
"c:\Users\chris\source\repos\Cell\Cell\obj\Debug\net8.0-windows\Cell_rh5tmp1r_wpftmp.GlobalUsings.g.cs", "C#", 5, 0, 0, 0, 0, 1, 1, 7
"c:\Users\chris\source\repos\Cell\Cell\obj\Debug\net8.0-windows\Cell_rhmikf3n_wpftmp.AssemblyInfo.cs", "C#", 11, 0, 0, 0, 0, 10, 5, 26
"c:\Users\chris\source\repos\Cell\Cell\obj\Debug\net8.0-windows\Cell_rhmikf3n_wpftmp.GeneratedMSBuildEditorConfig.editorconfig", "Properties", 0, 0, 0, 0, 21, 0, 1, 22
"c:\Users\chris\source\repos\Cell\Cell\obj\Debug\net8.0-windows\Cell_rhmikf3n_wpftmp.GlobalUsings.g.cs", "C#", 5, 0, 0, 0, 0, 1, 1, 7
"c:\Users\chris\source\repos\Cell\Cell\obj\Debug\net8.0-windows\Cell_rhmikf3n_wpftmp.sourcelink.json", "JSON", 0, 0, 0, 1, 0, 0, 0, 1
"c:\Users\chris\source\repos\Cell\Cell\obj\Debug\net8.0-windows\Cell_rlhuag5t_wpftmp.AssemblyInfo.cs", "C#", 11, 0, 0, 0, 0, 10, 5, 26
"c:\Users\chris\source\repos\Cell\Cell\obj\Debug\net8.0-windows\Cell_rlhuag5t_wpftmp.GeneratedMSBuildEditorConfig.editorconfig", "Properties", 0, 0, 0, 0, 13, 0, 1, 14
"c:\Users\chris\source\repos\Cell\Cell\obj\Debug\net8.0-windows\Cell_rlhuag5t_wpftmp.GlobalUsings.g.cs", "C#", 5, 0, 0, 0, 0, 1, 1, 7
"c:\Users\chris\source\repos\Cell\Cell\obj\Debug\net8.0-windows\Cell_rmasjeoa_wpftmp.AssemblyInfo.cs", "C#", 11, 0, 0, 0, 0, 10, 5, 26
"c:\Users\chris\source\repos\Cell\Cell\obj\Debug\net8.0-windows\Cell_rmasjeoa_wpftmp.GeneratedMSBuildEditorConfig.editorconfig", "Properties", 0, 0, 0, 0, 21, 0, 1, 22
"c:\Users\chris\source\repos\Cell\Cell\obj\Debug\net8.0-windows\Cell_rmasjeoa_wpftmp.GlobalUsings.g.cs", "C#", 5, 0, 0, 0, 0, 1, 1, 7
"c:\Users\chris\source\repos\Cell\Cell\obj\Debug\net8.0-windows\Cell_rmasjeoa_wpftmp.sourcelink.json", "JSON", 0, 0, 0, 1, 0, 0, 0, 1
"c:\Users\chris\source\repos\Cell\Cell\obj\Debug\net8.0-windows\Cell_rnefznbl_wpftmp.AssemblyInfo.cs", "C#", 11, 0, 0, 0, 0, 10, 5, 26
"c:\Users\chris\source\repos\Cell\Cell\obj\Debug\net8.0-windows\Cell_rnefznbl_wpftmp.GeneratedMSBuildEditorConfig.editorconfig", "Properties", 0, 0, 0, 0, 21, 0, 1, 22
"c:\Users\chris\source\repos\Cell\Cell\obj\Debug\net8.0-windows\Cell_rnefznbl_wpftmp.GlobalUsings.g.cs", "C#", 5, 0, 0, 0, 0, 1, 1, 7
"c:\Users\chris\source\repos\Cell\Cell\obj\Debug\net8.0-windows\Cell_rnefznbl_wpftmp.sourcelink.json", "JSON", 0, 0, 0, 1, 0, 0, 0, 1
"c:\Users\chris\source\repos\Cell\Cell\obj\Debug\net8.0-windows\Cell_rntrbmmn_wpftmp.AssemblyInfo.cs", "C#", 11, 0, 0, 0, 0, 10, 5, 26
"c:\Users\chris\source\repos\Cell\Cell\obj\Debug\net8.0-windows\Cell_rntrbmmn_wpftmp.GeneratedMSBuildEditorConfig.editorconfig", "Properties", 0, 0, 0, 0, 21, 0, 1, 22
"c:\Users\chris\source\repos\Cell\Cell\obj\Debug\net8.0-windows\Cell_rntrbmmn_wpftmp.GlobalUsings.g.cs", "C#", 5, 0, 0, 0, 0, 1, 1, 7
"c:\Users\chris\source\repos\Cell\Cell\obj\Debug\net8.0-windows\Cell_rntrbmmn_wpftmp.sourcelink.json", "JSON", 0, 0, 0, 1, 0, 0, 0, 1
"c:\Users\chris\source\repos\Cell\Cell\obj\Debug\net8.0-windows\Cell_ro4dnjkv_wpftmp.AssemblyInfo.cs", "C#", 11, 0, 0, 0, 0, 10, 5, 26
"c:\Users\chris\source\repos\Cell\Cell\obj\Debug\net8.0-windows\Cell_ro4dnjkv_wpftmp.GeneratedMSBuildEditorConfig.editorconfig", "Properties", 0, 0, 0, 0, 21, 0, 1, 22
"c:\Users\chris\source\repos\Cell\Cell\obj\Debug\net8.0-windows\Cell_ro4dnjkv_wpftmp.GlobalUsings.g.cs", "C#", 5, 0, 0, 0, 0, 1, 1, 7
"c:\Users\chris\source\repos\Cell\Cell\obj\Debug\net8.0-windows\Cell_ro4dnjkv_wpftmp.sourcelink.json", "JSON", 0, 0, 0, 1, 0, 0, 0, 1
"c:\Users\chris\source\repos\Cell\Cell\obj\Debug\net8.0-windows\Cell_rohpe3br_wpftmp.AssemblyInfo.cs", "C#", 11, 0, 0, 0, 0, 10, 5, 26
"c:\Users\chris\source\repos\Cell\Cell\obj\Debug\net8.0-windows\Cell_rohpe3br_wpftmp.GeneratedMSBuildEditorConfig.editorconfig", "Properties", 0, 0, 0, 0, 21, 0, 1, 22
"c:\Users\chris\source\repos\Cell\Cell\obj\Debug\net8.0-windows\Cell_rohpe3br_wpftmp.GlobalUsings.g.cs", "C#", 5, 0, 0, 0, 0, 1, 1, 7
"c:\Users\chris\source\repos\Cell\Cell\obj\Debug\net8.0-windows\Cell_rohpe3br_wpftmp.sourcelink.json", "JSON", 0, 0, 0, 1, 0, 0, 0, 1
"c:\Users\chris\source\repos\Cell\Cell\obj\Debug\net8.0-windows\Cell_rohxwhib_wpftmp.AssemblyInfo.cs", "C#", 11, 0, 0, 0, 0, 10, 5, 26
"c:\Users\chris\source\repos\Cell\Cell\obj\Debug\net8.0-windows\Cell_rohxwhib_wpftmp.GeneratedMSBuildEditorConfig.editorconfig", "Properties", 0, 0, 0, 0, 21, 0, 1, 22
"c:\Users\chris\source\repos\Cell\Cell\obj\Debug\net8.0-windows\Cell_rohxwhib_wpftmp.GlobalUsings.g.cs", "C#", 5, 0, 0, 0, 0, 1, 1, 7
"c:\Users\chris\source\repos\Cell\Cell\obj\Debug\net8.0-windows\Cell_rohxwhib_wpftmp.sourcelink.json", "JSON", 0, 0, 0, 1, 0, 0, 0, 1
"c:\Users\chris\source\repos\Cell\Cell\obj\Debug\net8.0-windows\Cell_rreh3d2j_wpftmp.AssemblyInfo.cs", "C#", 11, 0, 0, 0, 0, 10, 5, 26
"c:\Users\chris\source\repos\Cell\Cell\obj\Debug\net8.0-windows\Cell_rreh3d2j_wpftmp.GeneratedMSBuildEditorConfig.editorconfig", "Properties", 0, 0, 0, 0, 21, 0, 1, 22
"c:\Users\chris\source\repos\Cell\Cell\obj\Debug\net8.0-windows\Cell_rreh3d2j_wpftmp.GlobalUsings.g.cs", "C#", 5, 0, 0, 0, 0, 1, 1, 7
"c:\Users\chris\source\repos\Cell\Cell\obj\Debug\net8.0-windows\Cell_rreh3d2j_wpftmp.sourcelink.json", "JSON", 0, 0, 0, 1, 0, 0, 0, 1
"c:\Users\chris\source\repos\Cell\Cell\obj\Debug\net8.0-windows\Cell_rrhqn1pl_wpftmp.AssemblyInfo.cs", "C#", 11, 0, 0, 0, 0, 10, 5, 26
"c:\Users\chris\source\repos\Cell\Cell\obj\Debug\net8.0-windows\Cell_rrhqn1pl_wpftmp.GeneratedMSBuildEditorConfig.editorconfig", "Properties", 0, 0, 0, 0, 21, 0, 1, 22
"c:\Users\chris\source\repos\Cell\Cell\obj\Debug\net8.0-windows\Cell_rrhqn1pl_wpftmp.GlobalUsings.g.cs", "C#", 5, 0, 0, 0, 0, 1, 1, 7
"c:\Users\chris\source\repos\Cell\Cell\obj\Debug\net8.0-windows\Cell_rrhqn1pl_wpftmp.sourcelink.json", "JSON", 0, 0, 0, 1, 0, 0, 0, 1
"c:\Users\chris\source\repos\Cell\Cell\obj\Debug\net8.0-windows\Cell_rsvuzkmx_wpftmp.AssemblyInfo.cs", "C#", 11, 0, 0, 0, 0, 10, 5, 26
"c:\Users\chris\source\repos\Cell\Cell\obj\Debug\net8.0-windows\Cell_rsvuzkmx_wpftmp.GeneratedMSBuildEditorConfig.editorconfig", "Properties", 0, 0, 0, 0, 21, 0, 1, 22
"c:\Users\chris\source\repos\Cell\Cell\obj\Debug\net8.0-windows\Cell_rsvuzkmx_wpftmp.GlobalUsings.g.cs", "C#", 5, 0, 0, 0, 0, 1, 1, 7
"c:\Users\chris\source\repos\Cell\Cell\obj\Debug\net8.0-windows\Cell_rsvuzkmx_wpftmp.sourcelink.json", "JSON", 0, 0, 0, 1, 0, 0, 0, 1
"c:\Users\chris\source\repos\Cell\Cell\obj\Debug\net8.0-windows\Cell_rszjuiap_wpftmp.AssemblyInfo.cs", "C#", 11, 0, 0, 0, 0, 10, 5, 26
"c:\Users\chris\source\repos\Cell\Cell\obj\Debug\net8.0-windows\Cell_rszjuiap_wpftmp.GeneratedMSBuildEditorConfig.editorconfig", "Properties", 0, 0, 0, 0, 21, 0, 1, 22
"c:\Users\chris\source\repos\Cell\Cell\obj\Debug\net8.0-windows\Cell_rszjuiap_wpftmp.GlobalUsings.g.cs", "C#", 5, 0, 0, 0, 0, 1, 1, 7
"c:\Users\chris\source\repos\Cell\Cell\obj\Debug\net8.0-windows\Cell_rszjuiap_wpftmp.sourcelink.json", "JSON", 0, 0, 0, 1, 0, 0, 0, 1
"c:\Users\chris\source\repos\Cell\Cell\obj\Debug\net8.0-windows\Cell_rtkc0wfj_wpftmp.AssemblyInfo.cs", "C#", 11, 0, 0, 0, 0, 10, 5, 26
"c:\Users\chris\source\repos\Cell\Cell\obj\Debug\net8.0-windows\Cell_rtkc0wfj_wpftmp.GeneratedMSBuildEditorConfig.editorconfig", "Properties", 0, 0, 0, 0, 21, 0, 1, 22
"c:\Users\chris\source\repos\Cell\Cell\obj\Debug\net8.0-windows\Cell_rtkc0wfj_wpftmp.GlobalUsings.g.cs", "C#", 5, 0, 0, 0, 0, 1, 1, 7
"c:\Users\chris\source\repos\Cell\Cell\obj\Debug\net8.0-windows\Cell_rtkc0wfj_wpftmp.sourcelink.json", "JSON", 0, 0, 0, 1, 0, 0, 0, 1
"c:\Users\chris\source\repos\Cell\Cell\obj\Debug\net8.0-windows\Cell_rudjdc42_wpftmp.AssemblyInfo.cs", "C#", 11, 0, 0, 0, 0, 10, 5, 26
"c:\Users\chris\source\repos\Cell\Cell\obj\Debug\net8.0-windows\Cell_rudjdc42_wpftmp.GeneratedMSBuildEditorConfig.editorconfig", "Properties", 0, 0, 0, 0, 21, 0, 1, 22
"c:\Users\chris\source\repos\Cell\Cell\obj\Debug\net8.0-windows\Cell_rudjdc42_wpftmp.GlobalUsings.g.cs", "C#", 5, 0, 0, 0, 0, 1, 1, 7
"c:\Users\chris\source\repos\Cell\Cell\obj\Debug\net8.0-windows\Cell_rudjdc42_wpftmp.sourcelink.json", "JSON", 0, 0, 0, 1, 0, 0, 0, 1
"c:\Users\chris\source\repos\Cell\Cell\obj\Debug\net8.0-windows\Cell_rvevd33v_wpftmp.AssemblyInfo.cs", "C#", 11, 0, 0, 0, 0, 10, 5, 26
"c:\Users\chris\source\repos\Cell\Cell\obj\Debug\net8.0-windows\Cell_rvevd33v_wpftmp.GeneratedMSBuildEditorConfig.editorconfig", "Properties", 0, 0, 0, 0, 21, 0, 1, 22
"c:\Users\chris\source\repos\Cell\Cell\obj\Debug\net8.0-windows\Cell_rvevd33v_wpftmp.GlobalUsings.g.cs", "C#", 5, 0, 0, 0, 0, 1, 1, 7
"c:\Users\chris\source\repos\Cell\Cell\obj\Debug\net8.0-windows\Cell_rvevd33v_wpftmp.sourcelink.json", "JSON", 0, 0, 0, 1, 0, 0, 0, 1
"c:\Users\chris\source\repos\Cell\Cell\obj\Debug\net8.0-windows\Cell_rwiavndl_wpftmp.AssemblyInfo.cs", "C#", 11, 0, 0, 0, 0, 10, 5, 26
"c:\Users\chris\source\repos\Cell\Cell\obj\Debug\net8.0-windows\Cell_rwiavndl_wpftmp.GeneratedMSBuildEditorConfig.editorconfig", "Properties", 0, 0, 0, 0, 21, 0, 1, 22
"c:\Users\chris\source\repos\Cell\Cell\obj\Debug\net8.0-windows\Cell_rwiavndl_wpftmp.GlobalUsings.g.cs", "C#", 5, 0, 0, 0, 0, 1, 1, 7
"c:\Users\chris\source\repos\Cell\Cell\obj\Debug\net8.0-windows\Cell_rwiavndl_wpftmp.sourcelink.json", "JSON", 0, 0, 0, 1, 0, 0, 0, 1
"c:\Users\chris\source\repos\Cell\Cell\obj\Debug\net8.0-windows\Cell_rx0lhzkz_wpftmp.AssemblyInfo.cs", "C#", 11, 0, 0, 0, 0, 10, 5, 26
"c:\Users\chris\source\repos\Cell\Cell\obj\Debug\net8.0-windows\Cell_rx0lhzkz_wpftmp.GeneratedMSBuildEditorConfig.editorconfig", "Properties", 0, 0, 0, 0, 21, 0, 1, 22
"c:\Users\chris\source\repos\Cell\Cell\obj\Debug\net8.0-windows\Cell_rx0lhzkz_wpftmp.GlobalUsings.g.cs", "C#", 5, 0, 0, 0, 0, 1, 1, 7
"c:\Users\chris\source\repos\Cell\Cell\obj\Debug\net8.0-windows\Cell_rx0lhzkz_wpftmp.sourcelink.json", "JSON", 0, 0, 0, 1, 0, 0, 0, 1
"c:\Users\chris\source\repos\Cell\Cell\obj\Debug\net8.0-windows\Cell_rx5r1iiu_wpftmp.AssemblyInfo.cs", "C#", 11, 0, 0, 0, 0, 10, 5, 26
"c:\Users\chris\source\repos\Cell\Cell\obj\Debug\net8.0-windows\Cell_rx5r1iiu_wpftmp.GeneratedMSBuildEditorConfig.editorconfig", "Properties", 0, 0, 0, 0, 13, 0, 1, 14
"c:\Users\chris\source\repos\Cell\Cell\obj\Debug\net8.0-windows\Cell_rx5r1iiu_wpftmp.GlobalUsings.g.cs", "C#", 5, 0, 0, 0, 0, 1, 1, 7
"c:\Users\chris\source\repos\Cell\Cell\obj\Debug\net8.0-windows\Cell_rynq2xtt_wpftmp.AssemblyInfo.cs", "C#", 11, 0, 0, 0, 0, 10, 5, 26
"c:\Users\chris\source\repos\Cell\Cell\obj\Debug\net8.0-windows\Cell_rynq2xtt_wpftmp.GeneratedMSBuildEditorConfig.editorconfig", "Properties", 0, 0, 0, 0, 21, 0, 1, 22
"c:\Users\chris\source\repos\Cell\Cell\obj\Debug\net8.0-windows\Cell_rynq2xtt_wpftmp.GlobalUsings.g.cs", "C#", 5, 0, 0, 0, 0, 1, 1, 7
"c:\Users\chris\source\repos\Cell\Cell\obj\Debug\net8.0-windows\Cell_rynq2xtt_wpftmp.sourcelink.json", "JSON", 0, 0, 0, 1, 0, 0, 0, 1
"c:\Users\chris\source\repos\Cell\Cell\obj\Debug\net8.0-windows\Cell_s0jtpbty_wpftmp.AssemblyInfo.cs", "C#", 11, 0, 0, 0, 0, 10, 5, 26
"c:\Users\chris\source\repos\Cell\Cell\obj\Debug\net8.0-windows\Cell_s0jtpbty_wpftmp.GeneratedMSBuildEditorConfig.editorconfig", "Properties", 0, 0, 0, 0, 21, 0, 1, 22
"c:\Users\chris\source\repos\Cell\Cell\obj\Debug\net8.0-windows\Cell_s0jtpbty_wpftmp.GlobalUsings.g.cs", "C#", 5, 0, 0, 0, 0, 1, 1, 7
"c:\Users\chris\source\repos\Cell\Cell\obj\Debug\net8.0-windows\Cell_s0jtpbty_wpftmp.sourcelink.json", "JSON", 0, 0, 0, 1, 0, 0, 0, 1
"c:\Users\chris\source\repos\Cell\Cell\obj\Debug\net8.0-windows\Cell_s1opy5zd_wpftmp.AssemblyInfo.cs", "C#", 11, 0, 0, 0, 0, 10, 5, 26
"c:\Users\chris\source\repos\Cell\Cell\obj\Debug\net8.0-windows\Cell_s1opy5zd_wpftmp.GeneratedMSBuildEditorConfig.editorconfig", "Properties", 0, 0, 0, 0, 13, 0, 1, 14
"c:\Users\chris\source\repos\Cell\Cell\obj\Debug\net8.0-windows\Cell_s1opy5zd_wpftmp.GlobalUsings.g.cs", "C#", 5, 0, 0, 0, 0, 1, 1, 7
"c:\Users\chris\source\repos\Cell\Cell\obj\Debug\net8.0-windows\Cell_s2njvgyk_wpftmp.AssemblyInfo.cs", "C#", 11, 0, 0, 0, 0, 10, 5, 26
"c:\Users\chris\source\repos\Cell\Cell\obj\Debug\net8.0-windows\Cell_s2njvgyk_wpftmp.GeneratedMSBuildEditorConfig.editorconfig", "Properties", 0, 0, 0, 0, 21, 0, 1, 22
"c:\Users\chris\source\repos\Cell\Cell\obj\Debug\net8.0-windows\Cell_s2njvgyk_wpftmp.GlobalUsings.g.cs", "C#", 5, 0, 0, 0, 0, 1, 1, 7
"c:\Users\chris\source\repos\Cell\Cell\obj\Debug\net8.0-windows\Cell_s2njvgyk_wpftmp.sourcelink.json", "JSON", 0, 0, 0, 1, 0, 0, 0, 1
"c:\Users\chris\source\repos\Cell\Cell\obj\Debug\net8.0-windows\Cell_s2vxcjcl_wpftmp.AssemblyInfo.cs", "C#", 11, 0, 0, 0, 0, 10, 5, 26
"c:\Users\chris\source\repos\Cell\Cell\obj\Debug\net8.0-windows\Cell_s2vxcjcl_wpftmp.GeneratedMSBuildEditorConfig.editorconfig", "Properties", 0, 0, 0, 0, 21, 0, 1, 22
"c:\Users\chris\source\repos\Cell\Cell\obj\Debug\net8.0-windows\Cell_s2vxcjcl_wpftmp.GlobalUsings.g.cs", "C#", 5, 0, 0, 0, 0, 1, 1, 7
"c:\Users\chris\source\repos\Cell\Cell\obj\Debug\net8.0-windows\Cell_s2vxcjcl_wpftmp.sourcelink.json", "JSON", 0, 0, 0, 1, 0, 0, 0, 1
"c:\Users\chris\source\repos\Cell\Cell\obj\Debug\net8.0-windows\Cell_s3czojtv_wpftmp.AssemblyInfo.cs", "C#", 11, 0, 0, 0, 0, 10, 5, 26
"c:\Users\chris\source\repos\Cell\Cell\obj\Debug\net8.0-windows\Cell_s3czojtv_wpftmp.GeneratedMSBuildEditorConfig.editorconfig", "Properties", 0, 0, 0, 0, 21, 0, 1, 22
"c:\Users\chris\source\repos\Cell\Cell\obj\Debug\net8.0-windows\Cell_s3czojtv_wpftmp.GlobalUsings.g.cs", "C#", 5, 0, 0, 0, 0, 1, 1, 7
"c:\Users\chris\source\repos\Cell\Cell\obj\Debug\net8.0-windows\Cell_s3czojtv_wpftmp.sourcelink.json", "JSON", 0, 0, 0, 1, 0, 0, 0, 1
"c:\Users\chris\source\repos\Cell\Cell\obj\Debug\net8.0-windows\Cell_s3dhngwr_wpftmp.AssemblyInfo.cs", "C#", 11, 0, 0, 0, 0, 10, 5, 26
"c:\Users\chris\source\repos\Cell\Cell\obj\Debug\net8.0-windows\Cell_s3dhngwr_wpftmp.GeneratedMSBuildEditorConfig.editorconfig", "Properties", 0, 0, 0, 0, 13, 0, 1, 14
"c:\Users\chris\source\repos\Cell\Cell\obj\Debug\net8.0-windows\Cell_s3dhngwr_wpftmp.GlobalUsings.g.cs", "C#", 5, 0, 0, 0, 0, 1, 1, 7
"c:\Users\chris\source\repos\Cell\Cell\obj\Debug\net8.0-windows\Cell_s3hslpqt_wpftmp.AssemblyInfo.cs", "C#", 11, 0, 0, 0, 0, 10, 5, 26
"c:\Users\chris\source\repos\Cell\Cell\obj\Debug\net8.0-windows\Cell_s3hslpqt_wpftmp.GeneratedMSBuildEditorConfig.editorconfig", "Properties", 0, 0, 0, 0, 13, 0, 1, 14
"c:\Users\chris\source\repos\Cell\Cell\obj\Debug\net8.0-windows\Cell_s3hslpqt_wpftmp.GlobalUsings.g.cs", "C#", 5, 0, 0, 0, 0, 1, 1, 7
"c:\Users\chris\source\repos\Cell\Cell\obj\Debug\net8.0-windows\Cell_s4c3rf5q_wpftmp.AssemblyInfo.cs", "C#", 11, 0, 0, 0, 0, 10, 5, 26
"c:\Users\chris\source\repos\Cell\Cell\obj\Debug\net8.0-windows\Cell_s4c3rf5q_wpftmp.GeneratedMSBuildEditorConfig.editorconfig", "Properties", 0, 0, 0, 0, 21, 0, 1, 22
"c:\Users\chris\source\repos\Cell\Cell\obj\Debug\net8.0-windows\Cell_s4c3rf5q_wpftmp.GlobalUsings.g.cs", "C#", 5, 0, 0, 0, 0, 1, 1, 7
"c:\Users\chris\source\repos\Cell\Cell\obj\Debug\net8.0-windows\Cell_s4c3rf5q_wpftmp.sourcelink.json", "JSON", 0, 0, 0, 1, 0, 0, 0, 1
"c:\Users\chris\source\repos\Cell\Cell\obj\Debug\net8.0-windows\Cell_s4ljwcj4_wpftmp.AssemblyInfo.cs", "C#", 11, 0, 0, 0, 0, 10, 5, 26
"c:\Users\chris\source\repos\Cell\Cell\obj\Debug\net8.0-windows\Cell_s4ljwcj4_wpftmp.GeneratedMSBuildEditorConfig.editorconfig", "Properties", 0, 0, 0, 0, 21, 0, 1, 22
"c:\Users\chris\source\repos\Cell\Cell\obj\Debug\net8.0-windows\Cell_s4ljwcj4_wpftmp.GlobalUsings.g.cs", "C#", 5, 0, 0, 0, 0, 1, 1, 7
"c:\Users\chris\source\repos\Cell\Cell\obj\Debug\net8.0-windows\Cell_s4ljwcj4_wpftmp.sourcelink.json", "JSON", 0, 0, 0, 1, 0, 0, 0, 1
"c:\Users\chris\source\repos\Cell\Cell\obj\Debug\net8.0-windows\Cell_s5i30xva_wpftmp.AssemblyInfo.cs", "C#", 11, 0, 0, 0, 0, 10, 5, 26
"c:\Users\chris\source\repos\Cell\Cell\obj\Debug\net8.0-windows\Cell_s5i30xva_wpftmp.GeneratedMSBuildEditorConfig.editorconfig", "Properties", 0, 0, 0, 0, 21, 0, 1, 22
"c:\Users\chris\source\repos\Cell\Cell\obj\Debug\net8.0-windows\Cell_s5i30xva_wpftmp.GlobalUsings.g.cs", "C#", 5, 0, 0, 0, 0, 1, 1, 7
"c:\Users\chris\source\repos\Cell\Cell\obj\Debug\net8.0-windows\Cell_s5i30xva_wpftmp.sourcelink.json", "JSON", 0, 0, 0, 1, 0, 0, 0, 1
"c:\Users\chris\source\repos\Cell\Cell\obj\Debug\net8.0-windows\Cell_sbbqkk1w_wpftmp.AssemblyInfo.cs", "C#", 11, 0, 0, 0, 0, 10, 5, 26
"c:\Users\chris\source\repos\Cell\Cell\obj\Debug\net8.0-windows\Cell_sbbqkk1w_wpftmp.GeneratedMSBuildEditorConfig.editorconfig", "Properties", 0, 0, 0, 0, 21, 0, 1, 22
"c:\Users\chris\source\repos\Cell\Cell\obj\Debug\net8.0-windows\Cell_sbbqkk1w_wpftmp.GlobalUsings.g.cs", "C#", 5, 0, 0, 0, 0, 1, 1, 7
"c:\Users\chris\source\repos\Cell\Cell\obj\Debug\net8.0-windows\Cell_sbbqkk1w_wpftmp.sourcelink.json", "JSON", 0, 0, 0, 1, 0, 0, 0, 1
"c:\Users\chris\source\repos\Cell\Cell\obj\Debug\net8.0-windows\Cell_sbzru14l_wpftmp.AssemblyInfo.cs", "C#", 11, 0, 0, 0, 0, 10, 5, 26
"c:\Users\chris\source\repos\Cell\Cell\obj\Debug\net8.0-windows\Cell_sbzru14l_wpftmp.GeneratedMSBuildEditorConfig.editorconfig", "Properties", 0, 0, 0, 0, 21, 0, 1, 22
"c:\Users\chris\source\repos\Cell\Cell\obj\Debug\net8.0-windows\Cell_sbzru14l_wpftmp.GlobalUsings.g.cs", "C#", 5, 0, 0, 0, 0, 1, 1, 7
"c:\Users\chris\source\repos\Cell\Cell\obj\Debug\net8.0-windows\Cell_sbzru14l_wpftmp.sourcelink.json", "JSON", 0, 0, 0, 1, 0, 0, 0, 1
"c:\Users\chris\source\repos\Cell\Cell\obj\Debug\net8.0-windows\Cell_sd4arjc5_wpftmp.AssemblyInfo.cs", "C#", 11, 0, 0, 0, 0, 10, 5, 26
"c:\Users\chris\source\repos\Cell\Cell\obj\Debug\net8.0-windows\Cell_sd4arjc5_wpftmp.GeneratedMSBuildEditorConfig.editorconfig", "Properties", 0, 0, 0, 0, 21, 0, 1, 22
"c:\Users\chris\source\repos\Cell\Cell\obj\Debug\net8.0-windows\Cell_sd4arjc5_wpftmp.GlobalUsings.g.cs", "C#", 5, 0, 0, 0, 0, 1, 1, 7
"c:\Users\chris\source\repos\Cell\Cell\obj\Debug\net8.0-windows\Cell_sd4arjc5_wpftmp.sourcelink.json", "JSON", 0, 0, 0, 1, 0, 0, 0, 1
"c:\Users\chris\source\repos\Cell\Cell\obj\Debug\net8.0-windows\Cell_sd4bvvai_wpftmp.AssemblyInfo.cs", "C#", 11, 0, 0, 0, 0, 10, 5, 26
"c:\Users\chris\source\repos\Cell\Cell\obj\Debug\net8.0-windows\Cell_sd4bvvai_wpftmp.GeneratedMSBuildEditorConfig.editorconfig", "Properties", 0, 0, 0, 0, 21, 0, 1, 22
"c:\Users\chris\source\repos\Cell\Cell\obj\Debug\net8.0-windows\Cell_sd4bvvai_wpftmp.GlobalUsings.g.cs", "C#", 5, 0, 0, 0, 0, 1, 1, 7
"c:\Users\chris\source\repos\Cell\Cell\obj\Debug\net8.0-windows\Cell_sd4bvvai_wpftmp.sourcelink.json", "JSON", 0, 0, 0, 1, 0, 0, 0, 1
"c:\Users\chris\source\repos\Cell\Cell\obj\Debug\net8.0-windows\Cell_sdt3xawu_wpftmp.AssemblyInfo.cs", "C#", 11, 0, 0, 0, 0, 10, 5, 26
"c:\Users\chris\source\repos\Cell\Cell\obj\Debug\net8.0-windows\Cell_sdt3xawu_wpftmp.GeneratedMSBuildEditorConfig.editorconfig", "Properties", 0, 0, 0, 0, 21, 0, 1, 22
"c:\Users\chris\source\repos\Cell\Cell\obj\Debug\net8.0-windows\Cell_sdt3xawu_wpftmp.GlobalUsings.g.cs", "C#", 5, 0, 0, 0, 0, 1, 1, 7
"c:\Users\chris\source\repos\Cell\Cell\obj\Debug\net8.0-windows\Cell_sdt3xawu_wpftmp.sourcelink.json", "JSON", 0, 0, 0, 1, 0, 0, 0, 1
"c:\Users\chris\source\repos\Cell\Cell\obj\Debug\net8.0-windows\Cell_seirud0t_wpftmp.AssemblyInfo.cs", "C#", 11, 0, 0, 0, 0, 10, 5, 26
"c:\Users\chris\source\repos\Cell\Cell\obj\Debug\net8.0-windows\Cell_seirud0t_wpftmp.GeneratedMSBuildEditorConfig.editorconfig", "Properties", 0, 0, 0, 0, 21, 0, 1, 22
"c:\Users\chris\source\repos\Cell\Cell\obj\Debug\net8.0-windows\Cell_seirud0t_wpftmp.GlobalUsings.g.cs", "C#", 5, 0, 0, 0, 0, 1, 1, 7
"c:\Users\chris\source\repos\Cell\Cell\obj\Debug\net8.0-windows\Cell_seirud0t_wpftmp.sourcelink.json", "JSON", 0, 0, 0, 1, 0, 0, 0, 1
"c:\Users\chris\source\repos\Cell\Cell\obj\Debug\net8.0-windows\Cell_sez1gfmw_wpftmp.AssemblyInfo.cs", "C#", 11, 0, 0, 0, 0, 10, 5, 26
"c:\Users\chris\source\repos\Cell\Cell\obj\Debug\net8.0-windows\Cell_sez1gfmw_wpftmp.GeneratedMSBuildEditorConfig.editorconfig", "Properties", 0, 0, 0, 0, 13, 0, 1, 14
"c:\Users\chris\source\repos\Cell\Cell\obj\Debug\net8.0-windows\Cell_sez1gfmw_wpftmp.GlobalUsings.g.cs", "C#", 5, 0, 0, 0, 0, 1, 1, 7
"c:\Users\chris\source\repos\Cell\Cell\obj\Debug\net8.0-windows\Cell_sfgmufax_wpftmp.AssemblyInfo.cs", "C#", 11, 0, 0, 0, 0, 10, 5, 26
"c:\Users\chris\source\repos\Cell\Cell\obj\Debug\net8.0-windows\Cell_sfgmufax_wpftmp.GeneratedMSBuildEditorConfig.editorconfig", "Properties", 0, 0, 0, 0, 13, 0, 1, 14
"c:\Users\chris\source\repos\Cell\Cell\obj\Debug\net8.0-windows\Cell_sfgmufax_wpftmp.GlobalUsings.g.cs", "C#", 5, 0, 0, 0, 0, 1, 1, 7
"c:\Users\chris\source\repos\Cell\Cell\obj\Debug\net8.0-windows\Cell_sfidcmha_wpftmp.AssemblyInfo.cs", "C#", 11, 0, 0, 0, 0, 10, 5, 26
"c:\Users\chris\source\repos\Cell\Cell\obj\Debug\net8.0-windows\Cell_sfidcmha_wpftmp.GeneratedMSBuildEditorConfig.editorconfig", "Properties", 0, 0, 0, 0, 21, 0, 1, 22
"c:\Users\chris\source\repos\Cell\Cell\obj\Debug\net8.0-windows\Cell_sfidcmha_wpftmp.GlobalUsings.g.cs", "C#", 5, 0, 0, 0, 0, 1, 1, 7
"c:\Users\chris\source\repos\Cell\Cell\obj\Debug\net8.0-windows\Cell_sfidcmha_wpftmp.sourcelink.json", "JSON", 0, 0, 0, 1, 0, 0, 0, 1
"c:\Users\chris\source\repos\Cell\Cell\obj\Debug\net8.0-windows\Cell_shaucosu_wpftmp.AssemblyInfo.cs", "C#", 11, 0, 0, 0, 0, 10, 5, 26
"c:\Users\chris\source\repos\Cell\Cell\obj\Debug\net8.0-windows\Cell_shaucosu_wpftmp.GeneratedMSBuildEditorConfig.editorconfig", "Properties", 0, 0, 0, 0, 21, 0, 1, 22
"c:\Users\chris\source\repos\Cell\Cell\obj\Debug\net8.0-windows\Cell_shaucosu_wpftmp.GlobalUsings.g.cs", "C#", 5, 0, 0, 0, 0, 1, 1, 7
"c:\Users\chris\source\repos\Cell\Cell\obj\Debug\net8.0-windows\Cell_shaucosu_wpftmp.sourcelink.json", "JSON", 0, 0, 0, 1, 0, 0, 0, 1
"c:\Users\chris\source\repos\Cell\Cell\obj\Debug\net8.0-windows\Cell_sinm1btt_wpftmp.AssemblyInfo.cs", "C#", 11, 0, 0, 0, 0, 10, 5, 26
"c:\Users\chris\source\repos\Cell\Cell\obj\Debug\net8.0-windows\Cell_sinm1btt_wpftmp.GeneratedMSBuildEditorConfig.editorconfig", "Properties", 0, 0, 0, 0, 21, 0, 1, 22
"c:\Users\chris\source\repos\Cell\Cell\obj\Debug\net8.0-windows\Cell_sinm1btt_wpftmp.GlobalUsings.g.cs", "C#", 5, 0, 0, 0, 0, 1, 1, 7
"c:\Users\chris\source\repos\Cell\Cell\obj\Debug\net8.0-windows\Cell_sinm1btt_wpftmp.sourcelink.json", "JSON", 0, 0, 0, 1, 0, 0, 0, 1
"c:\Users\chris\source\repos\Cell\Cell\obj\Debug\net8.0-windows\Cell_sp1ympce_wpftmp.AssemblyInfo.cs", "C#", 11, 0, 0, 0, 0, 10, 5, 26
"c:\Users\chris\source\repos\Cell\Cell\obj\Debug\net8.0-windows\Cell_sp1ympce_wpftmp.GeneratedMSBuildEditorConfig.editorconfig", "Properties", 0, 0, 0, 0, 21, 0, 1, 22
"c:\Users\chris\source\repos\Cell\Cell\obj\Debug\net8.0-windows\Cell_sp1ympce_wpftmp.GlobalUsings.g.cs", "C#", 5, 0, 0, 0, 0, 1, 1, 7
"c:\Users\chris\source\repos\Cell\Cell\obj\Debug\net8.0-windows\Cell_sp1ympce_wpftmp.sourcelink.json", "JSON", 0, 0, 0, 1, 0, 0, 0, 1
"c:\Users\chris\source\repos\Cell\Cell\obj\Debug\net8.0-windows\Cell_spwabxvl_wpftmp.AssemblyInfo.cs", "C#", 11, 0, 0, 0, 0, 10, 5, 26
"c:\Users\chris\source\repos\Cell\Cell\obj\Debug\net8.0-windows\Cell_spwabxvl_wpftmp.GeneratedMSBuildEditorConfig.editorconfig", "Properties", 0, 0, 0, 0, 21, 0, 1, 22
"c:\Users\chris\source\repos\Cell\Cell\obj\Debug\net8.0-windows\Cell_spwabxvl_wpftmp.GlobalUsings.g.cs", "C#", 5, 0, 0, 0, 0, 1, 1, 7
"c:\Users\chris\source\repos\Cell\Cell\obj\Debug\net8.0-windows\Cell_spwabxvl_wpftmp.sourcelink.json", "JSON", 0, 0, 0, 1, 0, 0, 0, 1
"c:\Users\chris\source\repos\Cell\Cell\obj\Debug\net8.0-windows\Cell_sqgiqbrn_wpftmp.AssemblyInfo.cs", "C#", 11, 0, 0, 0, 0, 10, 5, 26
"c:\Users\chris\source\repos\Cell\Cell\obj\Debug\net8.0-windows\Cell_sqgiqbrn_wpftmp.GeneratedMSBuildEditorConfig.editorconfig", "Properties", 0, 0, 0, 0, 21, 0, 1, 22
"c:\Users\chris\source\repos\Cell\Cell\obj\Debug\net8.0-windows\Cell_sqgiqbrn_wpftmp.GlobalUsings.g.cs", "C#", 5, 0, 0, 0, 0, 1, 1, 7
"c:\Users\chris\source\repos\Cell\Cell\obj\Debug\net8.0-windows\Cell_sqgiqbrn_wpftmp.sourcelink.json", "JSON", 0, 0, 0, 1, 0, 0, 0, 1
"c:\Users\chris\source\repos\Cell\Cell\obj\Debug\net8.0-windows\Cell_sqmi10fj_wpftmp.AssemblyInfo.cs", "C#", 11, 0, 0, 0, 0, 10, 5, 26
"c:\Users\chris\source\repos\Cell\Cell\obj\Debug\net8.0-windows\Cell_sqmi10fj_wpftmp.GeneratedMSBuildEditorConfig.editorconfig", "Properties", 0, 0, 0, 0, 13, 0, 1, 14
"c:\Users\chris\source\repos\Cell\Cell\obj\Debug\net8.0-windows\Cell_sqmi10fj_wpftmp.GlobalUsings.g.cs", "C#", 5, 0, 0, 0, 0, 1, 1, 7
"c:\Users\chris\source\repos\Cell\Cell\obj\Debug\net8.0-windows\Cell_sqmxz45g_wpftmp.AssemblyInfo.cs", "C#", 11, 0, 0, 0, 0, 10, 5, 26
"c:\Users\chris\source\repos\Cell\Cell\obj\Debug\net8.0-windows\Cell_sqmxz45g_wpftmp.GeneratedMSBuildEditorConfig.editorconfig", "Properties", 0, 0, 0, 0, 21, 0, 1, 22
"c:\Users\chris\source\repos\Cell\Cell\obj\Debug\net8.0-windows\Cell_sqmxz45g_wpftmp.GlobalUsings.g.cs", "C#", 5, 0, 0, 0, 0, 1, 1, 7
"c:\Users\chris\source\repos\Cell\Cell\obj\Debug\net8.0-windows\Cell_sqmxz45g_wpftmp.sourcelink.json", "JSON", 0, 0, 0, 1, 0, 0, 0, 1
"c:\Users\chris\source\repos\Cell\Cell\obj\Debug\net8.0-windows\Cell_ssn2tg02_wpftmp.AssemblyInfo.cs", "C#", 11, 0, 0, 0, 0, 10, 5, 26
"c:\Users\chris\source\repos\Cell\Cell\obj\Debug\net8.0-windows\Cell_ssn2tg02_wpftmp.GeneratedMSBuildEditorConfig.editorconfig", "Properties", 0, 0, 0, 0, 21, 0, 1, 22
"c:\Users\chris\source\repos\Cell\Cell\obj\Debug\net8.0-windows\Cell_ssn2tg02_wpftmp.GlobalUsings.g.cs", "C#", 5, 0, 0, 0, 0, 1, 1, 7
"c:\Users\chris\source\repos\Cell\Cell\obj\Debug\net8.0-windows\Cell_ssn2tg02_wpftmp.sourcelink.json", "JSON", 0, 0, 0, 1, 0, 0, 0, 1
"c:\Users\chris\source\repos\Cell\Cell\obj\Debug\net8.0-windows\Cell_ssx5tvgo_wpftmp.AssemblyInfo.cs", "C#", 11, 0, 0, 0, 0, 10, 5, 26
"c:\Users\chris\source\repos\Cell\Cell\obj\Debug\net8.0-windows\Cell_ssx5tvgo_wpftmp.GeneratedMSBuildEditorConfig.editorconfig", "Properties", 0, 0, 0, 0, 21, 0, 1, 22
"c:\Users\chris\source\repos\Cell\Cell\obj\Debug\net8.0-windows\Cell_ssx5tvgo_wpftmp.GlobalUsings.g.cs", "C#", 5, 0, 0, 0, 0, 1, 1, 7
"c:\Users\chris\source\repos\Cell\Cell\obj\Debug\net8.0-windows\Cell_ssx5tvgo_wpftmp.sourcelink.json", "JSON", 0, 0, 0, 1, 0, 0, 0, 1
"c:\Users\chris\source\repos\Cell\Cell\obj\Debug\net8.0-windows\Cell_sughxq3j_wpftmp.AssemblyInfo.cs", "C#", 11, 0, 0, 0, 0, 10, 5, 26
"c:\Users\chris\source\repos\Cell\Cell\obj\Debug\net8.0-windows\Cell_sughxq3j_wpftmp.GeneratedMSBuildEditorConfig.editorconfig", "Properties", 0, 0, 0, 0, 21, 0, 1, 22
"c:\Users\chris\source\repos\Cell\Cell\obj\Debug\net8.0-windows\Cell_sughxq3j_wpftmp.GlobalUsings.g.cs", "C#", 5, 0, 0, 0, 0, 1, 1, 7
"c:\Users\chris\source\repos\Cell\Cell\obj\Debug\net8.0-windows\Cell_sughxq3j_wpftmp.sourcelink.json", "JSON", 0, 0, 0, 1, 0, 0, 0, 1
"c:\Users\chris\source\repos\Cell\Cell\obj\Debug\net8.0-windows\Cell_sv03gwzg_wpftmp.AssemblyInfo.cs", "C#", 11, 0, 0, 0, 0, 10, 5, 26
"c:\Users\chris\source\repos\Cell\Cell\obj\Debug\net8.0-windows\Cell_sv03gwzg_wpftmp.GeneratedMSBuildEditorConfig.editorconfig", "Properties", 0, 0, 0, 0, 21, 0, 1, 22
"c:\Users\chris\source\repos\Cell\Cell\obj\Debug\net8.0-windows\Cell_sv03gwzg_wpftmp.GlobalUsings.g.cs", "C#", 5, 0, 0, 0, 0, 1, 1, 7
"c:\Users\chris\source\repos\Cell\Cell\obj\Debug\net8.0-windows\Cell_sv03gwzg_wpftmp.sourcelink.json", "JSON", 0, 0, 0, 1, 0, 0, 0, 1
"c:\Users\chris\source\repos\Cell\Cell\obj\Debug\net8.0-windows\Cell_svnhndi5_wpftmp.AssemblyInfo.cs", "C#", 11, 0, 0, 0, 0, 10, 5, 26
"c:\Users\chris\source\repos\Cell\Cell\obj\Debug\net8.0-windows\Cell_svnhndi5_wpftmp.GeneratedMSBuildEditorConfig.editorconfig", "Properties", 0, 0, 0, 0, 13, 0, 1, 14
"c:\Users\chris\source\repos\Cell\Cell\obj\Debug\net8.0-windows\Cell_svnhndi5_wpftmp.GlobalUsings.g.cs", "C#", 5, 0, 0, 0, 0, 1, 1, 7
"c:\Users\chris\source\repos\Cell\Cell\obj\Debug\net8.0-windows\Cell_sw50nmfm_wpftmp.AssemblyInfo.cs", "C#", 11, 0, 0, 0, 0, 10, 5, 26
"c:\Users\chris\source\repos\Cell\Cell\obj\Debug\net8.0-windows\Cell_sw50nmfm_wpftmp.GeneratedMSBuildEditorConfig.editorconfig", "Properties", 0, 0, 0, 0, 21, 0, 1, 22
"c:\Users\chris\source\repos\Cell\Cell\obj\Debug\net8.0-windows\Cell_sw50nmfm_wpftmp.GlobalUsings.g.cs", "C#", 5, 0, 0, 0, 0, 1, 1, 7
"c:\Users\chris\source\repos\Cell\Cell\obj\Debug\net8.0-windows\Cell_sw50nmfm_wpftmp.sourcelink.json", "JSON", 0, 0, 0, 1, 0, 0, 0, 1
"c:\Users\chris\source\repos\Cell\Cell\obj\Debug\net8.0-windows\Cell_sy2sya3l_wpftmp.AssemblyInfo.cs", "C#", 11, 0, 0, 0, 0, 10, 5, 26
"c:\Users\chris\source\repos\Cell\Cell\obj\Debug\net8.0-windows\Cell_sy2sya3l_wpftmp.GeneratedMSBuildEditorConfig.editorconfig", "Properties", 0, 0, 0, 0, 13, 0, 1, 14
"c:\Users\chris\source\repos\Cell\Cell\obj\Debug\net8.0-windows\Cell_sy2sya3l_wpftmp.GlobalUsings.g.cs", "C#", 5, 0, 0, 0, 0, 1, 1, 7
"c:\Users\chris\source\repos\Cell\Cell\obj\Debug\net8.0-windows\Cell_t2r0yfxk_wpftmp.AssemblyInfo.cs", "C#", 11, 0, 0, 0, 0, 10, 5, 26
"c:\Users\chris\source\repos\Cell\Cell\obj\Debug\net8.0-windows\Cell_t2r0yfxk_wpftmp.GeneratedMSBuildEditorConfig.editorconfig", "Properties", 0, 0, 0, 0, 21, 0, 1, 22
"c:\Users\chris\source\repos\Cell\Cell\obj\Debug\net8.0-windows\Cell_t2r0yfxk_wpftmp.GlobalUsings.g.cs", "C#", 5, 0, 0, 0, 0, 1, 1, 7
"c:\Users\chris\source\repos\Cell\Cell\obj\Debug\net8.0-windows\Cell_t2r0yfxk_wpftmp.sourcelink.json", "JSON", 0, 0, 0, 1, 0, 0, 0, 1
"c:\Users\chris\source\repos\Cell\Cell\obj\Debug\net8.0-windows\Cell_t4a0v0tu_wpftmp.AssemblyInfo.cs", "C#", 11, 0, 0, 0, 0, 10, 5, 26
"c:\Users\chris\source\repos\Cell\Cell\obj\Debug\net8.0-windows\Cell_t4a0v0tu_wpftmp.GeneratedMSBuildEditorConfig.editorconfig", "Properties", 0, 0, 0, 0, 21, 0, 1, 22
"c:\Users\chris\source\repos\Cell\Cell\obj\Debug\net8.0-windows\Cell_t4a0v0tu_wpftmp.GlobalUsings.g.cs", "C#", 5, 0, 0, 0, 0, 1, 1, 7
"c:\Users\chris\source\repos\Cell\Cell\obj\Debug\net8.0-windows\Cell_t4a0v0tu_wpftmp.sourcelink.json", "JSON", 0, 0, 0, 1, 0, 0, 0, 1
"c:\Users\chris\source\repos\Cell\Cell\obj\Debug\net8.0-windows\Cell_t4pmgt1p_wpftmp.AssemblyInfo.cs", "C#", 11, 0, 0, 0, 0, 10, 5, 26
"c:\Users\chris\source\repos\Cell\Cell\obj\Debug\net8.0-windows\Cell_t4pmgt1p_wpftmp.GeneratedMSBuildEditorConfig.editorconfig", "Properties", 0, 0, 0, 0, 21, 0, 1, 22
"c:\Users\chris\source\repos\Cell\Cell\obj\Debug\net8.0-windows\Cell_t4pmgt1p_wpftmp.GlobalUsings.g.cs", "C#", 5, 0, 0, 0, 0, 1, 1, 7
"c:\Users\chris\source\repos\Cell\Cell\obj\Debug\net8.0-windows\Cell_t4pmgt1p_wpftmp.sourcelink.json", "JSON", 0, 0, 0, 1, 0, 0, 0, 1
"c:\Users\chris\source\repos\Cell\Cell\obj\Debug\net8.0-windows\Cell_t4zinmrm_wpftmp.AssemblyInfo.cs", "C#", 11, 0, 0, 0, 0, 10, 5, 26
"c:\Users\chris\source\repos\Cell\Cell\obj\Debug\net8.0-windows\Cell_t4zinmrm_wpftmp.GeneratedMSBuildEditorConfig.editorconfig", "Properties", 0, 0, 0, 0, 21, 0, 1, 22
"c:\Users\chris\source\repos\Cell\Cell\obj\Debug\net8.0-windows\Cell_t4zinmrm_wpftmp.GlobalUsings.g.cs", "C#", 5, 0, 0, 0, 0, 1, 1, 7
"c:\Users\chris\source\repos\Cell\Cell\obj\Debug\net8.0-windows\Cell_t4zinmrm_wpftmp.sourcelink.json", "JSON", 0, 0, 0, 1, 0, 0, 0, 1
"c:\Users\chris\source\repos\Cell\Cell\obj\Debug\net8.0-windows\Cell_taewcmfd_wpftmp.AssemblyInfo.cs", "C#", 11, 0, 0, 0, 0, 10, 5, 26
"c:\Users\chris\source\repos\Cell\Cell\obj\Debug\net8.0-windows\Cell_taewcmfd_wpftmp.GeneratedMSBuildEditorConfig.editorconfig", "Properties", 0, 0, 0, 0, 13, 0, 1, 14
"c:\Users\chris\source\repos\Cell\Cell\obj\Debug\net8.0-windows\Cell_taewcmfd_wpftmp.GlobalUsings.g.cs", "C#", 5, 0, 0, 0, 0, 1, 1, 7
"c:\Users\chris\source\repos\Cell\Cell\obj\Debug\net8.0-windows\Cell_tbfb52vi_wpftmp.AssemblyInfo.cs", "C#", 11, 0, 0, 0, 0, 10, 5, 26
"c:\Users\chris\source\repos\Cell\Cell\obj\Debug\net8.0-windows\Cell_tbfb52vi_wpftmp.GeneratedMSBuildEditorConfig.editorconfig", "Properties", 0, 0, 0, 0, 21, 0, 1, 22
"c:\Users\chris\source\repos\Cell\Cell\obj\Debug\net8.0-windows\Cell_tbfb52vi_wpftmp.GlobalUsings.g.cs", "C#", 5, 0, 0, 0, 0, 1, 1, 7
"c:\Users\chris\source\repos\Cell\Cell\obj\Debug\net8.0-windows\Cell_tbfb52vi_wpftmp.sourcelink.json", "JSON", 0, 0, 0, 1, 0, 0, 0, 1
"c:\Users\chris\source\repos\Cell\Cell\obj\Debug\net8.0-windows\Cell_tbw1ajgj_wpftmp.AssemblyInfo.cs", "C#", 11, 0, 0, 0, 0, 10, 5, 26
"c:\Users\chris\source\repos\Cell\Cell\obj\Debug\net8.0-windows\Cell_tbw1ajgj_wpftmp.GeneratedMSBuildEditorConfig.editorconfig", "Properties", 0, 0, 0, 0, 13, 0, 1, 14
"c:\Users\chris\source\repos\Cell\Cell\obj\Debug\net8.0-windows\Cell_tbw1ajgj_wpftmp.GlobalUsings.g.cs", "C#", 5, 0, 0, 0, 0, 1, 1, 7
"c:\Users\chris\source\repos\Cell\Cell\obj\Debug\net8.0-windows\Cell_tbypzcfh_wpftmp.AssemblyInfo.cs", "C#", 11, 0, 0, 0, 0, 10, 5, 26
"c:\Users\chris\source\repos\Cell\Cell\obj\Debug\net8.0-windows\Cell_tbypzcfh_wpftmp.GeneratedMSBuildEditorConfig.editorconfig", "Properties", 0, 0, 0, 0, 21, 0, 1, 22
"c:\Users\chris\source\repos\Cell\Cell\obj\Debug\net8.0-windows\Cell_tbypzcfh_wpftmp.GlobalUsings.g.cs", "C#", 5, 0, 0, 0, 0, 1, 1, 7
"c:\Users\chris\source\repos\Cell\Cell\obj\Debug\net8.0-windows\Cell_tbypzcfh_wpftmp.sourcelink.json", "JSON", 0, 0, 0, 1, 0, 0, 0, 1
"c:\Users\chris\source\repos\Cell\Cell\obj\Debug\net8.0-windows\Cell_tcdsmgnv_wpftmp.AssemblyInfo.cs", "C#", 11, 0, 0, 0, 0, 10, 5, 26
"c:\Users\chris\source\repos\Cell\Cell\obj\Debug\net8.0-windows\Cell_tcdsmgnv_wpftmp.GeneratedMSBuildEditorConfig.editorconfig", "Properties", 0, 0, 0, 0, 21, 0, 1, 22
"c:\Users\chris\source\repos\Cell\Cell\obj\Debug\net8.0-windows\Cell_tcdsmgnv_wpftmp.GlobalUsings.g.cs", "C#", 5, 0, 0, 0, 0, 1, 1, 7
"c:\Users\chris\source\repos\Cell\Cell\obj\Debug\net8.0-windows\Cell_tcdsmgnv_wpftmp.sourcelink.json", "JSON", 0, 0, 0, 1, 0, 0, 0, 1
"c:\Users\chris\source\repos\Cell\Cell\obj\Debug\net8.0-windows\Cell_tdgl52yw_wpftmp.AssemblyInfo.cs", "C#", 11, 0, 0, 0, 0, 10, 5, 26
"c:\Users\chris\source\repos\Cell\Cell\obj\Debug\net8.0-windows\Cell_tdgl52yw_wpftmp.GeneratedMSBuildEditorConfig.editorconfig", "Properties", 0, 0, 0, 0, 13, 0, 1, 14
"c:\Users\chris\source\repos\Cell\Cell\obj\Debug\net8.0-windows\Cell_tdgl52yw_wpftmp.GlobalUsings.g.cs", "C#", 5, 0, 0, 0, 0, 1, 1, 7
"c:\Users\chris\source\repos\Cell\Cell\obj\Debug\net8.0-windows\Cell_tdva2b2w_wpftmp.AssemblyInfo.cs", "C#", 11, 0, 0, 0, 0, 10, 5, 26
"c:\Users\chris\source\repos\Cell\Cell\obj\Debug\net8.0-windows\Cell_tdva2b2w_wpftmp.GeneratedMSBuildEditorConfig.editorconfig", "Properties", 0, 0, 0, 0, 21, 0, 1, 22
"c:\Users\chris\source\repos\Cell\Cell\obj\Debug\net8.0-windows\Cell_tdva2b2w_wpftmp.GlobalUsings.g.cs", "C#", 5, 0, 0, 0, 0, 1, 1, 7
"c:\Users\chris\source\repos\Cell\Cell\obj\Debug\net8.0-windows\Cell_tdva2b2w_wpftmp.sourcelink.json", "JSON", 0, 0, 0, 1, 0, 0, 0, 1
"c:\Users\chris\source\repos\Cell\Cell\obj\Debug\net8.0-windows\Cell_tfsymn20_wpftmp.AssemblyInfo.cs", "C#", 11, 0, 0, 0, 0, 10, 5, 26
"c:\Users\chris\source\repos\Cell\Cell\obj\Debug\net8.0-windows\Cell_tfsymn20_wpftmp.GeneratedMSBuildEditorConfig.editorconfig", "Properties", 0, 0, 0, 0, 21, 0, 1, 22
"c:\Users\chris\source\repos\Cell\Cell\obj\Debug\net8.0-windows\Cell_tfsymn20_wpftmp.GlobalUsings.g.cs", "C#", 5, 0, 0, 0, 0, 1, 1, 7
"c:\Users\chris\source\repos\Cell\Cell\obj\Debug\net8.0-windows\Cell_tfsymn20_wpftmp.sourcelink.json", "JSON", 0, 0, 0, 1, 0, 0, 0, 1
"c:\Users\chris\source\repos\Cell\Cell\obj\Debug\net8.0-windows\Cell_tj25ntea_wpftmp.AssemblyInfo.cs", "C#", 11, 0, 0, 0, 0, 10, 5, 26
"c:\Users\chris\source\repos\Cell\Cell\obj\Debug\net8.0-windows\Cell_tj25ntea_wpftmp.GeneratedMSBuildEditorConfig.editorconfig", "Properties", 0, 0, 0, 0, 21, 0, 1, 22
"c:\Users\chris\source\repos\Cell\Cell\obj\Debug\net8.0-windows\Cell_tj25ntea_wpftmp.GlobalUsings.g.cs", "C#", 5, 0, 0, 0, 0, 1, 1, 7
"c:\Users\chris\source\repos\Cell\Cell\obj\Debug\net8.0-windows\Cell_tj25ntea_wpftmp.sourcelink.json", "JSON", 0, 0, 0, 1, 0, 0, 0, 1
"c:\Users\chris\source\repos\Cell\Cell\obj\Debug\net8.0-windows\Cell_tjjdu1er_wpftmp.AssemblyInfo.cs", "C#", 11, 0, 0, 0, 0, 10, 5, 26
"c:\Users\chris\source\repos\Cell\Cell\obj\Debug\net8.0-windows\Cell_tjjdu1er_wpftmp.GeneratedMSBuildEditorConfig.editorconfig", "Properties", 0, 0, 0, 0, 13, 0, 1, 14
"c:\Users\chris\source\repos\Cell\Cell\obj\Debug\net8.0-windows\Cell_tjjdu1er_wpftmp.GlobalUsings.g.cs", "C#", 5, 0, 0, 0, 0, 1, 1, 7
"c:\Users\chris\source\repos\Cell\Cell\obj\Debug\net8.0-windows\Cell_tkhemid5_wpftmp.AssemblyInfo.cs", "C#", 11, 0, 0, 0, 0, 10, 5, 26
"c:\Users\chris\source\repos\Cell\Cell\obj\Debug\net8.0-windows\Cell_tkhemid5_wpftmp.GeneratedMSBuildEditorConfig.editorconfig", "Properties", 0, 0, 0, 0, 13, 0, 1, 14
"c:\Users\chris\source\repos\Cell\Cell\obj\Debug\net8.0-windows\Cell_tkhemid5_wpftmp.GlobalUsings.g.cs", "C#", 5, 0, 0, 0, 0, 1, 1, 7
"c:\Users\chris\source\repos\Cell\Cell\obj\Debug\net8.0-windows\Cell_tki54k33_wpftmp.AssemblyInfo.cs", "C#", 11, 0, 0, 0, 0, 10, 5, 26
"c:\Users\chris\source\repos\Cell\Cell\obj\Debug\net8.0-windows\Cell_tki54k33_wpftmp.GeneratedMSBuildEditorConfig.editorconfig", "Properties", 0, 0, 0, 0, 13, 0, 1, 14
"c:\Users\chris\source\repos\Cell\Cell\obj\Debug\net8.0-windows\Cell_tki54k33_wpftmp.GlobalUsings.g.cs", "C#", 5, 0, 0, 0, 0, 1, 1, 7
"c:\Users\chris\source\repos\Cell\Cell\obj\Debug\net8.0-windows\Cell_tmhktsof_wpftmp.AssemblyInfo.cs", "C#", 11, 0, 0, 0, 0, 10, 5, 26
"c:\Users\chris\source\repos\Cell\Cell\obj\Debug\net8.0-windows\Cell_tmhktsof_wpftmp.GeneratedMSBuildEditorConfig.editorconfig", "Properties", 0, 0, 0, 0, 21, 0, 1, 22
"c:\Users\chris\source\repos\Cell\Cell\obj\Debug\net8.0-windows\Cell_tmhktsof_wpftmp.GlobalUsings.g.cs", "C#", 5, 0, 0, 0, 0, 1, 1, 7
"c:\Users\chris\source\repos\Cell\Cell\obj\Debug\net8.0-windows\Cell_tmhktsof_wpftmp.sourcelink.json", "JSON", 0, 0, 0, 1, 0, 0, 0, 1
"c:\Users\chris\source\repos\Cell\Cell\obj\Debug\net8.0-windows\Cell_tmx5h41o_wpftmp.AssemblyInfo.cs", "C#", 11, 0, 0, 0, 0, 10, 5, 26
"c:\Users\chris\source\repos\Cell\Cell\obj\Debug\net8.0-windows\Cell_tmx5h41o_wpftmp.GeneratedMSBuildEditorConfig.editorconfig", "Properties", 0, 0, 0, 0, 21, 0, 1, 22
"c:\Users\chris\source\repos\Cell\Cell\obj\Debug\net8.0-windows\Cell_tmx5h41o_wpftmp.GlobalUsings.g.cs", "C#", 5, 0, 0, 0, 0, 1, 1, 7
"c:\Users\chris\source\repos\Cell\Cell\obj\Debug\net8.0-windows\Cell_tmx5h41o_wpftmp.sourcelink.json", "JSON", 0, 0, 0, 1, 0, 0, 0, 1
"c:\Users\chris\source\repos\Cell\Cell\obj\Debug\net8.0-windows\Cell_tnofmsd2_wpftmp.AssemblyInfo.cs", "C#", 11, 0, 0, 0, 0, 10, 5, 26
"c:\Users\chris\source\repos\Cell\Cell\obj\Debug\net8.0-windows\Cell_tnofmsd2_wpftmp.GeneratedMSBuildEditorConfig.editorconfig", "Properties", 0, 0, 0, 0, 21, 0, 1, 22
"c:\Users\chris\source\repos\Cell\Cell\obj\Debug\net8.0-windows\Cell_tnofmsd2_wpftmp.GlobalUsings.g.cs", "C#", 5, 0, 0, 0, 0, 1, 1, 7
"c:\Users\chris\source\repos\Cell\Cell\obj\Debug\net8.0-windows\Cell_tnofmsd2_wpftmp.sourcelink.json", "JSON", 0, 0, 0, 1, 0, 0, 0, 1
"c:\Users\chris\source\repos\Cell\Cell\obj\Debug\net8.0-windows\Cell_tovzdpmj_wpftmp.AssemblyInfo.cs", "C#", 11, 0, 0, 0, 0, 10, 5, 26
"c:\Users\chris\source\repos\Cell\Cell\obj\Debug\net8.0-windows\Cell_tovzdpmj_wpftmp.GeneratedMSBuildEditorConfig.editorconfig", "Properties", 0, 0, 0, 0, 13, 0, 1, 14
"c:\Users\chris\source\repos\Cell\Cell\obj\Debug\net8.0-windows\Cell_tovzdpmj_wpftmp.GlobalUsings.g.cs", "C#", 5, 0, 0, 0, 0, 1, 1, 7
"c:\Users\chris\source\repos\Cell\Cell\obj\Debug\net8.0-windows\Cell_tpgv4s4g_wpftmp.AssemblyInfo.cs", "C#", 11, 0, 0, 0, 0, 10, 5, 26
"c:\Users\chris\source\repos\Cell\Cell\obj\Debug\net8.0-windows\Cell_tpgv4s4g_wpftmp.GeneratedMSBuildEditorConfig.editorconfig", "Properties", 0, 0, 0, 0, 13, 0, 1, 14
"c:\Users\chris\source\repos\Cell\Cell\obj\Debug\net8.0-windows\Cell_tpgv4s4g_wpftmp.GlobalUsings.g.cs", "C#", 5, 0, 0, 0, 0, 1, 1, 7
"c:\Users\chris\source\repos\Cell\Cell\obj\Debug\net8.0-windows\Cell_tsoktdmy_wpftmp.AssemblyInfo.cs", "C#", 11, 0, 0, 0, 0, 10, 5, 26
"c:\Users\chris\source\repos\Cell\Cell\obj\Debug\net8.0-windows\Cell_tsoktdmy_wpftmp.GeneratedMSBuildEditorConfig.editorconfig", "Properties", 0, 0, 0, 0, 21, 0, 1, 22
"c:\Users\chris\source\repos\Cell\Cell\obj\Debug\net8.0-windows\Cell_tsoktdmy_wpftmp.GlobalUsings.g.cs", "C#", 5, 0, 0, 0, 0, 1, 1, 7
"c:\Users\chris\source\repos\Cell\Cell\obj\Debug\net8.0-windows\Cell_tsoktdmy_wpftmp.sourcelink.json", "JSON", 0, 0, 0, 1, 0, 0, 0, 1
"c:\Users\chris\source\repos\Cell\Cell\obj\Debug\net8.0-windows\Cell_tsxk0szl_wpftmp.AssemblyInfo.cs", "C#", 11, 0, 0, 0, 0, 10, 5, 26
"c:\Users\chris\source\repos\Cell\Cell\obj\Debug\net8.0-windows\Cell_tsxk0szl_wpftmp.GeneratedMSBuildEditorConfig.editorconfig", "Properties", 0, 0, 0, 0, 13, 0, 1, 14
"c:\Users\chris\source\repos\Cell\Cell\obj\Debug\net8.0-windows\Cell_tsxk0szl_wpftmp.GlobalUsings.g.cs", "C#", 5, 0, 0, 0, 0, 1, 1, 7
"c:\Users\chris\source\repos\Cell\Cell\obj\Debug\net8.0-windows\Cell_ttwt03ae_wpftmp.AssemblyInfo.cs", "C#", 11, 0, 0, 0, 0, 10, 5, 26
"c:\Users\chris\source\repos\Cell\Cell\obj\Debug\net8.0-windows\Cell_ttwt03ae_wpftmp.GeneratedMSBuildEditorConfig.editorconfig", "Properties", 0, 0, 0, 0, 21, 0, 1, 22
"c:\Users\chris\source\repos\Cell\Cell\obj\Debug\net8.0-windows\Cell_ttwt03ae_wpftmp.GlobalUsings.g.cs", "C#", 5, 0, 0, 0, 0, 1, 1, 7
"c:\Users\chris\source\repos\Cell\Cell\obj\Debug\net8.0-windows\Cell_ttwt03ae_wpftmp.sourcelink.json", "JSON", 0, 0, 0, 1, 0, 0, 0, 1
"c:\Users\chris\source\repos\Cell\Cell\obj\Debug\net8.0-windows\Cell_tu53mqqb_wpftmp.AssemblyInfo.cs", "C#", 11, 0, 0, 0, 0, 10, 5, 26
"c:\Users\chris\source\repos\Cell\Cell\obj\Debug\net8.0-windows\Cell_tu53mqqb_wpftmp.GeneratedMSBuildEditorConfig.editorconfig", "Properties", 0, 0, 0, 0, 13, 0, 1, 14
"c:\Users\chris\source\repos\Cell\Cell\obj\Debug\net8.0-windows\Cell_tu53mqqb_wpftmp.GlobalUsings.g.cs", "C#", 5, 0, 0, 0, 0, 1, 1, 7
"c:\Users\chris\source\repos\Cell\Cell\obj\Debug\net8.0-windows\Cell_tuakoq5h_wpftmp.AssemblyInfo.cs", "C#", 11, 0, 0, 0, 0, 10, 5, 26
"c:\Users\chris\source\repos\Cell\Cell\obj\Debug\net8.0-windows\Cell_tuakoq5h_wpftmp.GeneratedMSBuildEditorConfig.editorconfig", "Properties", 0, 0, 0, 0, 21, 0, 1, 22
"c:\Users\chris\source\repos\Cell\Cell\obj\Debug\net8.0-windows\Cell_tuakoq5h_wpftmp.GlobalUsings.g.cs", "C#", 5, 0, 0, 0, 0, 1, 1, 7
"c:\Users\chris\source\repos\Cell\Cell\obj\Debug\net8.0-windows\Cell_tuakoq5h_wpftmp.sourcelink.json", "JSON", 0, 0, 0, 1, 0, 0, 0, 1
"c:\Users\chris\source\repos\Cell\Cell\obj\Debug\net8.0-windows\Cell_twpkewjw_wpftmp.AssemblyInfo.cs", "C#", 11, 0, 0, 0, 0, 10, 5, 26
"c:\Users\chris\source\repos\Cell\Cell\obj\Debug\net8.0-windows\Cell_twpkewjw_wpftmp.GeneratedMSBuildEditorConfig.editorconfig", "Properties", 0, 0, 0, 0, 21, 0, 1, 22
"c:\Users\chris\source\repos\Cell\Cell\obj\Debug\net8.0-windows\Cell_twpkewjw_wpftmp.GlobalUsings.g.cs", "C#", 5, 0, 0, 0, 0, 1, 1, 7
"c:\Users\chris\source\repos\Cell\Cell\obj\Debug\net8.0-windows\Cell_twpkewjw_wpftmp.sourcelink.json", "JSON", 0, 0, 0, 1, 0, 0, 0, 1
"c:\Users\chris\source\repos\Cell\Cell\obj\Debug\net8.0-windows\Cell_tzve0qrb_wpftmp.AssemblyInfo.cs", "C#", 11, 0, 0, 0, 0, 10, 5, 26
"c:\Users\chris\source\repos\Cell\Cell\obj\Debug\net8.0-windows\Cell_tzve0qrb_wpftmp.GeneratedMSBuildEditorConfig.editorconfig", "Properties", 0, 0, 0, 0, 21, 0, 1, 22
"c:\Users\chris\source\repos\Cell\Cell\obj\Debug\net8.0-windows\Cell_tzve0qrb_wpftmp.GlobalUsings.g.cs", "C#", 5, 0, 0, 0, 0, 1, 1, 7
"c:\Users\chris\source\repos\Cell\Cell\obj\Debug\net8.0-windows\Cell_tzve0qrb_wpftmp.sourcelink.json", "JSON", 0, 0, 0, 1, 0, 0, 0, 1
"c:\Users\chris\source\repos\Cell\Cell\obj\Debug\net8.0-windows\Cell_u15x0ysh_wpftmp.AssemblyInfo.cs", "C#", 11, 0, 0, 0, 0, 10, 5, 26
"c:\Users\chris\source\repos\Cell\Cell\obj\Debug\net8.0-windows\Cell_u15x0ysh_wpftmp.GeneratedMSBuildEditorConfig.editorconfig", "Properties", 0, 0, 0, 0, 13, 0, 1, 14
"c:\Users\chris\source\repos\Cell\Cell\obj\Debug\net8.0-windows\Cell_u15x0ysh_wpftmp.GlobalUsings.g.cs", "C#", 5, 0, 0, 0, 0, 1, 1, 7
"c:\Users\chris\source\repos\Cell\Cell\obj\Debug\net8.0-windows\Cell_u1mflknn_wpftmp.AssemblyInfo.cs", "C#", 11, 0, 0, 0, 0, 10, 5, 26
"c:\Users\chris\source\repos\Cell\Cell\obj\Debug\net8.0-windows\Cell_u1mflknn_wpftmp.GeneratedMSBuildEditorConfig.editorconfig", "Properties", 0, 0, 0, 0, 21, 0, 1, 22
"c:\Users\chris\source\repos\Cell\Cell\obj\Debug\net8.0-windows\Cell_u1mflknn_wpftmp.GlobalUsings.g.cs", "C#", 5, 0, 0, 0, 0, 1, 1, 7
"c:\Users\chris\source\repos\Cell\Cell\obj\Debug\net8.0-windows\Cell_u1mflknn_wpftmp.sourcelink.json", "JSON", 0, 0, 0, 1, 0, 0, 0, 1
"c:\Users\chris\source\repos\Cell\Cell\obj\Debug\net8.0-windows\Cell_u1pjghh2_wpftmp.AssemblyInfo.cs", "C#", 11, 0, 0, 0, 0, 10, 5, 26
"c:\Users\chris\source\repos\Cell\Cell\obj\Debug\net8.0-windows\Cell_u1pjghh2_wpftmp.GeneratedMSBuildEditorConfig.editorconfig", "Properties", 0, 0, 0, 0, 21, 0, 1, 22
"c:\Users\chris\source\repos\Cell\Cell\obj\Debug\net8.0-windows\Cell_u1pjghh2_wpftmp.GlobalUsings.g.cs", "C#", 5, 0, 0, 0, 0, 1, 1, 7
"c:\Users\chris\source\repos\Cell\Cell\obj\Debug\net8.0-windows\Cell_u1pjghh2_wpftmp.sourcelink.json", "JSON", 0, 0, 0, 1, 0, 0, 0, 1
"c:\Users\chris\source\repos\Cell\Cell\obj\Debug\net8.0-windows\Cell_u53y12oi_wpftmp.AssemblyInfo.cs", "C#", 11, 0, 0, 0, 0, 10, 5, 26
"c:\Users\chris\source\repos\Cell\Cell\obj\Debug\net8.0-windows\Cell_u53y12oi_wpftmp.GeneratedMSBuildEditorConfig.editorconfig", "Properties", 0, 0, 0, 0, 21, 0, 1, 22
"c:\Users\chris\source\repos\Cell\Cell\obj\Debug\net8.0-windows\Cell_u53y12oi_wpftmp.GlobalUsings.g.cs", "C#", 5, 0, 0, 0, 0, 1, 1, 7
"c:\Users\chris\source\repos\Cell\Cell\obj\Debug\net8.0-windows\Cell_u53y12oi_wpftmp.sourcelink.json", "JSON", 0, 0, 0, 1, 0, 0, 0, 1
"c:\Users\chris\source\repos\Cell\Cell\obj\Debug\net8.0-windows\Cell_u5l3mzcl_wpftmp.AssemblyInfo.cs", "C#", 11, 0, 0, 0, 0, 10, 5, 26
"c:\Users\chris\source\repos\Cell\Cell\obj\Debug\net8.0-windows\Cell_u5l3mzcl_wpftmp.GeneratedMSBuildEditorConfig.editorconfig", "Properties", 0, 0, 0, 0, 13, 0, 1, 14
"c:\Users\chris\source\repos\Cell\Cell\obj\Debug\net8.0-windows\Cell_u5l3mzcl_wpftmp.GlobalUsings.g.cs", "C#", 5, 0, 0, 0, 0, 1, 1, 7
"c:\Users\chris\source\repos\Cell\Cell\obj\Debug\net8.0-windows\Cell_u5l52j11_wpftmp.AssemblyInfo.cs", "C#", 11, 0, 0, 0, 0, 10, 5, 26
"c:\Users\chris\source\repos\Cell\Cell\obj\Debug\net8.0-windows\Cell_u5l52j11_wpftmp.GeneratedMSBuildEditorConfig.editorconfig", "Properties", 0, 0, 0, 0, 21, 0, 1, 22
"c:\Users\chris\source\repos\Cell\Cell\obj\Debug\net8.0-windows\Cell_u5l52j11_wpftmp.GlobalUsings.g.cs", "C#", 5, 0, 0, 0, 0, 1, 1, 7
"c:\Users\chris\source\repos\Cell\Cell\obj\Debug\net8.0-windows\Cell_u5l52j11_wpftmp.sourcelink.json", "JSON", 0, 0, 0, 1, 0, 0, 0, 1
"c:\Users\chris\source\repos\Cell\Cell\obj\Debug\net8.0-windows\Cell_u5vg41rt_wpftmp.AssemblyInfo.cs", "C#", 11, 0, 0, 0, 0, 10, 5, 26
"c:\Users\chris\source\repos\Cell\Cell\obj\Debug\net8.0-windows\Cell_u5vg41rt_wpftmp.GeneratedMSBuildEditorConfig.editorconfig", "Properties", 0, 0, 0, 0, 21, 0, 1, 22
"c:\Users\chris\source\repos\Cell\Cell\obj\Debug\net8.0-windows\Cell_u5vg41rt_wpftmp.GlobalUsings.g.cs", "C#", 5, 0, 0, 0, 0, 1, 1, 7
"c:\Users\chris\source\repos\Cell\Cell\obj\Debug\net8.0-windows\Cell_u5vg41rt_wpftmp.sourcelink.json", "JSON", 0, 0, 0, 1, 0, 0, 0, 1
"c:\Users\chris\source\repos\Cell\Cell\obj\Debug\net8.0-windows\Cell_u5xslcwg_wpftmp.AssemblyInfo.cs", "C#", 11, 0, 0, 0, 0, 10, 5, 26
"c:\Users\chris\source\repos\Cell\Cell\obj\Debug\net8.0-windows\Cell_u5xslcwg_wpftmp.GeneratedMSBuildEditorConfig.editorconfig", "Properties", 0, 0, 0, 0, 13, 0, 1, 14
"c:\Users\chris\source\repos\Cell\Cell\obj\Debug\net8.0-windows\Cell_u5xslcwg_wpftmp.GlobalUsings.g.cs", "C#", 5, 0, 0, 0, 0, 1, 1, 7
"c:\Users\chris\source\repos\Cell\Cell\obj\Debug\net8.0-windows\Cell_ua43djsj_wpftmp.AssemblyInfo.cs", "C#", 11, 0, 0, 0, 0, 10, 5, 26
"c:\Users\chris\source\repos\Cell\Cell\obj\Debug\net8.0-windows\Cell_ua43djsj_wpftmp.GeneratedMSBuildEditorConfig.editorconfig", "Properties", 0, 0, 0, 0, 21, 0, 1, 22
"c:\Users\chris\source\repos\Cell\Cell\obj\Debug\net8.0-windows\Cell_ua43djsj_wpftmp.GlobalUsings.g.cs", "C#", 5, 0, 0, 0, 0, 1, 1, 7
"c:\Users\chris\source\repos\Cell\Cell\obj\Debug\net8.0-windows\Cell_ua43djsj_wpftmp.sourcelink.json", "JSON", 0, 0, 0, 1, 0, 0, 0, 1
"c:\Users\chris\source\repos\Cell\Cell\obj\Debug\net8.0-windows\Cell_ub4nxbgi_wpftmp.AssemblyInfo.cs", "C#", 11, 0, 0, 0, 0, 10, 5, 26
"c:\Users\chris\source\repos\Cell\Cell\obj\Debug\net8.0-windows\Cell_ub4nxbgi_wpftmp.GeneratedMSBuildEditorConfig.editorconfig", "Properties", 0, 0, 0, 0, 21, 0, 1, 22
"c:\Users\chris\source\repos\Cell\Cell\obj\Debug\net8.0-windows\Cell_ub4nxbgi_wpftmp.GlobalUsings.g.cs", "C#", 5, 0, 0, 0, 0, 1, 1, 7
"c:\Users\chris\source\repos\Cell\Cell\obj\Debug\net8.0-windows\Cell_ub4nxbgi_wpftmp.sourcelink.json", "JSON", 0, 0, 0, 1, 0, 0, 0, 1
"c:\Users\chris\source\repos\Cell\Cell\obj\Debug\net8.0-windows\Cell_ubacoclc_wpftmp.AssemblyInfo.cs", "C#", 11, 0, 0, 0, 0, 10, 5, 26
"c:\Users\chris\source\repos\Cell\Cell\obj\Debug\net8.0-windows\Cell_ubacoclc_wpftmp.GeneratedMSBuildEditorConfig.editorconfig", "Properties", 0, 0, 0, 0, 21, 0, 1, 22
"c:\Users\chris\source\repos\Cell\Cell\obj\Debug\net8.0-windows\Cell_ubacoclc_wpftmp.GlobalUsings.g.cs", "C#", 5, 0, 0, 0, 0, 1, 1, 7
"c:\Users\chris\source\repos\Cell\Cell\obj\Debug\net8.0-windows\Cell_ubacoclc_wpftmp.sourcelink.json", "JSON", 0, 0, 0, 1, 0, 0, 0, 1
"c:\Users\chris\source\repos\Cell\Cell\obj\Debug\net8.0-windows\Cell_ubwkaz5x_wpftmp.AssemblyInfo.cs", "C#", 11, 0, 0, 0, 0, 10, 5, 26
"c:\Users\chris\source\repos\Cell\Cell\obj\Debug\net8.0-windows\Cell_ubwkaz5x_wpftmp.GeneratedMSBuildEditorConfig.editorconfig", "Properties", 0, 0, 0, 0, 21, 0, 1, 22
"c:\Users\chris\source\repos\Cell\Cell\obj\Debug\net8.0-windows\Cell_ubwkaz5x_wpftmp.GlobalUsings.g.cs", "C#", 5, 0, 0, 0, 0, 1, 1, 7
"c:\Users\chris\source\repos\Cell\Cell\obj\Debug\net8.0-windows\Cell_ubwkaz5x_wpftmp.sourcelink.json", "JSON", 0, 0, 0, 1, 0, 0, 0, 1
"c:\Users\chris\source\repos\Cell\Cell\obj\Debug\net8.0-windows\Cell_uclj4tm5_wpftmp.AssemblyInfo.cs", "C#", 11, 0, 0, 0, 0, 10, 5, 26
"c:\Users\chris\source\repos\Cell\Cell\obj\Debug\net8.0-windows\Cell_uclj4tm5_wpftmp.GeneratedMSBuildEditorConfig.editorconfig", "Properties", 0, 0, 0, 0, 21, 0, 1, 22
"c:\Users\chris\source\repos\Cell\Cell\obj\Debug\net8.0-windows\Cell_uclj4tm5_wpftmp.GlobalUsings.g.cs", "C#", 5, 0, 0, 0, 0, 1, 1, 7
"c:\Users\chris\source\repos\Cell\Cell\obj\Debug\net8.0-windows\Cell_uclj4tm5_wpftmp.sourcelink.json", "JSON", 0, 0, 0, 1, 0, 0, 0, 1
"c:\Users\chris\source\repos\Cell\Cell\obj\Debug\net8.0-windows\Cell_ud3etwtl_wpftmp.AssemblyInfo.cs", "C#", 11, 0, 0, 0, 0, 10, 5, 26
"c:\Users\chris\source\repos\Cell\Cell\obj\Debug\net8.0-windows\Cell_ud3etwtl_wpftmp.GeneratedMSBuildEditorConfig.editorconfig", "Properties", 0, 0, 0, 0, 21, 0, 1, 22
"c:\Users\chris\source\repos\Cell\Cell\obj\Debug\net8.0-windows\Cell_ud3etwtl_wpftmp.GlobalUsings.g.cs", "C#", 5, 0, 0, 0, 0, 1, 1, 7
"c:\Users\chris\source\repos\Cell\Cell\obj\Debug\net8.0-windows\Cell_ud3etwtl_wpftmp.sourcelink.json", "JSON", 0, 0, 0, 1, 0, 0, 0, 1
"c:\Users\chris\source\repos\Cell\Cell\obj\Debug\net8.0-windows\Cell_uf4e5yvs_wpftmp.AssemblyInfo.cs", "C#", 11, 0, 0, 0, 0, 10, 5, 26
"c:\Users\chris\source\repos\Cell\Cell\obj\Debug\net8.0-windows\Cell_uf4e5yvs_wpftmp.GeneratedMSBuildEditorConfig.editorconfig", "Properties", 0, 0, 0, 0, 21, 0, 1, 22
"c:\Users\chris\source\repos\Cell\Cell\obj\Debug\net8.0-windows\Cell_uf4e5yvs_wpftmp.GlobalUsings.g.cs", "C#", 5, 0, 0, 0, 0, 1, 1, 7
"c:\Users\chris\source\repos\Cell\Cell\obj\Debug\net8.0-windows\Cell_uf4e5yvs_wpftmp.sourcelink.json", "JSON", 0, 0, 0, 1, 0, 0, 0, 1
"c:\Users\chris\source\repos\Cell\Cell\obj\Debug\net8.0-windows\Cell_ugcjedit_wpftmp.AssemblyInfo.cs", "C#", 11, 0, 0, 0, 0, 10, 5, 26
"c:\Users\chris\source\repos\Cell\Cell\obj\Debug\net8.0-windows\Cell_ugcjedit_wpftmp.GeneratedMSBuildEditorConfig.editorconfig", "Properties", 0, 0, 0, 0, 13, 0, 1, 14
"c:\Users\chris\source\repos\Cell\Cell\obj\Debug\net8.0-windows\Cell_ugcjedit_wpftmp.GlobalUsings.g.cs", "C#", 5, 0, 0, 0, 0, 1, 1, 7
"c:\Users\chris\source\repos\Cell\Cell\obj\Debug\net8.0-windows\Cell_uh22i0jc_wpftmp.AssemblyInfo.cs", "C#", 11, 0, 0, 0, 0, 10, 5, 26
"c:\Users\chris\source\repos\Cell\Cell\obj\Debug\net8.0-windows\Cell_uh22i0jc_wpftmp.GeneratedMSBuildEditorConfig.editorconfig", "Properties", 0, 0, 0, 0, 21, 0, 1, 22
"c:\Users\chris\source\repos\Cell\Cell\obj\Debug\net8.0-windows\Cell_uh22i0jc_wpftmp.GlobalUsings.g.cs", "C#", 5, 0, 0, 0, 0, 1, 1, 7
"c:\Users\chris\source\repos\Cell\Cell\obj\Debug\net8.0-windows\Cell_uh22i0jc_wpftmp.sourcelink.json", "JSON", 0, 0, 0, 1, 0, 0, 0, 1
"c:\Users\chris\source\repos\Cell\Cell\obj\Debug\net8.0-windows\Cell_uho0zgup_wpftmp.AssemblyInfo.cs", "C#", 11, 0, 0, 0, 0, 10, 5, 26
"c:\Users\chris\source\repos\Cell\Cell\obj\Debug\net8.0-windows\Cell_uho0zgup_wpftmp.GeneratedMSBuildEditorConfig.editorconfig", "Properties", 0, 0, 0, 0, 21, 0, 1, 22
"c:\Users\chris\source\repos\Cell\Cell\obj\Debug\net8.0-windows\Cell_uho0zgup_wpftmp.GlobalUsings.g.cs", "C#", 5, 0, 0, 0, 0, 1, 1, 7
"c:\Users\chris\source\repos\Cell\Cell\obj\Debug\net8.0-windows\Cell_uho0zgup_wpftmp.sourcelink.json", "JSON", 0, 0, 0, 1, 0, 0, 0, 1
"c:\Users\chris\source\repos\Cell\Cell\obj\Debug\net8.0-windows\Cell_ujncld5u_wpftmp.AssemblyInfo.cs", "C#", 11, 0, 0, 0, 0, 10, 5, 26
"c:\Users\chris\source\repos\Cell\Cell\obj\Debug\net8.0-windows\Cell_ujncld5u_wpftmp.GeneratedMSBuildEditorConfig.editorconfig", "Properties", 0, 0, 0, 0, 21, 0, 1, 22
"c:\Users\chris\source\repos\Cell\Cell\obj\Debug\net8.0-windows\Cell_ujncld5u_wpftmp.GlobalUsings.g.cs", "C#", 5, 0, 0, 0, 0, 1, 1, 7
"c:\Users\chris\source\repos\Cell\Cell\obj\Debug\net8.0-windows\Cell_ujncld5u_wpftmp.sourcelink.json", "JSON", 0, 0, 0, 1, 0, 0, 0, 1
"c:\Users\chris\source\repos\Cell\Cell\obj\Debug\net8.0-windows\Cell_ukyxasew_wpftmp.AssemblyInfo.cs", "C#", 11, 0, 0, 0, 0, 10, 5, 26
"c:\Users\chris\source\repos\Cell\Cell\obj\Debug\net8.0-windows\Cell_ukyxasew_wpftmp.GeneratedMSBuildEditorConfig.editorconfig", "Properties", 0, 0, 0, 0, 21, 0, 1, 22
"c:\Users\chris\source\repos\Cell\Cell\obj\Debug\net8.0-windows\Cell_ukyxasew_wpftmp.GlobalUsings.g.cs", "C#", 5, 0, 0, 0, 0, 1, 1, 7
"c:\Users\chris\source\repos\Cell\Cell\obj\Debug\net8.0-windows\Cell_ukyxasew_wpftmp.sourcelink.json", "JSON", 0, 0, 0, 1, 0, 0, 0, 1
"c:\Users\chris\source\repos\Cell\Cell\obj\Debug\net8.0-windows\Cell_ulwwwdqc_wpftmp.AssemblyInfo.cs", "C#", 11, 0, 0, 0, 0, 10, 5, 26
"c:\Users\chris\source\repos\Cell\Cell\obj\Debug\net8.0-windows\Cell_ulwwwdqc_wpftmp.GeneratedMSBuildEditorConfig.editorconfig", "Properties", 0, 0, 0, 0, 21, 0, 1, 22
"c:\Users\chris\source\repos\Cell\Cell\obj\Debug\net8.0-windows\Cell_ulwwwdqc_wpftmp.GlobalUsings.g.cs", "C#", 5, 0, 0, 0, 0, 1, 1, 7
"c:\Users\chris\source\repos\Cell\Cell\obj\Debug\net8.0-windows\Cell_ulwwwdqc_wpftmp.sourcelink.json", "JSON", 0, 0, 0, 1, 0, 0, 0, 1
"c:\Users\chris\source\repos\Cell\Cell\obj\Debug\net8.0-windows\Cell_umxphsax_wpftmp.AssemblyInfo.cs", "C#", 11, 0, 0, 0, 0, 10, 5, 26
"c:\Users\chris\source\repos\Cell\Cell\obj\Debug\net8.0-windows\Cell_umxphsax_wpftmp.GeneratedMSBuildEditorConfig.editorconfig", "Properties", 0, 0, 0, 0, 21, 0, 1, 22
"c:\Users\chris\source\repos\Cell\Cell\obj\Debug\net8.0-windows\Cell_umxphsax_wpftmp.GlobalUsings.g.cs", "C#", 5, 0, 0, 0, 0, 1, 1, 7
"c:\Users\chris\source\repos\Cell\Cell\obj\Debug\net8.0-windows\Cell_umxphsax_wpftmp.sourcelink.json", "JSON", 0, 0, 0, 1, 0, 0, 0, 1
"c:\Users\chris\source\repos\Cell\Cell\obj\Debug\net8.0-windows\Cell_uncqlcup_wpftmp.AssemblyInfo.cs", "C#", 11, 0, 0, 0, 0, 10, 5, 26
"c:\Users\chris\source\repos\Cell\Cell\obj\Debug\net8.0-windows\Cell_uncqlcup_wpftmp.GeneratedMSBuildEditorConfig.editorconfig", "Properties", 0, 0, 0, 0, 21, 0, 1, 22
"c:\Users\chris\source\repos\Cell\Cell\obj\Debug\net8.0-windows\Cell_uncqlcup_wpftmp.GlobalUsings.g.cs", "C#", 5, 0, 0, 0, 0, 1, 1, 7
"c:\Users\chris\source\repos\Cell\Cell\obj\Debug\net8.0-windows\Cell_uncqlcup_wpftmp.sourcelink.json", "JSON", 0, 0, 0, 1, 0, 0, 0, 1
"c:\Users\chris\source\repos\Cell\Cell\obj\Debug\net8.0-windows\Cell_uo1nfixo_wpftmp.AssemblyInfo.cs", "C#", 11, 0, 0, 0, 0, 10, 5, 26
"c:\Users\chris\source\repos\Cell\Cell\obj\Debug\net8.0-windows\Cell_uo1nfixo_wpftmp.GeneratedMSBuildEditorConfig.editorconfig", "Properties", 0, 0, 0, 0, 21, 0, 1, 22
"c:\Users\chris\source\repos\Cell\Cell\obj\Debug\net8.0-windows\Cell_uo1nfixo_wpftmp.GlobalUsings.g.cs", "C#", 5, 0, 0, 0, 0, 1, 1, 7
"c:\Users\chris\source\repos\Cell\Cell\obj\Debug\net8.0-windows\Cell_uo1nfixo_wpftmp.sourcelink.json", "JSON", 0, 0, 0, 1, 0, 0, 0, 1
"c:\Users\chris\source\repos\Cell\Cell\obj\Debug\net8.0-windows\Cell_uofghery_wpftmp.AssemblyInfo.cs", "C#", 11, 0, 0, 0, 0, 10, 5, 26
"c:\Users\chris\source\repos\Cell\Cell\obj\Debug\net8.0-windows\Cell_uofghery_wpftmp.GeneratedMSBuildEditorConfig.editorconfig", "Properties", 0, 0, 0, 0, 21, 0, 1, 22
"c:\Users\chris\source\repos\Cell\Cell\obj\Debug\net8.0-windows\Cell_uofghery_wpftmp.GlobalUsings.g.cs", "C#", 5, 0, 0, 0, 0, 1, 1, 7
"c:\Users\chris\source\repos\Cell\Cell\obj\Debug\net8.0-windows\Cell_uofghery_wpftmp.sourcelink.json", "JSON", 0, 0, 0, 1, 0, 0, 0, 1
"c:\Users\chris\source\repos\Cell\Cell\obj\Debug\net8.0-windows\Cell_uplqnujs_wpftmp.AssemblyInfo.cs", "C#", 11, 0, 0, 0, 0, 10, 5, 26
"c:\Users\chris\source\repos\Cell\Cell\obj\Debug\net8.0-windows\Cell_uplqnujs_wpftmp.GeneratedMSBuildEditorConfig.editorconfig", "Properties", 0, 0, 0, 0, 21, 0, 1, 22
"c:\Users\chris\source\repos\Cell\Cell\obj\Debug\net8.0-windows\Cell_uplqnujs_wpftmp.GlobalUsings.g.cs", "C#", 5, 0, 0, 0, 0, 1, 1, 7
"c:\Users\chris\source\repos\Cell\Cell\obj\Debug\net8.0-windows\Cell_uplqnujs_wpftmp.sourcelink.json", "JSON", 0, 0, 0, 1, 0, 0, 0, 1
"c:\Users\chris\source\repos\Cell\Cell\obj\Debug\net8.0-windows\Cell_upoi30au_wpftmp.AssemblyInfo.cs", "C#", 11, 0, 0, 0, 0, 10, 5, 26
"c:\Users\chris\source\repos\Cell\Cell\obj\Debug\net8.0-windows\Cell_upoi30au_wpftmp.GeneratedMSBuildEditorConfig.editorconfig", "Properties", 0, 0, 0, 0, 21, 0, 1, 22
"c:\Users\chris\source\repos\Cell\Cell\obj\Debug\net8.0-windows\Cell_upoi30au_wpftmp.GlobalUsings.g.cs", "C#", 5, 0, 0, 0, 0, 1, 1, 7
"c:\Users\chris\source\repos\Cell\Cell\obj\Debug\net8.0-windows\Cell_upoi30au_wpftmp.sourcelink.json", "JSON", 0, 0, 0, 1, 0, 0, 0, 1
"c:\Users\chris\source\repos\Cell\Cell\obj\Debug\net8.0-windows\Cell_ur4pk3m0_wpftmp.AssemblyInfo.cs", "C#", 11, 0, 0, 0, 0, 10, 5, 26
"c:\Users\chris\source\repos\Cell\Cell\obj\Debug\net8.0-windows\Cell_ur4pk3m0_wpftmp.GeneratedMSBuildEditorConfig.editorconfig", "Properties", 0, 0, 0, 0, 13, 0, 1, 14
"c:\Users\chris\source\repos\Cell\Cell\obj\Debug\net8.0-windows\Cell_ur4pk3m0_wpftmp.GlobalUsings.g.cs", "C#", 5, 0, 0, 0, 0, 1, 1, 7
"c:\Users\chris\source\repos\Cell\Cell\obj\Debug\net8.0-windows\Cell_utoghr4h_wpftmp.AssemblyInfo.cs", "C#", 11, 0, 0, 0, 0, 10, 5, 26
"c:\Users\chris\source\repos\Cell\Cell\obj\Debug\net8.0-windows\Cell_utoghr4h_wpftmp.GeneratedMSBuildEditorConfig.editorconfig", "Properties", 0, 0, 0, 0, 21, 0, 1, 22
"c:\Users\chris\source\repos\Cell\Cell\obj\Debug\net8.0-windows\Cell_utoghr4h_wpftmp.GlobalUsings.g.cs", "C#", 5, 0, 0, 0, 0, 1, 1, 7
"c:\Users\chris\source\repos\Cell\Cell\obj\Debug\net8.0-windows\Cell_utoghr4h_wpftmp.sourcelink.json", "JSON", 0, 0, 0, 1, 0, 0, 0, 1
"c:\Users\chris\source\repos\Cell\Cell\obj\Debug\net8.0-windows\Cell_uu0r3maj_wpftmp.AssemblyInfo.cs", "C#", 11, 0, 0, 0, 0, 10, 5, 26
"c:\Users\chris\source\repos\Cell\Cell\obj\Debug\net8.0-windows\Cell_uu0r3maj_wpftmp.GeneratedMSBuildEditorConfig.editorconfig", "Properties", 0, 0, 0, 0, 21, 0, 1, 22
"c:\Users\chris\source\repos\Cell\Cell\obj\Debug\net8.0-windows\Cell_uu0r3maj_wpftmp.GlobalUsings.g.cs", "C#", 5, 0, 0, 0, 0, 1, 1, 7
"c:\Users\chris\source\repos\Cell\Cell\obj\Debug\net8.0-windows\Cell_uu0r3maj_wpftmp.sourcelink.json", "JSON", 0, 0, 0, 1, 0, 0, 0, 1
"c:\Users\chris\source\repos\Cell\Cell\obj\Debug\net8.0-windows\Cell_uvqxs3a3_wpftmp.AssemblyInfo.cs", "C#", 11, 0, 0, 0, 0, 10, 5, 26
"c:\Users\chris\source\repos\Cell\Cell\obj\Debug\net8.0-windows\Cell_uvqxs3a3_wpftmp.GeneratedMSBuildEditorConfig.editorconfig", "Properties", 0, 0, 0, 0, 21, 0, 1, 22
"c:\Users\chris\source\repos\Cell\Cell\obj\Debug\net8.0-windows\Cell_uvqxs3a3_wpftmp.GlobalUsings.g.cs", "C#", 5, 0, 0, 0, 0, 1, 1, 7
"c:\Users\chris\source\repos\Cell\Cell\obj\Debug\net8.0-windows\Cell_uvqxs3a3_wpftmp.sourcelink.json", "JSON", 0, 0, 0, 1, 0, 0, 0, 1
"c:\Users\chris\source\repos\Cell\Cell\obj\Debug\net8.0-windows\Cell_uxap2upn_wpftmp.AssemblyInfo.cs", "C#", 11, 0, 0, 0, 0, 10, 5, 26
"c:\Users\chris\source\repos\Cell\Cell\obj\Debug\net8.0-windows\Cell_uxap2upn_wpftmp.GeneratedMSBuildEditorConfig.editorconfig", "Properties", 0, 0, 0, 0, 13, 0, 1, 14
"c:\Users\chris\source\repos\Cell\Cell\obj\Debug\net8.0-windows\Cell_uxap2upn_wpftmp.GlobalUsings.g.cs", "C#", 5, 0, 0, 0, 0, 1, 1, 7
"c:\Users\chris\source\repos\Cell\Cell\obj\Debug\net8.0-windows\Cell_uxgp1w0q_wpftmp.AssemblyInfo.cs", "C#", 11, 0, 0, 0, 0, 10, 5, 26
"c:\Users\chris\source\repos\Cell\Cell\obj\Debug\net8.0-windows\Cell_uxgp1w0q_wpftmp.GeneratedMSBuildEditorConfig.editorconfig", "Properties", 0, 0, 0, 0, 21, 0, 1, 22
"c:\Users\chris\source\repos\Cell\Cell\obj\Debug\net8.0-windows\Cell_uxgp1w0q_wpftmp.GlobalUsings.g.cs", "C#", 5, 0, 0, 0, 0, 1, 1, 7
"c:\Users\chris\source\repos\Cell\Cell\obj\Debug\net8.0-windows\Cell_uxgp1w0q_wpftmp.sourcelink.json", "JSON", 0, 0, 0, 1, 0, 0, 0, 1
"c:\Users\chris\source\repos\Cell\Cell\obj\Debug\net8.0-windows\Cell_uxv2gfyl_wpftmp.AssemblyInfo.cs", "C#", 11, 0, 0, 0, 0, 10, 5, 26
"c:\Users\chris\source\repos\Cell\Cell\obj\Debug\net8.0-windows\Cell_uxv2gfyl_wpftmp.GeneratedMSBuildEditorConfig.editorconfig", "Properties", 0, 0, 0, 0, 21, 0, 1, 22
"c:\Users\chris\source\repos\Cell\Cell\obj\Debug\net8.0-windows\Cell_uxv2gfyl_wpftmp.GlobalUsings.g.cs", "C#", 5, 0, 0, 0, 0, 1, 1, 7
"c:\Users\chris\source\repos\Cell\Cell\obj\Debug\net8.0-windows\Cell_uxv2gfyl_wpftmp.sourcelink.json", "JSON", 0, 0, 0, 1, 0, 0, 0, 1
"c:\Users\chris\source\repos\Cell\Cell\obj\Debug\net8.0-windows\Cell_uzlyw4tx_wpftmp.AssemblyInfo.cs", "C#", 11, 0, 0, 0, 0, 10, 5, 26
"c:\Users\chris\source\repos\Cell\Cell\obj\Debug\net8.0-windows\Cell_uzlyw4tx_wpftmp.GeneratedMSBuildEditorConfig.editorconfig", "Properties", 0, 0, 0, 0, 21, 0, 1, 22
"c:\Users\chris\source\repos\Cell\Cell\obj\Debug\net8.0-windows\Cell_uzlyw4tx_wpftmp.GlobalUsings.g.cs", "C#", 5, 0, 0, 0, 0, 1, 1, 7
"c:\Users\chris\source\repos\Cell\Cell\obj\Debug\net8.0-windows\Cell_uzlyw4tx_wpftmp.sourcelink.json", "JSON", 0, 0, 0, 1, 0, 0, 0, 1
"c:\Users\chris\source\repos\Cell\Cell\obj\Debug\net8.0-windows\Cell_v1b50uua_wpftmp.AssemblyInfo.cs", "C#", 11, 0, 0, 0, 0, 10, 5, 26
"c:\Users\chris\source\repos\Cell\Cell\obj\Debug\net8.0-windows\Cell_v1b50uua_wpftmp.GeneratedMSBuildEditorConfig.editorconfig", "Properties", 0, 0, 0, 0, 21, 0, 1, 22
"c:\Users\chris\source\repos\Cell\Cell\obj\Debug\net8.0-windows\Cell_v1b50uua_wpftmp.GlobalUsings.g.cs", "C#", 5, 0, 0, 0, 0, 1, 1, 7
"c:\Users\chris\source\repos\Cell\Cell\obj\Debug\net8.0-windows\Cell_v1b50uua_wpftmp.sourcelink.json", "JSON", 0, 0, 0, 1, 0, 0, 0, 1
"c:\Users\chris\source\repos\Cell\Cell\obj\Debug\net8.0-windows\Cell_v1urp2pa_wpftmp.AssemblyInfo.cs", "C#", 11, 0, 0, 0, 0, 10, 5, 26
"c:\Users\chris\source\repos\Cell\Cell\obj\Debug\net8.0-windows\Cell_v1urp2pa_wpftmp.GeneratedMSBuildEditorConfig.editorconfig", "Properties", 0, 0, 0, 0, 21, 0, 1, 22
"c:\Users\chris\source\repos\Cell\Cell\obj\Debug\net8.0-windows\Cell_v1urp2pa_wpftmp.GlobalUsings.g.cs", "C#", 5, 0, 0, 0, 0, 1, 1, 7
"c:\Users\chris\source\repos\Cell\Cell\obj\Debug\net8.0-windows\Cell_v1urp2pa_wpftmp.sourcelink.json", "JSON", 0, 0, 0, 1, 0, 0, 0, 1
"c:\Users\chris\source\repos\Cell\Cell\obj\Debug\net8.0-windows\Cell_v3g4vkqv_wpftmp.AssemblyInfo.cs", "C#", 11, 0, 0, 0, 0, 10, 5, 26
"c:\Users\chris\source\repos\Cell\Cell\obj\Debug\net8.0-windows\Cell_v3g4vkqv_wpftmp.GeneratedMSBuildEditorConfig.editorconfig", "Properties", 0, 0, 0, 0, 21, 0, 1, 22
"c:\Users\chris\source\repos\Cell\Cell\obj\Debug\net8.0-windows\Cell_v3g4vkqv_wpftmp.GlobalUsings.g.cs", "C#", 5, 0, 0, 0, 0, 1, 1, 7
"c:\Users\chris\source\repos\Cell\Cell\obj\Debug\net8.0-windows\Cell_v3g4vkqv_wpftmp.sourcelink.json", "JSON", 0, 0, 0, 1, 0, 0, 0, 1
"c:\Users\chris\source\repos\Cell\Cell\obj\Debug\net8.0-windows\Cell_v4mvz5t5_wpftmp.AssemblyInfo.cs", "C#", 11, 0, 0, 0, 0, 10, 5, 26
"c:\Users\chris\source\repos\Cell\Cell\obj\Debug\net8.0-windows\Cell_v4mvz5t5_wpftmp.GeneratedMSBuildEditorConfig.editorconfig", "Properties", 0, 0, 0, 0, 21, 0, 1, 22
"c:\Users\chris\source\repos\Cell\Cell\obj\Debug\net8.0-windows\Cell_v4mvz5t5_wpftmp.GlobalUsings.g.cs", "C#", 5, 0, 0, 0, 0, 1, 1, 7
"c:\Users\chris\source\repos\Cell\Cell\obj\Debug\net8.0-windows\Cell_v4mvz5t5_wpftmp.sourcelink.json", "JSON", 0, 0, 0, 1, 0, 0, 0, 1
"c:\Users\chris\source\repos\Cell\Cell\obj\Debug\net8.0-windows\Cell_v4ph1jbi_wpftmp.AssemblyInfo.cs", "C#", 11, 0, 0, 0, 0, 10, 5, 26
"c:\Users\chris\source\repos\Cell\Cell\obj\Debug\net8.0-windows\Cell_v4ph1jbi_wpftmp.GeneratedMSBuildEditorConfig.editorconfig", "Properties", 0, 0, 0, 0, 21, 0, 1, 22
"c:\Users\chris\source\repos\Cell\Cell\obj\Debug\net8.0-windows\Cell_v4ph1jbi_wpftmp.GlobalUsings.g.cs", "C#", 5, 0, 0, 0, 0, 1, 1, 7
"c:\Users\chris\source\repos\Cell\Cell\obj\Debug\net8.0-windows\Cell_v4ph1jbi_wpftmp.sourcelink.json", "JSON", 0, 0, 0, 1, 0, 0, 0, 1
"c:\Users\chris\source\repos\Cell\Cell\obj\Debug\net8.0-windows\Cell_v5jnfz2g_wpftmp.AssemblyInfo.cs", "C#", 11, 0, 0, 0, 0, 10, 5, 26
"c:\Users\chris\source\repos\Cell\Cell\obj\Debug\net8.0-windows\Cell_v5jnfz2g_wpftmp.GeneratedMSBuildEditorConfig.editorconfig", "Properties", 0, 0, 0, 0, 13, 0, 1, 14
"c:\Users\chris\source\repos\Cell\Cell\obj\Debug\net8.0-windows\Cell_v5jnfz2g_wpftmp.GlobalUsings.g.cs", "C#", 5, 0, 0, 0, 0, 1, 1, 7
"c:\Users\chris\source\repos\Cell\Cell\obj\Debug\net8.0-windows\Cell_vbajuwe0_wpftmp.AssemblyInfo.cs", "C#", 11, 0, 0, 0, 0, 10, 5, 26
"c:\Users\chris\source\repos\Cell\Cell\obj\Debug\net8.0-windows\Cell_vbajuwe0_wpftmp.GeneratedMSBuildEditorConfig.editorconfig", "Properties", 0, 0, 0, 0, 21, 0, 1, 22
"c:\Users\chris\source\repos\Cell\Cell\obj\Debug\net8.0-windows\Cell_vbajuwe0_wpftmp.GlobalUsings.g.cs", "C#", 5, 0, 0, 0, 0, 1, 1, 7
"c:\Users\chris\source\repos\Cell\Cell\obj\Debug\net8.0-windows\Cell_vbajuwe0_wpftmp.sourcelink.json", "JSON", 0, 0, 0, 1, 0, 0, 0, 1
"c:\Users\chris\source\repos\Cell\Cell\obj\Debug\net8.0-windows\Cell_vbd02dc0_wpftmp.AssemblyInfo.cs", "C#", 11, 0, 0, 0, 0, 10, 5, 26
"c:\Users\chris\source\repos\Cell\Cell\obj\Debug\net8.0-windows\Cell_vbd02dc0_wpftmp.GeneratedMSBuildEditorConfig.editorconfig", "Properties", 0, 0, 0, 0, 21, 0, 1, 22
"c:\Users\chris\source\repos\Cell\Cell\obj\Debug\net8.0-windows\Cell_vbd02dc0_wpftmp.GlobalUsings.g.cs", "C#", 5, 0, 0, 0, 0, 1, 1, 7
"c:\Users\chris\source\repos\Cell\Cell\obj\Debug\net8.0-windows\Cell_vbd02dc0_wpftmp.sourcelink.json", "JSON", 0, 0, 0, 1, 0, 0, 0, 1
"c:\Users\chris\source\repos\Cell\Cell\obj\Debug\net8.0-windows\Cell_vbilmbj5_wpftmp.AssemblyInfo.cs", "C#", 11, 0, 0, 0, 0, 10, 5, 26
"c:\Users\chris\source\repos\Cell\Cell\obj\Debug\net8.0-windows\Cell_vbilmbj5_wpftmp.GeneratedMSBuildEditorConfig.editorconfig", "Properties", 0, 0, 0, 0, 21, 0, 1, 22
"c:\Users\chris\source\repos\Cell\Cell\obj\Debug\net8.0-windows\Cell_vbilmbj5_wpftmp.GlobalUsings.g.cs", "C#", 5, 0, 0, 0, 0, 1, 1, 7
"c:\Users\chris\source\repos\Cell\Cell\obj\Debug\net8.0-windows\Cell_vbilmbj5_wpftmp.sourcelink.json", "JSON", 0, 0, 0, 1, 0, 0, 0, 1
"c:\Users\chris\source\repos\Cell\Cell\obj\Debug\net8.0-windows\Cell_vbugu1bi_wpftmp.AssemblyInfo.cs", "C#", 11, 0, 0, 0, 0, 10, 5, 26
"c:\Users\chris\source\repos\Cell\Cell\obj\Debug\net8.0-windows\Cell_vbugu1bi_wpftmp.GeneratedMSBuildEditorConfig.editorconfig", "Properties", 0, 0, 0, 0, 21, 0, 1, 22
"c:\Users\chris\source\repos\Cell\Cell\obj\Debug\net8.0-windows\Cell_vbugu1bi_wpftmp.GlobalUsings.g.cs", "C#", 5, 0, 0, 0, 0, 1, 1, 7
"c:\Users\chris\source\repos\Cell\Cell\obj\Debug\net8.0-windows\Cell_vbugu1bi_wpftmp.sourcelink.json", "JSON", 0, 0, 0, 1, 0, 0, 0, 1
"c:\Users\chris\source\repos\Cell\Cell\obj\Debug\net8.0-windows\Cell_vcwrg5wv_wpftmp.AssemblyInfo.cs", "C#", 11, 0, 0, 0, 0, 10, 5, 26
"c:\Users\chris\source\repos\Cell\Cell\obj\Debug\net8.0-windows\Cell_vcwrg5wv_wpftmp.GeneratedMSBuildEditorConfig.editorconfig", "Properties", 0, 0, 0, 0, 21, 0, 1, 22
"c:\Users\chris\source\repos\Cell\Cell\obj\Debug\net8.0-windows\Cell_vcwrg5wv_wpftmp.GlobalUsings.g.cs", "C#", 5, 0, 0, 0, 0, 1, 1, 7
"c:\Users\chris\source\repos\Cell\Cell\obj\Debug\net8.0-windows\Cell_vcwrg5wv_wpftmp.sourcelink.json", "JSON", 0, 0, 0, 1, 0, 0, 0, 1
"c:\Users\chris\source\repos\Cell\Cell\obj\Debug\net8.0-windows\Cell_veycfsgq_wpftmp.AssemblyInfo.cs", "C#", 11, 0, 0, 0, 0, 10, 5, 26
"c:\Users\chris\source\repos\Cell\Cell\obj\Debug\net8.0-windows\Cell_veycfsgq_wpftmp.GeneratedMSBuildEditorConfig.editorconfig", "Properties", 0, 0, 0, 0, 21, 0, 1, 22
"c:\Users\chris\source\repos\Cell\Cell\obj\Debug\net8.0-windows\Cell_veycfsgq_wpftmp.GlobalUsings.g.cs", "C#", 5, 0, 0, 0, 0, 1, 1, 7
"c:\Users\chris\source\repos\Cell\Cell\obj\Debug\net8.0-windows\Cell_veycfsgq_wpftmp.sourcelink.json", "JSON", 0, 0, 0, 1, 0, 0, 0, 1
"c:\Users\chris\source\repos\Cell\Cell\obj\Debug\net8.0-windows\Cell_vil5l04y_wpftmp.AssemblyInfo.cs", "C#", 11, 0, 0, 0, 0, 10, 5, 26
"c:\Users\chris\source\repos\Cell\Cell\obj\Debug\net8.0-windows\Cell_vil5l04y_wpftmp.GeneratedMSBuildEditorConfig.editorconfig", "Properties", 0, 0, 0, 0, 21, 0, 1, 22
"c:\Users\chris\source\repos\Cell\Cell\obj\Debug\net8.0-windows\Cell_vil5l04y_wpftmp.GlobalUsings.g.cs", "C#", 5, 0, 0, 0, 0, 1, 1, 7
"c:\Users\chris\source\repos\Cell\Cell\obj\Debug\net8.0-windows\Cell_vil5l04y_wpftmp.sourcelink.json", "JSON", 0, 0, 0, 1, 0, 0, 0, 1
"c:\Users\chris\source\repos\Cell\Cell\obj\Debug\net8.0-windows\Cell_vkqg0phf_wpftmp.AssemblyInfo.cs", "C#", 11, 0, 0, 0, 0, 10, 5, 26
"c:\Users\chris\source\repos\Cell\Cell\obj\Debug\net8.0-windows\Cell_vkqg0phf_wpftmp.GeneratedMSBuildEditorConfig.editorconfig", "Properties", 0, 0, 0, 0, 21, 0, 1, 22
"c:\Users\chris\source\repos\Cell\Cell\obj\Debug\net8.0-windows\Cell_vkqg0phf_wpftmp.GlobalUsings.g.cs", "C#", 5, 0, 0, 0, 0, 1, 1, 7
"c:\Users\chris\source\repos\Cell\Cell\obj\Debug\net8.0-windows\Cell_vkqg0phf_wpftmp.sourcelink.json", "JSON", 0, 0, 0, 1, 0, 0, 0, 1
"c:\Users\chris\source\repos\Cell\Cell\obj\Debug\net8.0-windows\Cell_vmiz3q4r_wpftmp.AssemblyInfo.cs", "C#", 11, 0, 0, 0, 0, 10, 5, 26
"c:\Users\chris\source\repos\Cell\Cell\obj\Debug\net8.0-windows\Cell_vmiz3q4r_wpftmp.GeneratedMSBuildEditorConfig.editorconfig", "Properties", 0, 0, 0, 0, 21, 0, 1, 22
"c:\Users\chris\source\repos\Cell\Cell\obj\Debug\net8.0-windows\Cell_vmiz3q4r_wpftmp.GlobalUsings.g.cs", "C#", 5, 0, 0, 0, 0, 1, 1, 7
"c:\Users\chris\source\repos\Cell\Cell\obj\Debug\net8.0-windows\Cell_vmiz3q4r_wpftmp.sourcelink.json", "JSON", 0, 0, 0, 1, 0, 0, 0, 1
"c:\Users\chris\source\repos\Cell\Cell\obj\Debug\net8.0-windows\Cell_vmjnqz3w_wpftmp.AssemblyInfo.cs", "C#", 11, 0, 0, 0, 0, 10, 5, 26
"c:\Users\chris\source\repos\Cell\Cell\obj\Debug\net8.0-windows\Cell_vmjnqz3w_wpftmp.GeneratedMSBuildEditorConfig.editorconfig", "Properties", 0, 0, 0, 0, 21, 0, 1, 22
"c:\Users\chris\source\repos\Cell\Cell\obj\Debug\net8.0-windows\Cell_vmjnqz3w_wpftmp.GlobalUsings.g.cs", "C#", 5, 0, 0, 0, 0, 1, 1, 7
"c:\Users\chris\source\repos\Cell\Cell\obj\Debug\net8.0-windows\Cell_vmjnqz3w_wpftmp.sourcelink.json", "JSON", 0, 0, 0, 1, 0, 0, 0, 1
"c:\Users\chris\source\repos\Cell\Cell\obj\Debug\net8.0-windows\Cell_vmsrwnyp_wpftmp.AssemblyInfo.cs", "C#", 11, 0, 0, 0, 0, 10, 5, 26
"c:\Users\chris\source\repos\Cell\Cell\obj\Debug\net8.0-windows\Cell_vmsrwnyp_wpftmp.GeneratedMSBuildEditorConfig.editorconfig", "Properties", 0, 0, 0, 0, 21, 0, 1, 22
"c:\Users\chris\source\repos\Cell\Cell\obj\Debug\net8.0-windows\Cell_vmsrwnyp_wpftmp.GlobalUsings.g.cs", "C#", 5, 0, 0, 0, 0, 1, 1, 7
"c:\Users\chris\source\repos\Cell\Cell\obj\Debug\net8.0-windows\Cell_vmsrwnyp_wpftmp.sourcelink.json", "JSON", 0, 0, 0, 1, 0, 0, 0, 1
"c:\Users\chris\source\repos\Cell\Cell\obj\Debug\net8.0-windows\Cell_vmzjo53b_wpftmp.AssemblyInfo.cs", "C#", 11, 0, 0, 0, 0, 10, 5, 26
"c:\Users\chris\source\repos\Cell\Cell\obj\Debug\net8.0-windows\Cell_vmzjo53b_wpftmp.GeneratedMSBuildEditorConfig.editorconfig", "Properties", 0, 0, 0, 0, 21, 0, 1, 22
"c:\Users\chris\source\repos\Cell\Cell\obj\Debug\net8.0-windows\Cell_vmzjo53b_wpftmp.GlobalUsings.g.cs", "C#", 5, 0, 0, 0, 0, 1, 1, 7
"c:\Users\chris\source\repos\Cell\Cell\obj\Debug\net8.0-windows\Cell_vmzjo53b_wpftmp.sourcelink.json", "JSON", 0, 0, 0, 1, 0, 0, 0, 1
"c:\Users\chris\source\repos\Cell\Cell\obj\Debug\net8.0-windows\Cell_vnd5anua_wpftmp.AssemblyInfo.cs", "C#", 11, 0, 0, 0, 0, 10, 5, 26
"c:\Users\chris\source\repos\Cell\Cell\obj\Debug\net8.0-windows\Cell_vnd5anua_wpftmp.GeneratedMSBuildEditorConfig.editorconfig", "Properties", 0, 0, 0, 0, 21, 0, 1, 22
"c:\Users\chris\source\repos\Cell\Cell\obj\Debug\net8.0-windows\Cell_vnd5anua_wpftmp.GlobalUsings.g.cs", "C#", 5, 0, 0, 0, 0, 1, 1, 7
"c:\Users\chris\source\repos\Cell\Cell\obj\Debug\net8.0-windows\Cell_vnd5anua_wpftmp.sourcelink.json", "JSON", 0, 0, 0, 1, 0, 0, 0, 1
"c:\Users\chris\source\repos\Cell\Cell\obj\Debug\net8.0-windows\Cell_vp11mqkq_wpftmp.AssemblyInfo.cs", "C#", 11, 0, 0, 0, 0, 10, 5, 26
"c:\Users\chris\source\repos\Cell\Cell\obj\Debug\net8.0-windows\Cell_vp11mqkq_wpftmp.GeneratedMSBuildEditorConfig.editorconfig", "Properties", 0, 0, 0, 0, 21, 0, 1, 22
"c:\Users\chris\source\repos\Cell\Cell\obj\Debug\net8.0-windows\Cell_vp11mqkq_wpftmp.GlobalUsings.g.cs", "C#", 5, 0, 0, 0, 0, 1, 1, 7
"c:\Users\chris\source\repos\Cell\Cell\obj\Debug\net8.0-windows\Cell_vp11mqkq_wpftmp.sourcelink.json", "JSON", 0, 0, 0, 1, 0, 0, 0, 1
"c:\Users\chris\source\repos\Cell\Cell\obj\Debug\net8.0-windows\Cell_vpidlmv1_wpftmp.AssemblyInfo.cs", "C#", 11, 0, 0, 0, 0, 10, 5, 26
"c:\Users\chris\source\repos\Cell\Cell\obj\Debug\net8.0-windows\Cell_vpidlmv1_wpftmp.GeneratedMSBuildEditorConfig.editorconfig", "Properties", 0, 0, 0, 0, 21, 0, 1, 22
"c:\Users\chris\source\repos\Cell\Cell\obj\Debug\net8.0-windows\Cell_vpidlmv1_wpftmp.GlobalUsings.g.cs", "C#", 5, 0, 0, 0, 0, 1, 1, 7
"c:\Users\chris\source\repos\Cell\Cell\obj\Debug\net8.0-windows\Cell_vpidlmv1_wpftmp.sourcelink.json", "JSON", 0, 0, 0, 1, 0, 0, 0, 1
"c:\Users\chris\source\repos\Cell\Cell\obj\Debug\net8.0-windows\Cell_vpri4xoj_wpftmp.AssemblyInfo.cs", "C#", 11, 0, 0, 0, 0, 10, 5, 26
"c:\Users\chris\source\repos\Cell\Cell\obj\Debug\net8.0-windows\Cell_vpri4xoj_wpftmp.GeneratedMSBuildEditorConfig.editorconfig", "Properties", 0, 0, 0, 0, 21, 0, 1, 22
"c:\Users\chris\source\repos\Cell\Cell\obj\Debug\net8.0-windows\Cell_vpri4xoj_wpftmp.GlobalUsings.g.cs", "C#", 5, 0, 0, 0, 0, 1, 1, 7
"c:\Users\chris\source\repos\Cell\Cell\obj\Debug\net8.0-windows\Cell_vpri4xoj_wpftmp.sourcelink.json", "JSON", 0, 0, 0, 1, 0, 0, 0, 1
"c:\Users\chris\source\repos\Cell\Cell\obj\Debug\net8.0-windows\Cell_vq1mis4e_wpftmp.AssemblyInfo.cs", "C#", 11, 0, 0, 0, 0, 10, 5, 26
"c:\Users\chris\source\repos\Cell\Cell\obj\Debug\net8.0-windows\Cell_vq1mis4e_wpftmp.GeneratedMSBuildEditorConfig.editorconfig", "Properties", 0, 0, 0, 0, 13, 0, 1, 14
"c:\Users\chris\source\repos\Cell\Cell\obj\Debug\net8.0-windows\Cell_vq1mis4e_wpftmp.GlobalUsings.g.cs", "C#", 5, 0, 0, 0, 0, 1, 1, 7
"c:\Users\chris\source\repos\Cell\Cell\obj\Debug\net8.0-windows\Cell_vqlq5xxk_wpftmp.AssemblyInfo.cs", "C#", 11, 0, 0, 0, 0, 10, 5, 26
"c:\Users\chris\source\repos\Cell\Cell\obj\Debug\net8.0-windows\Cell_vqlq5xxk_wpftmp.GeneratedMSBuildEditorConfig.editorconfig", "Properties", 0, 0, 0, 0, 21, 0, 1, 22
"c:\Users\chris\source\repos\Cell\Cell\obj\Debug\net8.0-windows\Cell_vqlq5xxk_wpftmp.GlobalUsings.g.cs", "C#", 5, 0, 0, 0, 0, 1, 1, 7
"c:\Users\chris\source\repos\Cell\Cell\obj\Debug\net8.0-windows\Cell_vqlq5xxk_wpftmp.sourcelink.json", "JSON", 0, 0, 0, 1, 0, 0, 0, 1
"c:\Users\chris\source\repos\Cell\Cell\obj\Debug\net8.0-windows\Cell_vs1ef2i2_wpftmp.AssemblyInfo.cs", "C#", 11, 0, 0, 0, 0, 10, 5, 26
"c:\Users\chris\source\repos\Cell\Cell\obj\Debug\net8.0-windows\Cell_vs1ef2i2_wpftmp.GeneratedMSBuildEditorConfig.editorconfig", "Properties", 0, 0, 0, 0, 21, 0, 1, 22
"c:\Users\chris\source\repos\Cell\Cell\obj\Debug\net8.0-windows\Cell_vs1ef2i2_wpftmp.GlobalUsings.g.cs", "C#", 5, 0, 0, 0, 0, 1, 1, 7
"c:\Users\chris\source\repos\Cell\Cell\obj\Debug\net8.0-windows\Cell_vs1ef2i2_wpftmp.sourcelink.json", "JSON", 0, 0, 0, 1, 0, 0, 0, 1
"c:\Users\chris\source\repos\Cell\Cell\obj\Debug\net8.0-windows\Cell_vsl5ril0_wpftmp.AssemblyInfo.cs", "C#", 11, 0, 0, 0, 0, 10, 5, 26
"c:\Users\chris\source\repos\Cell\Cell\obj\Debug\net8.0-windows\Cell_vsl5ril0_wpftmp.GeneratedMSBuildEditorConfig.editorconfig", "Properties", 0, 0, 0, 0, 21, 0, 1, 22
"c:\Users\chris\source\repos\Cell\Cell\obj\Debug\net8.0-windows\Cell_vsl5ril0_wpftmp.GlobalUsings.g.cs", "C#", 5, 0, 0, 0, 0, 1, 1, 7
"c:\Users\chris\source\repos\Cell\Cell\obj\Debug\net8.0-windows\Cell_vsl5ril0_wpftmp.sourcelink.json", "JSON", 0, 0, 0, 1, 0, 0, 0, 1
"c:\Users\chris\source\repos\Cell\Cell\obj\Debug\net8.0-windows\Cell_vsm34wfo_wpftmp.AssemblyInfo.cs", "C#", 11, 0, 0, 0, 0, 10, 5, 26
"c:\Users\chris\source\repos\Cell\Cell\obj\Debug\net8.0-windows\Cell_vsm34wfo_wpftmp.GeneratedMSBuildEditorConfig.editorconfig", "Properties", 0, 0, 0, 0, 21, 0, 1, 22
"c:\Users\chris\source\repos\Cell\Cell\obj\Debug\net8.0-windows\Cell_vsm34wfo_wpftmp.GlobalUsings.g.cs", "C#", 5, 0, 0, 0, 0, 1, 1, 7
"c:\Users\chris\source\repos\Cell\Cell\obj\Debug\net8.0-windows\Cell_vsm34wfo_wpftmp.sourcelink.json", "JSON", 0, 0, 0, 1, 0, 0, 0, 1
"c:\Users\chris\source\repos\Cell\Cell\obj\Debug\net8.0-windows\Cell_vss42vpe_wpftmp.AssemblyInfo.cs", "C#", 11, 0, 0, 0, 0, 10, 5, 26
"c:\Users\chris\source\repos\Cell\Cell\obj\Debug\net8.0-windows\Cell_vss42vpe_wpftmp.GeneratedMSBuildEditorConfig.editorconfig", "Properties", 0, 0, 0, 0, 21, 0, 1, 22
"c:\Users\chris\source\repos\Cell\Cell\obj\Debug\net8.0-windows\Cell_vss42vpe_wpftmp.GlobalUsings.g.cs", "C#", 5, 0, 0, 0, 0, 1, 1, 7
"c:\Users\chris\source\repos\Cell\Cell\obj\Debug\net8.0-windows\Cell_vss42vpe_wpftmp.sourcelink.json", "JSON", 0, 0, 0, 1, 0, 0, 0, 1
"c:\Users\chris\source\repos\Cell\Cell\obj\Debug\net8.0-windows\Cell_vtkfdlyr_wpftmp.AssemblyInfo.cs", "C#", 11, 0, 0, 0, 0, 10, 5, 26
"c:\Users\chris\source\repos\Cell\Cell\obj\Debug\net8.0-windows\Cell_vtkfdlyr_wpftmp.GeneratedMSBuildEditorConfig.editorconfig", "Properties", 0, 0, 0, 0, 21, 0, 1, 22
"c:\Users\chris\source\repos\Cell\Cell\obj\Debug\net8.0-windows\Cell_vtkfdlyr_wpftmp.GlobalUsings.g.cs", "C#", 5, 0, 0, 0, 0, 1, 1, 7
"c:\Users\chris\source\repos\Cell\Cell\obj\Debug\net8.0-windows\Cell_vtkfdlyr_wpftmp.sourcelink.json", "JSON", 0, 0, 0, 1, 0, 0, 0, 1
"c:\Users\chris\source\repos\Cell\Cell\obj\Debug\net8.0-windows\Cell_vulk2pn5_wpftmp.AssemblyInfo.cs", "C#", 11, 0, 0, 0, 0, 10, 5, 26
"c:\Users\chris\source\repos\Cell\Cell\obj\Debug\net8.0-windows\Cell_vulk2pn5_wpftmp.GeneratedMSBuildEditorConfig.editorconfig", "Properties", 0, 0, 0, 0, 21, 0, 1, 22
"c:\Users\chris\source\repos\Cell\Cell\obj\Debug\net8.0-windows\Cell_vulk2pn5_wpftmp.GlobalUsings.g.cs", "C#", 5, 0, 0, 0, 0, 1, 1, 7
"c:\Users\chris\source\repos\Cell\Cell\obj\Debug\net8.0-windows\Cell_vulk2pn5_wpftmp.sourcelink.json", "JSON", 0, 0, 0, 1, 0, 0, 0, 1
"c:\Users\chris\source\repos\Cell\Cell\obj\Debug\net8.0-windows\Cell_vut5nzz3_wpftmp.AssemblyInfo.cs", "C#", 11, 0, 0, 0, 0, 10, 5, 26
"c:\Users\chris\source\repos\Cell\Cell\obj\Debug\net8.0-windows\Cell_vut5nzz3_wpftmp.GeneratedMSBuildEditorConfig.editorconfig", "Properties", 0, 0, 0, 0, 21, 0, 1, 22
"c:\Users\chris\source\repos\Cell\Cell\obj\Debug\net8.0-windows\Cell_vut5nzz3_wpftmp.GlobalUsings.g.cs", "C#", 5, 0, 0, 0, 0, 1, 1, 7
"c:\Users\chris\source\repos\Cell\Cell\obj\Debug\net8.0-windows\Cell_vut5nzz3_wpftmp.sourcelink.json", "JSON", 0, 0, 0, 1, 0, 0, 0, 1
"c:\Users\chris\source\repos\Cell\Cell\obj\Debug\net8.0-windows\Cell_vv2nqdiz_wpftmp.AssemblyInfo.cs", "C#", 11, 0, 0, 0, 0, 10, 5, 26
"c:\Users\chris\source\repos\Cell\Cell\obj\Debug\net8.0-windows\Cell_vv2nqdiz_wpftmp.GeneratedMSBuildEditorConfig.editorconfig", "Properties", 0, 0, 0, 0, 21, 0, 1, 22
"c:\Users\chris\source\repos\Cell\Cell\obj\Debug\net8.0-windows\Cell_vv2nqdiz_wpftmp.GlobalUsings.g.cs", "C#", 5, 0, 0, 0, 0, 1, 1, 7
"c:\Users\chris\source\repos\Cell\Cell\obj\Debug\net8.0-windows\Cell_vv2nqdiz_wpftmp.sourcelink.json", "JSON", 0, 0, 0, 1, 0, 0, 0, 1
"c:\Users\chris\source\repos\Cell\Cell\obj\Debug\net8.0-windows\Cell_vv5rt5rr_wpftmp.AssemblyInfo.cs", "C#", 11, 0, 0, 0, 0, 10, 5, 26
"c:\Users\chris\source\repos\Cell\Cell\obj\Debug\net8.0-windows\Cell_vv5rt5rr_wpftmp.GeneratedMSBuildEditorConfig.editorconfig", "Properties", 0, 0, 0, 0, 21, 0, 1, 22
"c:\Users\chris\source\repos\Cell\Cell\obj\Debug\net8.0-windows\Cell_vv5rt5rr_wpftmp.GlobalUsings.g.cs", "C#", 5, 0, 0, 0, 0, 1, 1, 7
"c:\Users\chris\source\repos\Cell\Cell\obj\Debug\net8.0-windows\Cell_vv5rt5rr_wpftmp.sourcelink.json", "JSON", 0, 0, 0, 1, 0, 0, 0, 1
"c:\Users\chris\source\repos\Cell\Cell\obj\Debug\net8.0-windows\Cell_vwgyioz1_wpftmp.AssemblyInfo.cs", "C#", 11, 0, 0, 0, 0, 10, 5, 26
"c:\Users\chris\source\repos\Cell\Cell\obj\Debug\net8.0-windows\Cell_vwgyioz1_wpftmp.GeneratedMSBuildEditorConfig.editorconfig", "Properties", 0, 0, 0, 0, 13, 0, 1, 14
"c:\Users\chris\source\repos\Cell\Cell\obj\Debug\net8.0-windows\Cell_vwgyioz1_wpftmp.GlobalUsings.g.cs", "C#", 5, 0, 0, 0, 0, 1, 1, 7
"c:\Users\chris\source\repos\Cell\Cell\obj\Debug\net8.0-windows\Cell_vwimj2b0_wpftmp.AssemblyInfo.cs", "C#", 11, 0, 0, 0, 0, 10, 5, 26
"c:\Users\chris\source\repos\Cell\Cell\obj\Debug\net8.0-windows\Cell_vwimj2b0_wpftmp.GeneratedMSBuildEditorConfig.editorconfig", "Properties", 0, 0, 0, 0, 21, 0, 1, 22
"c:\Users\chris\source\repos\Cell\Cell\obj\Debug\net8.0-windows\Cell_vwimj2b0_wpftmp.GlobalUsings.g.cs", "C#", 5, 0, 0, 0, 0, 1, 1, 7
"c:\Users\chris\source\repos\Cell\Cell\obj\Debug\net8.0-windows\Cell_vwimj2b0_wpftmp.sourcelink.json", "JSON", 0, 0, 0, 1, 0, 0, 0, 1
"c:\Users\chris\source\repos\Cell\Cell\obj\Debug\net8.0-windows\Cell_vwrb1ao1_wpftmp.AssemblyInfo.cs", "C#", 11, 0, 0, 0, 0, 10, 5, 26
"c:\Users\chris\source\repos\Cell\Cell\obj\Debug\net8.0-windows\Cell_vwrb1ao1_wpftmp.GeneratedMSBuildEditorConfig.editorconfig", "Properties", 0, 0, 0, 0, 21, 0, 1, 22
"c:\Users\chris\source\repos\Cell\Cell\obj\Debug\net8.0-windows\Cell_vwrb1ao1_wpftmp.GlobalUsings.g.cs", "C#", 5, 0, 0, 0, 0, 1, 1, 7
"c:\Users\chris\source\repos\Cell\Cell\obj\Debug\net8.0-windows\Cell_vwrb1ao1_wpftmp.sourcelink.json", "JSON", 0, 0, 0, 1, 0, 0, 0, 1
"c:\Users\chris\source\repos\Cell\Cell\obj\Debug\net8.0-windows\Cell_vwzzfoam_wpftmp.AssemblyInfo.cs", "C#", 11, 0, 0, 0, 0, 10, 5, 26
"c:\Users\chris\source\repos\Cell\Cell\obj\Debug\net8.0-windows\Cell_vwzzfoam_wpftmp.GeneratedMSBuildEditorConfig.editorconfig", "Properties", 0, 0, 0, 0, 21, 0, 1, 22
"c:\Users\chris\source\repos\Cell\Cell\obj\Debug\net8.0-windows\Cell_vwzzfoam_wpftmp.GlobalUsings.g.cs", "C#", 5, 0, 0, 0, 0, 1, 1, 7
"c:\Users\chris\source\repos\Cell\Cell\obj\Debug\net8.0-windows\Cell_vwzzfoam_wpftmp.sourcelink.json", "JSON", 0, 0, 0, 1, 0, 0, 0, 1
"c:\Users\chris\source\repos\Cell\Cell\obj\Debug\net8.0-windows\Cell_vxdnp1de_wpftmp.AssemblyInfo.cs", "C#", 11, 0, 0, 0, 0, 10, 5, 26
"c:\Users\chris\source\repos\Cell\Cell\obj\Debug\net8.0-windows\Cell_vxdnp1de_wpftmp.GeneratedMSBuildEditorConfig.editorconfig", "Properties", 0, 0, 0, 0, 21, 0, 1, 22
"c:\Users\chris\source\repos\Cell\Cell\obj\Debug\net8.0-windows\Cell_vxdnp1de_wpftmp.GlobalUsings.g.cs", "C#", 5, 0, 0, 0, 0, 1, 1, 7
"c:\Users\chris\source\repos\Cell\Cell\obj\Debug\net8.0-windows\Cell_vxdnp1de_wpftmp.sourcelink.json", "JSON", 0, 0, 0, 1, 0, 0, 0, 1
"c:\Users\chris\source\repos\Cell\Cell\obj\Debug\net8.0-windows\Cell_vxo1kkhj_wpftmp.AssemblyInfo.cs", "C#", 11, 0, 0, 0, 0, 10, 5, 26
"c:\Users\chris\source\repos\Cell\Cell\obj\Debug\net8.0-windows\Cell_vxo1kkhj_wpftmp.GeneratedMSBuildEditorConfig.editorconfig", "Properties", 0, 0, 0, 0, 21, 0, 1, 22
"c:\Users\chris\source\repos\Cell\Cell\obj\Debug\net8.0-windows\Cell_vxo1kkhj_wpftmp.GlobalUsings.g.cs", "C#", 5, 0, 0, 0, 0, 1, 1, 7
"c:\Users\chris\source\repos\Cell\Cell\obj\Debug\net8.0-windows\Cell_vxo1kkhj_wpftmp.sourcelink.json", "JSON", 0, 0, 0, 1, 0, 0, 0, 1
"c:\Users\chris\source\repos\Cell\Cell\obj\Debug\net8.0-windows\Cell_vxrdijf2_wpftmp.AssemblyInfo.cs", "C#", 11, 0, 0, 0, 0, 10, 5, 26
"c:\Users\chris\source\repos\Cell\Cell\obj\Debug\net8.0-windows\Cell_vxrdijf2_wpftmp.GeneratedMSBuildEditorConfig.editorconfig", "Properties", 0, 0, 0, 0, 21, 0, 1, 22
"c:\Users\chris\source\repos\Cell\Cell\obj\Debug\net8.0-windows\Cell_vxrdijf2_wpftmp.GlobalUsings.g.cs", "C#", 5, 0, 0, 0, 0, 1, 1, 7
"c:\Users\chris\source\repos\Cell\Cell\obj\Debug\net8.0-windows\Cell_vxrdijf2_wpftmp.sourcelink.json", "JSON", 0, 0, 0, 1, 0, 0, 0, 1
"c:\Users\chris\source\repos\Cell\Cell\obj\Debug\net8.0-windows\Cell_vy5clgjc_wpftmp.AssemblyInfo.cs", "C#", 11, 0, 0, 0, 0, 10, 5, 26
"c:\Users\chris\source\repos\Cell\Cell\obj\Debug\net8.0-windows\Cell_vy5clgjc_wpftmp.GeneratedMSBuildEditorConfig.editorconfig", "Properties", 0, 0, 0, 0, 21, 0, 1, 22
"c:\Users\chris\source\repos\Cell\Cell\obj\Debug\net8.0-windows\Cell_vy5clgjc_wpftmp.GlobalUsings.g.cs", "C#", 5, 0, 0, 0, 0, 1, 1, 7
"c:\Users\chris\source\repos\Cell\Cell\obj\Debug\net8.0-windows\Cell_vy5clgjc_wpftmp.sourcelink.json", "JSON", 0, 0, 0, 1, 0, 0, 0, 1
"c:\Users\chris\source\repos\Cell\Cell\obj\Debug\net8.0-windows\Cell_vy5dhp20_wpftmp.AssemblyInfo.cs", "C#", 11, 0, 0, 0, 0, 10, 5, 26
"c:\Users\chris\source\repos\Cell\Cell\obj\Debug\net8.0-windows\Cell_vy5dhp20_wpftmp.GeneratedMSBuildEditorConfig.editorconfig", "Properties", 0, 0, 0, 0, 21, 0, 1, 22
"c:\Users\chris\source\repos\Cell\Cell\obj\Debug\net8.0-windows\Cell_vy5dhp20_wpftmp.GlobalUsings.g.cs", "C#", 5, 0, 0, 0, 0, 1, 1, 7
"c:\Users\chris\source\repos\Cell\Cell\obj\Debug\net8.0-windows\Cell_vy5dhp20_wpftmp.sourcelink.json", "JSON", 0, 0, 0, 1, 0, 0, 0, 1
"c:\Users\chris\source\repos\Cell\Cell\obj\Debug\net8.0-windows\Cell_vyl1piil_wpftmp.AssemblyInfo.cs", "C#", 11, 0, 0, 0, 0, 10, 5, 26
"c:\Users\chris\source\repos\Cell\Cell\obj\Debug\net8.0-windows\Cell_vyl1piil_wpftmp.GeneratedMSBuildEditorConfig.editorconfig", "Properties", 0, 0, 0, 0, 21, 0, 1, 22
"c:\Users\chris\source\repos\Cell\Cell\obj\Debug\net8.0-windows\Cell_vyl1piil_wpftmp.GlobalUsings.g.cs", "C#", 5, 0, 0, 0, 0, 1, 1, 7
"c:\Users\chris\source\repos\Cell\Cell\obj\Debug\net8.0-windows\Cell_vyl1piil_wpftmp.sourcelink.json", "JSON", 0, 0, 0, 1, 0, 0, 0, 1
"c:\Users\chris\source\repos\Cell\Cell\obj\Debug\net8.0-windows\Cell_vzatlwvk_wpftmp.AssemblyInfo.cs", "C#", 11, 0, 0, 0, 0, 10, 5, 26
"c:\Users\chris\source\repos\Cell\Cell\obj\Debug\net8.0-windows\Cell_vzatlwvk_wpftmp.GeneratedMSBuildEditorConfig.editorconfig", "Properties", 0, 0, 0, 0, 13, 0, 1, 14
"c:\Users\chris\source\repos\Cell\Cell\obj\Debug\net8.0-windows\Cell_vzatlwvk_wpftmp.GlobalUsings.g.cs", "C#", 5, 0, 0, 0, 0, 1, 1, 7
"c:\Users\chris\source\repos\Cell\Cell\obj\Debug\net8.0-windows\Cell_w0bknmmr_wpftmp.AssemblyInfo.cs", "C#", 11, 0, 0, 0, 0, 10, 5, 26
"c:\Users\chris\source\repos\Cell\Cell\obj\Debug\net8.0-windows\Cell_w0bknmmr_wpftmp.GeneratedMSBuildEditorConfig.editorconfig", "Properties", 0, 0, 0, 0, 21, 0, 1, 22
"c:\Users\chris\source\repos\Cell\Cell\obj\Debug\net8.0-windows\Cell_w0bknmmr_wpftmp.GlobalUsings.g.cs", "C#", 5, 0, 0, 0, 0, 1, 1, 7
"c:\Users\chris\source\repos\Cell\Cell\obj\Debug\net8.0-windows\Cell_w0bknmmr_wpftmp.sourcelink.json", "JSON", 0, 0, 0, 1, 0, 0, 0, 1
"c:\Users\chris\source\repos\Cell\Cell\obj\Debug\net8.0-windows\Cell_w0eeku1s_wpftmp.AssemblyInfo.cs", "C#", 11, 0, 0, 0, 0, 10, 5, 26
"c:\Users\chris\source\repos\Cell\Cell\obj\Debug\net8.0-windows\Cell_w0eeku1s_wpftmp.GeneratedMSBuildEditorConfig.editorconfig", "Properties", 0, 0, 0, 0, 21, 0, 1, 22
"c:\Users\chris\source\repos\Cell\Cell\obj\Debug\net8.0-windows\Cell_w0eeku1s_wpftmp.GlobalUsings.g.cs", "C#", 5, 0, 0, 0, 0, 1, 1, 7
"c:\Users\chris\source\repos\Cell\Cell\obj\Debug\net8.0-windows\Cell_w0eeku1s_wpftmp.sourcelink.json", "JSON", 0, 0, 0, 1, 0, 0, 0, 1
"c:\Users\chris\source\repos\Cell\Cell\obj\Debug\net8.0-windows\Cell_w1usycze_wpftmp.AssemblyInfo.cs", "C#", 11, 0, 0, 0, 0, 10, 5, 26
"c:\Users\chris\source\repos\Cell\Cell\obj\Debug\net8.0-windows\Cell_w1usycze_wpftmp.GeneratedMSBuildEditorConfig.editorconfig", "Properties", 0, 0, 0, 0, 21, 0, 1, 22
"c:\Users\chris\source\repos\Cell\Cell\obj\Debug\net8.0-windows\Cell_w1usycze_wpftmp.GlobalUsings.g.cs", "C#", 5, 0, 0, 0, 0, 1, 1, 7
"c:\Users\chris\source\repos\Cell\Cell\obj\Debug\net8.0-windows\Cell_w1usycze_wpftmp.sourcelink.json", "JSON", 0, 0, 0, 1, 0, 0, 0, 1
"c:\Users\chris\source\repos\Cell\Cell\obj\Debug\net8.0-windows\Cell_w1w4okeh_wpftmp.AssemblyInfo.cs", "C#", 11, 0, 0, 0, 0, 10, 5, 26
"c:\Users\chris\source\repos\Cell\Cell\obj\Debug\net8.0-windows\Cell_w1w4okeh_wpftmp.GeneratedMSBuildEditorConfig.editorconfig", "Properties", 0, 0, 0, 0, 21, 0, 1, 22
"c:\Users\chris\source\repos\Cell\Cell\obj\Debug\net8.0-windows\Cell_w1w4okeh_wpftmp.GlobalUsings.g.cs", "C#", 5, 0, 0, 0, 0, 1, 1, 7
"c:\Users\chris\source\repos\Cell\Cell\obj\Debug\net8.0-windows\Cell_w1w4okeh_wpftmp.sourcelink.json", "JSON", 0, 0, 0, 1, 0, 0, 0, 1
"c:\Users\chris\source\repos\Cell\Cell\obj\Debug\net8.0-windows\Cell_w1yy5s0o_wpftmp.AssemblyInfo.cs", "C#", 11, 0, 0, 0, 0, 10, 5, 26
"c:\Users\chris\source\repos\Cell\Cell\obj\Debug\net8.0-windows\Cell_w1yy5s0o_wpftmp.GeneratedMSBuildEditorConfig.editorconfig", "Properties", 0, 0, 0, 0, 13, 0, 1, 14
"c:\Users\chris\source\repos\Cell\Cell\obj\Debug\net8.0-windows\Cell_w1yy5s0o_wpftmp.GlobalUsings.g.cs", "C#", 5, 0, 0, 0, 0, 1, 1, 7
"c:\Users\chris\source\repos\Cell\Cell\obj\Debug\net8.0-windows\Cell_w1zmjofk_wpftmp.AssemblyInfo.cs", "C#", 11, 0, 0, 0, 0, 10, 5, 26
"c:\Users\chris\source\repos\Cell\Cell\obj\Debug\net8.0-windows\Cell_w1zmjofk_wpftmp.GeneratedMSBuildEditorConfig.editorconfig", "Properties", 0, 0, 0, 0, 13, 0, 1, 14
"c:\Users\chris\source\repos\Cell\Cell\obj\Debug\net8.0-windows\Cell_w1zmjofk_wpftmp.GlobalUsings.g.cs", "C#", 5, 0, 0, 0, 0, 1, 1, 7
"c:\Users\chris\source\repos\Cell\Cell\obj\Debug\net8.0-windows\Cell_w2fbikum_wpftmp.AssemblyInfo.cs", "C#", 11, 0, 0, 0, 0, 10, 5, 26
"c:\Users\chris\source\repos\Cell\Cell\obj\Debug\net8.0-windows\Cell_w2fbikum_wpftmp.GeneratedMSBuildEditorConfig.editorconfig", "Properties", 0, 0, 0, 0, 13, 0, 1, 14
"c:\Users\chris\source\repos\Cell\Cell\obj\Debug\net8.0-windows\Cell_w2fbikum_wpftmp.GlobalUsings.g.cs", "C#", 5, 0, 0, 0, 0, 1, 1, 7
"c:\Users\chris\source\repos\Cell\Cell\obj\Debug\net8.0-windows\Cell_w2gfvhkq_wpftmp.AssemblyInfo.cs", "C#", 11, 0, 0, 0, 0, 10, 5, 26
"c:\Users\chris\source\repos\Cell\Cell\obj\Debug\net8.0-windows\Cell_w2gfvhkq_wpftmp.GeneratedMSBuildEditorConfig.editorconfig", "Properties", 0, 0, 0, 0, 21, 0, 1, 22
"c:\Users\chris\source\repos\Cell\Cell\obj\Debug\net8.0-windows\Cell_w2gfvhkq_wpftmp.GlobalUsings.g.cs", "C#", 5, 0, 0, 0, 0, 1, 1, 7
"c:\Users\chris\source\repos\Cell\Cell\obj\Debug\net8.0-windows\Cell_w2gfvhkq_wpftmp.sourcelink.json", "JSON", 0, 0, 0, 1, 0, 0, 0, 1
"c:\Users\chris\source\repos\Cell\Cell\obj\Debug\net8.0-windows\Cell_w5skc1pg_wpftmp.AssemblyInfo.cs", "C#", 11, 0, 0, 0, 0, 10, 5, 26
"c:\Users\chris\source\repos\Cell\Cell\obj\Debug\net8.0-windows\Cell_w5skc1pg_wpftmp.GeneratedMSBuildEditorConfig.editorconfig", "Properties", 0, 0, 0, 0, 21, 0, 1, 22
"c:\Users\chris\source\repos\Cell\Cell\obj\Debug\net8.0-windows\Cell_w5skc1pg_wpftmp.GlobalUsings.g.cs", "C#", 5, 0, 0, 0, 0, 1, 1, 7
"c:\Users\chris\source\repos\Cell\Cell\obj\Debug\net8.0-windows\Cell_w5skc1pg_wpftmp.sourcelink.json", "JSON", 0, 0, 0, 1, 0, 0, 0, 1
"c:\Users\chris\source\repos\Cell\Cell\obj\Debug\net8.0-windows\Cell_w5ul4mfi_wpftmp.AssemblyInfo.cs", "C#", 11, 0, 0, 0, 0, 10, 5, 26
"c:\Users\chris\source\repos\Cell\Cell\obj\Debug\net8.0-windows\Cell_w5ul4mfi_wpftmp.GeneratedMSBuildEditorConfig.editorconfig", "Properties", 0, 0, 0, 0, 21, 0, 1, 22
"c:\Users\chris\source\repos\Cell\Cell\obj\Debug\net8.0-windows\Cell_w5ul4mfi_wpftmp.GlobalUsings.g.cs", "C#", 5, 0, 0, 0, 0, 1, 1, 7
"c:\Users\chris\source\repos\Cell\Cell\obj\Debug\net8.0-windows\Cell_w5ul4mfi_wpftmp.sourcelink.json", "JSON", 0, 0, 0, 1, 0, 0, 0, 1
"c:\Users\chris\source\repos\Cell\Cell\obj\Debug\net8.0-windows\Cell_wajivqlb_wpftmp.AssemblyInfo.cs", "C#", 11, 0, 0, 0, 0, 10, 5, 26
"c:\Users\chris\source\repos\Cell\Cell\obj\Debug\net8.0-windows\Cell_wajivqlb_wpftmp.GeneratedMSBuildEditorConfig.editorconfig", "Properties", 0, 0, 0, 0, 21, 0, 1, 22
"c:\Users\chris\source\repos\Cell\Cell\obj\Debug\net8.0-windows\Cell_wajivqlb_wpftmp.GlobalUsings.g.cs", "C#", 5, 0, 0, 0, 0, 1, 1, 7
"c:\Users\chris\source\repos\Cell\Cell\obj\Debug\net8.0-windows\Cell_wajivqlb_wpftmp.sourcelink.json", "JSON", 0, 0, 0, 1, 0, 0, 0, 1
"c:\Users\chris\source\repos\Cell\Cell\obj\Debug\net8.0-windows\Cell_wbf3wmxg_wpftmp.AssemblyInfo.cs", "C#", 11, 0, 0, 0, 0, 10, 5, 26
"c:\Users\chris\source\repos\Cell\Cell\obj\Debug\net8.0-windows\Cell_wbf3wmxg_wpftmp.GeneratedMSBuildEditorConfig.editorconfig", "Properties", 0, 0, 0, 0, 21, 0, 1, 22
"c:\Users\chris\source\repos\Cell\Cell\obj\Debug\net8.0-windows\Cell_wbf3wmxg_wpftmp.GlobalUsings.g.cs", "C#", 5, 0, 0, 0, 0, 1, 1, 7
"c:\Users\chris\source\repos\Cell\Cell\obj\Debug\net8.0-windows\Cell_wbf3wmxg_wpftmp.sourcelink.json", "JSON", 0, 0, 0, 1, 0, 0, 0, 1
"c:\Users\chris\source\repos\Cell\Cell\obj\Debug\net8.0-windows\Cell_wbsjlrq4_wpftmp.AssemblyInfo.cs", "C#", 11, 0, 0, 0, 0, 10, 5, 26
"c:\Users\chris\source\repos\Cell\Cell\obj\Debug\net8.0-windows\Cell_wbsjlrq4_wpftmp.GeneratedMSBuildEditorConfig.editorconfig", "Properties", 0, 0, 0, 0, 21, 0, 1, 22
"c:\Users\chris\source\repos\Cell\Cell\obj\Debug\net8.0-windows\Cell_wbsjlrq4_wpftmp.GlobalUsings.g.cs", "C#", 5, 0, 0, 0, 0, 1, 1, 7
"c:\Users\chris\source\repos\Cell\Cell\obj\Debug\net8.0-windows\Cell_wbsjlrq4_wpftmp.sourcelink.json", "JSON", 0, 0, 0, 1, 0, 0, 0, 1
"c:\Users\chris\source\repos\Cell\Cell\obj\Debug\net8.0-windows\Cell_wdok4lcd_wpftmp.AssemblyInfo.cs", "C#", 11, 0, 0, 0, 0, 10, 5, 26
"c:\Users\chris\source\repos\Cell\Cell\obj\Debug\net8.0-windows\Cell_wdok4lcd_wpftmp.GeneratedMSBuildEditorConfig.editorconfig", "Properties", 0, 0, 0, 0, 21, 0, 1, 22
"c:\Users\chris\source\repos\Cell\Cell\obj\Debug\net8.0-windows\Cell_wdok4lcd_wpftmp.GlobalUsings.g.cs", "C#", 5, 0, 0, 0, 0, 1, 1, 7
"c:\Users\chris\source\repos\Cell\Cell\obj\Debug\net8.0-windows\Cell_wdok4lcd_wpftmp.sourcelink.json", "JSON", 0, 0, 0, 1, 0, 0, 0, 1
"c:\Users\chris\source\repos\Cell\Cell\obj\Debug\net8.0-windows\Cell_wea1fpmt_wpftmp.AssemblyInfo.cs", "C#", 11, 0, 0, 0, 0, 10, 5, 26
"c:\Users\chris\source\repos\Cell\Cell\obj\Debug\net8.0-windows\Cell_wea1fpmt_wpftmp.GeneratedMSBuildEditorConfig.editorconfig", "Properties", 0, 0, 0, 0, 21, 0, 1, 22
"c:\Users\chris\source\repos\Cell\Cell\obj\Debug\net8.0-windows\Cell_wea1fpmt_wpftmp.GlobalUsings.g.cs", "C#", 5, 0, 0, 0, 0, 1, 1, 7
"c:\Users\chris\source\repos\Cell\Cell\obj\Debug\net8.0-windows\Cell_wea1fpmt_wpftmp.sourcelink.json", "JSON", 0, 0, 0, 1, 0, 0, 0, 1
"c:\Users\chris\source\repos\Cell\Cell\obj\Debug\net8.0-windows\Cell_wed4vz10_wpftmp.AssemblyInfo.cs", "C#", 11, 0, 0, 0, 0, 10, 5, 26
"c:\Users\chris\source\repos\Cell\Cell\obj\Debug\net8.0-windows\Cell_wed4vz10_wpftmp.GeneratedMSBuildEditorConfig.editorconfig", "Properties", 0, 0, 0, 0, 21, 0, 1, 22
"c:\Users\chris\source\repos\Cell\Cell\obj\Debug\net8.0-windows\Cell_wed4vz10_wpftmp.GlobalUsings.g.cs", "C#", 5, 0, 0, 0, 0, 1, 1, 7
"c:\Users\chris\source\repos\Cell\Cell\obj\Debug\net8.0-windows\Cell_wed4vz10_wpftmp.sourcelink.json", "JSON", 0, 0, 0, 1, 0, 0, 0, 1
"c:\Users\chris\source\repos\Cell\Cell\obj\Debug\net8.0-windows\Cell_wfz1uldx_wpftmp.AssemblyInfo.cs", "C#", 11, 0, 0, 0, 0, 10, 5, 26
"c:\Users\chris\source\repos\Cell\Cell\obj\Debug\net8.0-windows\Cell_wfz1uldx_wpftmp.GeneratedMSBuildEditorConfig.editorconfig", "Properties", 0, 0, 0, 0, 13, 0, 1, 14
"c:\Users\chris\source\repos\Cell\Cell\obj\Debug\net8.0-windows\Cell_wfz1uldx_wpftmp.GlobalUsings.g.cs", "C#", 5, 0, 0, 0, 0, 1, 1, 7
"c:\Users\chris\source\repos\Cell\Cell\obj\Debug\net8.0-windows\Cell_whdnwrqn_wpftmp.AssemblyInfo.cs", "C#", 11, 0, 0, 0, 0, 10, 5, 26
"c:\Users\chris\source\repos\Cell\Cell\obj\Debug\net8.0-windows\Cell_whdnwrqn_wpftmp.GeneratedMSBuildEditorConfig.editorconfig", "Properties", 0, 0, 0, 0, 13, 0, 1, 14
"c:\Users\chris\source\repos\Cell\Cell\obj\Debug\net8.0-windows\Cell_whdnwrqn_wpftmp.GlobalUsings.g.cs", "C#", 5, 0, 0, 0, 0, 1, 1, 7
"c:\Users\chris\source\repos\Cell\Cell\obj\Debug\net8.0-windows\Cell_wikep4mg_wpftmp.AssemblyInfo.cs", "C#", 11, 0, 0, 0, 0, 10, 5, 26
"c:\Users\chris\source\repos\Cell\Cell\obj\Debug\net8.0-windows\Cell_wikep4mg_wpftmp.GeneratedMSBuildEditorConfig.editorconfig", "Properties", 0, 0, 0, 0, 21, 0, 1, 22
"c:\Users\chris\source\repos\Cell\Cell\obj\Debug\net8.0-windows\Cell_wikep4mg_wpftmp.GlobalUsings.g.cs", "C#", 5, 0, 0, 0, 0, 1, 1, 7
"c:\Users\chris\source\repos\Cell\Cell\obj\Debug\net8.0-windows\Cell_wikep4mg_wpftmp.sourcelink.json", "JSON", 0, 0, 0, 1, 0, 0, 0, 1
"c:\Users\chris\source\repos\Cell\Cell\obj\Debug\net8.0-windows\Cell_wk1hyqfp_wpftmp.AssemblyInfo.cs", "C#", 11, 0, 0, 0, 0, 10, 5, 26
"c:\Users\chris\source\repos\Cell\Cell\obj\Debug\net8.0-windows\Cell_wk1hyqfp_wpftmp.GeneratedMSBuildEditorConfig.editorconfig", "Properties", 0, 0, 0, 0, 21, 0, 1, 22
"c:\Users\chris\source\repos\Cell\Cell\obj\Debug\net8.0-windows\Cell_wk1hyqfp_wpftmp.GlobalUsings.g.cs", "C#", 5, 0, 0, 0, 0, 1, 1, 7
"c:\Users\chris\source\repos\Cell\Cell\obj\Debug\net8.0-windows\Cell_wk1hyqfp_wpftmp.sourcelink.json", "JSON", 0, 0, 0, 1, 0, 0, 0, 1
"c:\Users\chris\source\repos\Cell\Cell\obj\Debug\net8.0-windows\Cell_wk2doodn_wpftmp.AssemblyInfo.cs", "C#", 11, 0, 0, 0, 0, 10, 5, 26
"c:\Users\chris\source\repos\Cell\Cell\obj\Debug\net8.0-windows\Cell_wk2doodn_wpftmp.GeneratedMSBuildEditorConfig.editorconfig", "Properties", 0, 0, 0, 0, 21, 0, 1, 22
"c:\Users\chris\source\repos\Cell\Cell\obj\Debug\net8.0-windows\Cell_wk2doodn_wpftmp.GlobalUsings.g.cs", "C#", 5, 0, 0, 0, 0, 1, 1, 7
"c:\Users\chris\source\repos\Cell\Cell\obj\Debug\net8.0-windows\Cell_wk2doodn_wpftmp.sourcelink.json", "JSON", 0, 0, 0, 1, 0, 0, 0, 1
"c:\Users\chris\source\repos\Cell\Cell\obj\Debug\net8.0-windows\Cell_wk2pe0xy_wpftmp.AssemblyInfo.cs", "C#", 11, 0, 0, 0, 0, 10, 5, 26
"c:\Users\chris\source\repos\Cell\Cell\obj\Debug\net8.0-windows\Cell_wk2pe0xy_wpftmp.GeneratedMSBuildEditorConfig.editorconfig", "Properties", 0, 0, 0, 0, 21, 0, 1, 22
"c:\Users\chris\source\repos\Cell\Cell\obj\Debug\net8.0-windows\Cell_wk2pe0xy_wpftmp.GlobalUsings.g.cs", "C#", 5, 0, 0, 0, 0, 1, 1, 7
"c:\Users\chris\source\repos\Cell\Cell\obj\Debug\net8.0-windows\Cell_wk2pe0xy_wpftmp.sourcelink.json", "JSON", 0, 0, 0, 1, 0, 0, 0, 1
"c:\Users\chris\source\repos\Cell\Cell\obj\Debug\net8.0-windows\Cell_wmiztpgd_wpftmp.AssemblyInfo.cs", "C#", 11, 0, 0, 0, 0, 10, 5, 26
"c:\Users\chris\source\repos\Cell\Cell\obj\Debug\net8.0-windows\Cell_wmiztpgd_wpftmp.GeneratedMSBuildEditorConfig.editorconfig", "Properties", 0, 0, 0, 0, 21, 0, 1, 22
"c:\Users\chris\source\repos\Cell\Cell\obj\Debug\net8.0-windows\Cell_wmiztpgd_wpftmp.GlobalUsings.g.cs", "C#", 5, 0, 0, 0, 0, 1, 1, 7
"c:\Users\chris\source\repos\Cell\Cell\obj\Debug\net8.0-windows\Cell_wmiztpgd_wpftmp.sourcelink.json", "JSON", 0, 0, 0, 1, 0, 0, 0, 1
"c:\Users\chris\source\repos\Cell\Cell\obj\Debug\net8.0-windows\Cell_wml5vmb4_wpftmp.AssemblyInfo.cs", "C#", 11, 0, 0, 0, 0, 10, 5, 26
"c:\Users\chris\source\repos\Cell\Cell\obj\Debug\net8.0-windows\Cell_wml5vmb4_wpftmp.GeneratedMSBuildEditorConfig.editorconfig", "Properties", 0, 0, 0, 0, 13, 0, 1, 14
"c:\Users\chris\source\repos\Cell\Cell\obj\Debug\net8.0-windows\Cell_wml5vmb4_wpftmp.GlobalUsings.g.cs", "C#", 5, 0, 0, 0, 0, 1, 1, 7
"c:\Users\chris\source\repos\Cell\Cell\obj\Debug\net8.0-windows\Cell_wmrbrjub_wpftmp.AssemblyInfo.cs", "C#", 11, 0, 0, 0, 0, 10, 5, 26
"c:\Users\chris\source\repos\Cell\Cell\obj\Debug\net8.0-windows\Cell_wmrbrjub_wpftmp.GeneratedMSBuildEditorConfig.editorconfig", "Properties", 0, 0, 0, 0, 13, 0, 1, 14
"c:\Users\chris\source\repos\Cell\Cell\obj\Debug\net8.0-windows\Cell_wmrbrjub_wpftmp.GlobalUsings.g.cs", "C#", 5, 0, 0, 0, 0, 1, 1, 7
"c:\Users\chris\source\repos\Cell\Cell\obj\Debug\net8.0-windows\Cell_wn2ajmcv_wpftmp.AssemblyInfo.cs", "C#", 11, 0, 0, 0, 0, 10, 5, 26
"c:\Users\chris\source\repos\Cell\Cell\obj\Debug\net8.0-windows\Cell_wn2ajmcv_wpftmp.GeneratedMSBuildEditorConfig.editorconfig", "Properties", 0, 0, 0, 0, 21, 0, 1, 22
"c:\Users\chris\source\repos\Cell\Cell\obj\Debug\net8.0-windows\Cell_wn2ajmcv_wpftmp.GlobalUsings.g.cs", "C#", 5, 0, 0, 0, 0, 1, 1, 7
"c:\Users\chris\source\repos\Cell\Cell\obj\Debug\net8.0-windows\Cell_wn2ajmcv_wpftmp.sourcelink.json", "JSON", 0, 0, 0, 1, 0, 0, 0, 1
"c:\Users\chris\source\repos\Cell\Cell\obj\Debug\net8.0-windows\Cell_wneqrrot_wpftmp.AssemblyInfo.cs", "C#", 11, 0, 0, 0, 0, 10, 5, 26
"c:\Users\chris\source\repos\Cell\Cell\obj\Debug\net8.0-windows\Cell_wneqrrot_wpftmp.GeneratedMSBuildEditorConfig.editorconfig", "Properties", 0, 0, 0, 0, 21, 0, 1, 22
"c:\Users\chris\source\repos\Cell\Cell\obj\Debug\net8.0-windows\Cell_wneqrrot_wpftmp.GlobalUsings.g.cs", "C#", 5, 0, 0, 0, 0, 1, 1, 7
"c:\Users\chris\source\repos\Cell\Cell\obj\Debug\net8.0-windows\Cell_wneqrrot_wpftmp.sourcelink.json", "JSON", 0, 0, 0, 1, 0, 0, 0, 1
"c:\Users\chris\source\repos\Cell\Cell\obj\Debug\net8.0-windows\Cell_wnhl0m5i_wpftmp.AssemblyInfo.cs", "C#", 11, 0, 0, 0, 0, 10, 5, 26
"c:\Users\chris\source\repos\Cell\Cell\obj\Debug\net8.0-windows\Cell_wnhl0m5i_wpftmp.GeneratedMSBuildEditorConfig.editorconfig", "Properties", 0, 0, 0, 0, 21, 0, 1, 22
"c:\Users\chris\source\repos\Cell\Cell\obj\Debug\net8.0-windows\Cell_wnhl0m5i_wpftmp.GlobalUsings.g.cs", "C#", 5, 0, 0, 0, 0, 1, 1, 7
"c:\Users\chris\source\repos\Cell\Cell\obj\Debug\net8.0-windows\Cell_woz1lmx4_wpftmp.AssemblyInfo.cs", "C#", 11, 0, 0, 0, 0, 10, 5, 26
"c:\Users\chris\source\repos\Cell\Cell\obj\Debug\net8.0-windows\Cell_woz1lmx4_wpftmp.GeneratedMSBuildEditorConfig.editorconfig", "Properties", 0, 0, 0, 0, 13, 0, 1, 14
"c:\Users\chris\source\repos\Cell\Cell\obj\Debug\net8.0-windows\Cell_woz1lmx4_wpftmp.GlobalUsings.g.cs", "C#", 5, 0, 0, 0, 0, 1, 1, 7
"c:\Users\chris\source\repos\Cell\Cell\obj\Debug\net8.0-windows\Cell_wpqnssad_wpftmp.AssemblyInfo.cs", "C#", 11, 0, 0, 0, 0, 10, 5, 26
"c:\Users\chris\source\repos\Cell\Cell\obj\Debug\net8.0-windows\Cell_wpqnssad_wpftmp.GeneratedMSBuildEditorConfig.editorconfig", "Properties", 0, 0, 0, 0, 21, 0, 1, 22
"c:\Users\chris\source\repos\Cell\Cell\obj\Debug\net8.0-windows\Cell_wpqnssad_wpftmp.GlobalUsings.g.cs", "C#", 5, 0, 0, 0, 0, 1, 1, 7
"c:\Users\chris\source\repos\Cell\Cell\obj\Debug\net8.0-windows\Cell_wpqnssad_wpftmp.sourcelink.json", "JSON", 0, 0, 0, 1, 0, 0, 0, 1
"c:\Users\chris\source\repos\Cell\Cell\obj\Debug\net8.0-windows\Cell_wq01vfnz_wpftmp.AssemblyInfo.cs", "C#", 11, 0, 0, 0, 0, 10, 5, 26
"c:\Users\chris\source\repos\Cell\Cell\obj\Debug\net8.0-windows\Cell_wq01vfnz_wpftmp.GeneratedMSBuildEditorConfig.editorconfig", "Properties", 0, 0, 0, 0, 21, 0, 1, 22
"c:\Users\chris\source\repos\Cell\Cell\obj\Debug\net8.0-windows\Cell_wq01vfnz_wpftmp.GlobalUsings.g.cs", "C#", 5, 0, 0, 0, 0, 1, 1, 7
"c:\Users\chris\source\repos\Cell\Cell\obj\Debug\net8.0-windows\Cell_wq01vfnz_wpftmp.sourcelink.json", "JSON", 0, 0, 0, 1, 0, 0, 0, 1
"c:\Users\chris\source\repos\Cell\Cell\obj\Debug\net8.0-windows\Cell_wq33ofde_wpftmp.AssemblyInfo.cs", "C#", 11, 0, 0, 0, 0, 10, 5, 26
"c:\Users\chris\source\repos\Cell\Cell\obj\Debug\net8.0-windows\Cell_wq33ofde_wpftmp.GeneratedMSBuildEditorConfig.editorconfig", "Properties", 0, 0, 0, 0, 21, 0, 1, 22
"c:\Users\chris\source\repos\Cell\Cell\obj\Debug\net8.0-windows\Cell_wq33ofde_wpftmp.GlobalUsings.g.cs", "C#", 5, 0, 0, 0, 0, 1, 1, 7
"c:\Users\chris\source\repos\Cell\Cell\obj\Debug\net8.0-windows\Cell_wq33ofde_wpftmp.sourcelink.json", "JSON", 0, 0, 0, 1, 0, 0, 0, 1
"c:\Users\chris\source\repos\Cell\Cell\obj\Debug\net8.0-windows\Cell_wqcp5paz_wpftmp.AssemblyInfo.cs", "C#", 11, 0, 0, 0, 0, 10, 5, 26
"c:\Users\chris\source\repos\Cell\Cell\obj\Debug\net8.0-windows\Cell_wqcp5paz_wpftmp.GeneratedMSBuildEditorConfig.editorconfig", "Properties", 0, 0, 0, 0, 21, 0, 1, 22
"c:\Users\chris\source\repos\Cell\Cell\obj\Debug\net8.0-windows\Cell_wqcp5paz_wpftmp.GlobalUsings.g.cs", "C#", 5, 0, 0, 0, 0, 1, 1, 7
"c:\Users\chris\source\repos\Cell\Cell\obj\Debug\net8.0-windows\Cell_wqcp5paz_wpftmp.sourcelink.json", "JSON", 0, 0, 0, 1, 0, 0, 0, 1
"c:\Users\chris\source\repos\Cell\Cell\obj\Debug\net8.0-windows\Cell_wqfnkgus_wpftmp.AssemblyInfo.cs", "C#", 11, 0, 0, 0, 0, 10, 5, 26
"c:\Users\chris\source\repos\Cell\Cell\obj\Debug\net8.0-windows\Cell_wqfnkgus_wpftmp.GeneratedMSBuildEditorConfig.editorconfig", "Properties", 0, 0, 0, 0, 21, 0, 1, 22
"c:\Users\chris\source\repos\Cell\Cell\obj\Debug\net8.0-windows\Cell_wqfnkgus_wpftmp.GlobalUsings.g.cs", "C#", 5, 0, 0, 0, 0, 1, 1, 7
"c:\Users\chris\source\repos\Cell\Cell\obj\Debug\net8.0-windows\Cell_wqfnkgus_wpftmp.sourcelink.json", "JSON", 0, 0, 0, 1, 0, 0, 0, 1
"c:\Users\chris\source\repos\Cell\Cell\obj\Debug\net8.0-windows\Cell_wqgj3qbz_wpftmp.AssemblyInfo.cs", "C#", 11, 0, 0, 0, 0, 10, 5, 26
"c:\Users\chris\source\repos\Cell\Cell\obj\Debug\net8.0-windows\Cell_wqgj3qbz_wpftmp.GeneratedMSBuildEditorConfig.editorconfig", "Properties", 0, 0, 0, 0, 21, 0, 1, 22
"c:\Users\chris\source\repos\Cell\Cell\obj\Debug\net8.0-windows\Cell_wqgj3qbz_wpftmp.GlobalUsings.g.cs", "C#", 5, 0, 0, 0, 0, 1, 1, 7
"c:\Users\chris\source\repos\Cell\Cell\obj\Debug\net8.0-windows\Cell_wqgj3qbz_wpftmp.sourcelink.json", "JSON", 0, 0, 0, 1, 0, 0, 0, 1
"c:\Users\chris\source\repos\Cell\Cell\obj\Debug\net8.0-windows\Cell_wrpdnah5_wpftmp.AssemblyInfo.cs", "C#", 11, 0, 0, 0, 0, 10, 5, 26
"c:\Users\chris\source\repos\Cell\Cell\obj\Debug\net8.0-windows\Cell_wrpdnah5_wpftmp.GeneratedMSBuildEditorConfig.editorconfig", "Properties", 0, 0, 0, 0, 21, 0, 1, 22
"c:\Users\chris\source\repos\Cell\Cell\obj\Debug\net8.0-windows\Cell_wrpdnah5_wpftmp.GlobalUsings.g.cs", "C#", 5, 0, 0, 0, 0, 1, 1, 7
"c:\Users\chris\source\repos\Cell\Cell\obj\Debug\net8.0-windows\Cell_wrpdnah5_wpftmp.sourcelink.json", "JSON", 0, 0, 0, 1, 0, 0, 0, 1
"c:\Users\chris\source\repos\Cell\Cell\obj\Debug\net8.0-windows\Cell_wtcbnkmu_wpftmp.AssemblyInfo.cs", "C#", 11, 0, 0, 0, 0, 10, 5, 26
"c:\Users\chris\source\repos\Cell\Cell\obj\Debug\net8.0-windows\Cell_wtcbnkmu_wpftmp.GeneratedMSBuildEditorConfig.editorconfig", "Properties", 0, 0, 0, 0, 13, 0, 1, 14
"c:\Users\chris\source\repos\Cell\Cell\obj\Debug\net8.0-windows\Cell_wtcbnkmu_wpftmp.GlobalUsings.g.cs", "C#", 5, 0, 0, 0, 0, 1, 1, 7
"c:\Users\chris\source\repos\Cell\Cell\obj\Debug\net8.0-windows\Cell_wtyawwox_wpftmp.AssemblyInfo.cs", "C#", 11, 0, 0, 0, 0, 10, 5, 26
"c:\Users\chris\source\repos\Cell\Cell\obj\Debug\net8.0-windows\Cell_wtyawwox_wpftmp.GeneratedMSBuildEditorConfig.editorconfig", "Properties", 0, 0, 0, 0, 21, 0, 1, 22
"c:\Users\chris\source\repos\Cell\Cell\obj\Debug\net8.0-windows\Cell_wtyawwox_wpftmp.GlobalUsings.g.cs", "C#", 5, 0, 0, 0, 0, 1, 1, 7
"c:\Users\chris\source\repos\Cell\Cell\obj\Debug\net8.0-windows\Cell_wtyawwox_wpftmp.sourcelink.json", "JSON", 0, 0, 0, 1, 0, 0, 0, 1
"c:\Users\chris\source\repos\Cell\Cell\obj\Debug\net8.0-windows\Cell_wuxcuapn_wpftmp.AssemblyInfo.cs", "C#", 11, 0, 0, 0, 0, 10, 5, 26
"c:\Users\chris\source\repos\Cell\Cell\obj\Debug\net8.0-windows\Cell_wuxcuapn_wpftmp.GeneratedMSBuildEditorConfig.editorconfig", "Properties", 0, 0, 0, 0, 21, 0, 1, 22
"c:\Users\chris\source\repos\Cell\Cell\obj\Debug\net8.0-windows\Cell_wuxcuapn_wpftmp.GlobalUsings.g.cs", "C#", 5, 0, 0, 0, 0, 1, 1, 7
"c:\Users\chris\source\repos\Cell\Cell\obj\Debug\net8.0-windows\Cell_wuxcuapn_wpftmp.sourcelink.json", "JSON", 0, 0, 0, 1, 0, 0, 0, 1
"c:\Users\chris\source\repos\Cell\Cell\obj\Debug\net8.0-windows\Cell_wuxoswo1_wpftmp.AssemblyInfo.cs", "C#", 11, 0, 0, 0, 0, 10, 5, 26
"c:\Users\chris\source\repos\Cell\Cell\obj\Debug\net8.0-windows\Cell_wuxoswo1_wpftmp.GeneratedMSBuildEditorConfig.editorconfig", "Properties", 0, 0, 0, 0, 21, 0, 1, 22
"c:\Users\chris\source\repos\Cell\Cell\obj\Debug\net8.0-windows\Cell_wuxoswo1_wpftmp.GlobalUsings.g.cs", "C#", 5, 0, 0, 0, 0, 1, 1, 7
"c:\Users\chris\source\repos\Cell\Cell\obj\Debug\net8.0-windows\Cell_wuxoswo1_wpftmp.sourcelink.json", "JSON", 0, 0, 0, 1, 0, 0, 0, 1
"c:\Users\chris\source\repos\Cell\Cell\obj\Debug\net8.0-windows\Cell_wveucork_wpftmp.AssemblyInfo.cs", "C#", 11, 0, 0, 0, 0, 10, 5, 26
"c:\Users\chris\source\repos\Cell\Cell\obj\Debug\net8.0-windows\Cell_wveucork_wpftmp.GeneratedMSBuildEditorConfig.editorconfig", "Properties", 0, 0, 0, 0, 21, 0, 1, 22
"c:\Users\chris\source\repos\Cell\Cell\obj\Debug\net8.0-windows\Cell_wveucork_wpftmp.GlobalUsings.g.cs", "C#", 5, 0, 0, 0, 0, 1, 1, 7
"c:\Users\chris\source\repos\Cell\Cell\obj\Debug\net8.0-windows\Cell_wveucork_wpftmp.sourcelink.json", "JSON", 0, 0, 0, 1, 0, 0, 0, 1
"c:\Users\chris\source\repos\Cell\Cell\obj\Debug\net8.0-windows\Cell_wvujb05u_wpftmp.AssemblyInfo.cs", "C#", 11, 0, 0, 0, 0, 10, 5, 26
"c:\Users\chris\source\repos\Cell\Cell\obj\Debug\net8.0-windows\Cell_wvujb05u_wpftmp.GeneratedMSBuildEditorConfig.editorconfig", "Properties", 0, 0, 0, 0, 21, 0, 1, 22
"c:\Users\chris\source\repos\Cell\Cell\obj\Debug\net8.0-windows\Cell_wvujb05u_wpftmp.GlobalUsings.g.cs", "C#", 5, 0, 0, 0, 0, 1, 1, 7
"c:\Users\chris\source\repos\Cell\Cell\obj\Debug\net8.0-windows\Cell_wvujb05u_wpftmp.sourcelink.json", "JSON", 0, 0, 0, 1, 0, 0, 0, 1
"c:\Users\chris\source\repos\Cell\Cell\obj\Debug\net8.0-windows\Cell_ww0otb4b_wpftmp.AssemblyInfo.cs", "C#", 11, 0, 0, 0, 0, 10, 5, 26
"c:\Users\chris\source\repos\Cell\Cell\obj\Debug\net8.0-windows\Cell_ww0otb4b_wpftmp.GeneratedMSBuildEditorConfig.editorconfig", "Properties", 0, 0, 0, 0, 21, 0, 1, 22
"c:\Users\chris\source\repos\Cell\Cell\obj\Debug\net8.0-windows\Cell_ww0otb4b_wpftmp.GlobalUsings.g.cs", "C#", 5, 0, 0, 0, 0, 1, 1, 7
"c:\Users\chris\source\repos\Cell\Cell\obj\Debug\net8.0-windows\Cell_ww0otb4b_wpftmp.sourcelink.json", "JSON", 0, 0, 0, 1, 0, 0, 0, 1
"c:\Users\chris\source\repos\Cell\Cell\obj\Debug\net8.0-windows\Cell_ww53dj1w_wpftmp.AssemblyInfo.cs", "C#", 11, 0, 0, 0, 0, 10, 5, 26
"c:\Users\chris\source\repos\Cell\Cell\obj\Debug\net8.0-windows\Cell_ww53dj1w_wpftmp.GeneratedMSBuildEditorConfig.editorconfig", "Properties", 0, 0, 0, 0, 13, 0, 1, 14
"c:\Users\chris\source\repos\Cell\Cell\obj\Debug\net8.0-windows\Cell_ww53dj1w_wpftmp.GlobalUsings.g.cs", "C#", 5, 0, 0, 0, 0, 1, 1, 7
"c:\Users\chris\source\repos\Cell\Cell\obj\Debug\net8.0-windows\Cell_wxutuy41_wpftmp.AssemblyInfo.cs", "C#", 11, 0, 0, 0, 0, 10, 5, 26
"c:\Users\chris\source\repos\Cell\Cell\obj\Debug\net8.0-windows\Cell_wxutuy41_wpftmp.GeneratedMSBuildEditorConfig.editorconfig", "Properties", 0, 0, 0, 0, 21, 0, 1, 22
"c:\Users\chris\source\repos\Cell\Cell\obj\Debug\net8.0-windows\Cell_wxutuy41_wpftmp.GlobalUsings.g.cs", "C#", 5, 0, 0, 0, 0, 1, 1, 7
"c:\Users\chris\source\repos\Cell\Cell\obj\Debug\net8.0-windows\Cell_wxutuy41_wpftmp.sourcelink.json", "JSON", 0, 0, 0, 1, 0, 0, 0, 1
"c:\Users\chris\source\repos\Cell\Cell\obj\Debug\net8.0-windows\Cell_wy4vecu0_wpftmp.AssemblyInfo.cs", "C#", 11, 0, 0, 0, 0, 10, 5, 26
"c:\Users\chris\source\repos\Cell\Cell\obj\Debug\net8.0-windows\Cell_wy4vecu0_wpftmp.GeneratedMSBuildEditorConfig.editorconfig", "Properties", 0, 0, 0, 0, 21, 0, 1, 22
"c:\Users\chris\source\repos\Cell\Cell\obj\Debug\net8.0-windows\Cell_wy4vecu0_wpftmp.GlobalUsings.g.cs", "C#", 5, 0, 0, 0, 0, 1, 1, 7
"c:\Users\chris\source\repos\Cell\Cell\obj\Debug\net8.0-windows\Cell_wy4vecu0_wpftmp.sourcelink.json", "JSON", 0, 0, 0, 1, 0, 0, 0, 1
"c:\Users\chris\source\repos\Cell\Cell\obj\Debug\net8.0-windows\Cell_wys0hbx5_wpftmp.AssemblyInfo.cs", "C#", 11, 0, 0, 0, 0, 10, 5, 26
"c:\Users\chris\source\repos\Cell\Cell\obj\Debug\net8.0-windows\Cell_wys0hbx5_wpftmp.GeneratedMSBuildEditorConfig.editorconfig", "Properties", 0, 0, 0, 0, 21, 0, 1, 22
"c:\Users\chris\source\repos\Cell\Cell\obj\Debug\net8.0-windows\Cell_wys0hbx5_wpftmp.GlobalUsings.g.cs", "C#", 5, 0, 0, 0, 0, 1, 1, 7
"c:\Users\chris\source\repos\Cell\Cell\obj\Debug\net8.0-windows\Cell_wys0hbx5_wpftmp.sourcelink.json", "JSON", 0, 0, 0, 1, 0, 0, 0, 1
"c:\Users\chris\source\repos\Cell\Cell\obj\Debug\net8.0-windows\Cell_wzov2pfa_wpftmp.AssemblyInfo.cs", "C#", 11, 0, 0, 0, 0, 10, 5, 26
"c:\Users\chris\source\repos\Cell\Cell\obj\Debug\net8.0-windows\Cell_wzov2pfa_wpftmp.GeneratedMSBuildEditorConfig.editorconfig", "Properties", 0, 0, 0, 0, 21, 0, 1, 22
"c:\Users\chris\source\repos\Cell\Cell\obj\Debug\net8.0-windows\Cell_wzov2pfa_wpftmp.GlobalUsings.g.cs", "C#", 5, 0, 0, 0, 0, 1, 1, 7
"c:\Users\chris\source\repos\Cell\Cell\obj\Debug\net8.0-windows\Cell_wzov2pfa_wpftmp.sourcelink.json", "JSON", 0, 0, 0, 1, 0, 0, 0, 1
"c:\Users\chris\source\repos\Cell\Cell\obj\Debug\net8.0-windows\Cell_x0gv5uai_wpftmp.AssemblyInfo.cs", "C#", 11, 0, 0, 0, 0, 10, 5, 26
"c:\Users\chris\source\repos\Cell\Cell\obj\Debug\net8.0-windows\Cell_x0gv5uai_wpftmp.GeneratedMSBuildEditorConfig.editorconfig", "Properties", 0, 0, 0, 0, 21, 0, 1, 22
"c:\Users\chris\source\repos\Cell\Cell\obj\Debug\net8.0-windows\Cell_x0gv5uai_wpftmp.GlobalUsings.g.cs", "C#", 5, 0, 0, 0, 0, 1, 1, 7
"c:\Users\chris\source\repos\Cell\Cell\obj\Debug\net8.0-windows\Cell_x0gv5uai_wpftmp.sourcelink.json", "JSON", 0, 0, 0, 1, 0, 0, 0, 1
"c:\Users\chris\source\repos\Cell\Cell\obj\Debug\net8.0-windows\Cell_x1enphve_wpftmp.AssemblyInfo.cs", "C#", 11, 0, 0, 0, 0, 10, 5, 26
"c:\Users\chris\source\repos\Cell\Cell\obj\Debug\net8.0-windows\Cell_x1enphve_wpftmp.GeneratedMSBuildEditorConfig.editorconfig", "Properties", 0, 0, 0, 0, 13, 0, 1, 14
"c:\Users\chris\source\repos\Cell\Cell\obj\Debug\net8.0-windows\Cell_x1enphve_wpftmp.GlobalUsings.g.cs", "C#", 5, 0, 0, 0, 0, 1, 1, 7
"c:\Users\chris\source\repos\Cell\Cell\obj\Debug\net8.0-windows\Cell_x1rbajft_wpftmp.AssemblyInfo.cs", "C#", 11, 0, 0, 0, 0, 10, 5, 26
"c:\Users\chris\source\repos\Cell\Cell\obj\Debug\net8.0-windows\Cell_x1rbajft_wpftmp.GeneratedMSBuildEditorConfig.editorconfig", "Properties", 0, 0, 0, 0, 21, 0, 1, 22
"c:\Users\chris\source\repos\Cell\Cell\obj\Debug\net8.0-windows\Cell_x1rbajft_wpftmp.GlobalUsings.g.cs", "C#", 5, 0, 0, 0, 0, 1, 1, 7
"c:\Users\chris\source\repos\Cell\Cell\obj\Debug\net8.0-windows\Cell_x1rbajft_wpftmp.sourcelink.json", "JSON", 0, 0, 0, 1, 0, 0, 0, 1
"c:\Users\chris\source\repos\Cell\Cell\obj\Debug\net8.0-windows\Cell_x2g3d05b_wpftmp.AssemblyInfo.cs", "C#", 11, 0, 0, 0, 0, 10, 5, 26
"c:\Users\chris\source\repos\Cell\Cell\obj\Debug\net8.0-windows\Cell_x2g3d05b_wpftmp.GeneratedMSBuildEditorConfig.editorconfig", "Properties", 0, 0, 0, 0, 21, 0, 1, 22
"c:\Users\chris\source\repos\Cell\Cell\obj\Debug\net8.0-windows\Cell_x2g3d05b_wpftmp.GlobalUsings.g.cs", "C#", 5, 0, 0, 0, 0, 1, 1, 7
"c:\Users\chris\source\repos\Cell\Cell\obj\Debug\net8.0-windows\Cell_x2g3d05b_wpftmp.sourcelink.json", "JSON", 0, 0, 0, 1, 0, 0, 0, 1
"c:\Users\chris\source\repos\Cell\Cell\obj\Debug\net8.0-windows\Cell_x2xvvhep_wpftmp.AssemblyInfo.cs", "C#", 11, 0, 0, 0, 0, 10, 5, 26
"c:\Users\chris\source\repos\Cell\Cell\obj\Debug\net8.0-windows\Cell_x2xvvhep_wpftmp.GeneratedMSBuildEditorConfig.editorconfig", "Properties", 0, 0, 0, 0, 13, 0, 1, 14
"c:\Users\chris\source\repos\Cell\Cell\obj\Debug\net8.0-windows\Cell_x2xvvhep_wpftmp.GlobalUsings.g.cs", "C#", 5, 0, 0, 0, 0, 1, 1, 7
"c:\Users\chris\source\repos\Cell\Cell\obj\Debug\net8.0-windows\Cell_x4wxyani_wpftmp.AssemblyInfo.cs", "C#", 11, 0, 0, 0, 0, 10, 5, 26
"c:\Users\chris\source\repos\Cell\Cell\obj\Debug\net8.0-windows\Cell_x4wxyani_wpftmp.GeneratedMSBuildEditorConfig.editorconfig", "Properties", 0, 0, 0, 0, 21, 0, 1, 22
"c:\Users\chris\source\repos\Cell\Cell\obj\Debug\net8.0-windows\Cell_x4wxyani_wpftmp.GlobalUsings.g.cs", "C#", 5, 0, 0, 0, 0, 1, 1, 7
"c:\Users\chris\source\repos\Cell\Cell\obj\Debug\net8.0-windows\Cell_x4wxyani_wpftmp.sourcelink.json", "JSON", 0, 0, 0, 1, 0, 0, 0, 1
"c:\Users\chris\source\repos\Cell\Cell\obj\Debug\net8.0-windows\Cell_x5ndcdiq_wpftmp.AssemblyInfo.cs", "C#", 11, 0, 0, 0, 0, 10, 5, 26
"c:\Users\chris\source\repos\Cell\Cell\obj\Debug\net8.0-windows\Cell_x5ndcdiq_wpftmp.GeneratedMSBuildEditorConfig.editorconfig", "Properties", 0, 0, 0, 0, 13, 0, 1, 14
"c:\Users\chris\source\repos\Cell\Cell\obj\Debug\net8.0-windows\Cell_x5ndcdiq_wpftmp.GlobalUsings.g.cs", "C#", 5, 0, 0, 0, 0, 1, 1, 7
"c:\Users\chris\source\repos\Cell\Cell\obj\Debug\net8.0-windows\Cell_x5o2fjof_wpftmp.AssemblyInfo.cs", "C#", 11, 0, 0, 0, 0, 10, 5, 26
"c:\Users\chris\source\repos\Cell\Cell\obj\Debug\net8.0-windows\Cell_x5o2fjof_wpftmp.GeneratedMSBuildEditorConfig.editorconfig", "Properties", 0, 0, 0, 0, 21, 0, 1, 22
"c:\Users\chris\source\repos\Cell\Cell\obj\Debug\net8.0-windows\Cell_x5o2fjof_wpftmp.GlobalUsings.g.cs", "C#", 5, 0, 0, 0, 0, 1, 1, 7
"c:\Users\chris\source\repos\Cell\Cell\obj\Debug\net8.0-windows\Cell_x5o2fjof_wpftmp.sourcelink.json", "JSON", 0, 0, 0, 1, 0, 0, 0, 1
"c:\Users\chris\source\repos\Cell\Cell\obj\Debug\net8.0-windows\Cell_xbwbcsd3_wpftmp.AssemblyInfo.cs", "C#", 11, 0, 0, 0, 0, 10, 5, 26
"c:\Users\chris\source\repos\Cell\Cell\obj\Debug\net8.0-windows\Cell_xbwbcsd3_wpftmp.GeneratedMSBuildEditorConfig.editorconfig", "Properties", 0, 0, 0, 0, 21, 0, 1, 22
"c:\Users\chris\source\repos\Cell\Cell\obj\Debug\net8.0-windows\Cell_xbwbcsd3_wpftmp.GlobalUsings.g.cs", "C#", 5, 0, 0, 0, 0, 1, 1, 7
"c:\Users\chris\source\repos\Cell\Cell\obj\Debug\net8.0-windows\Cell_xbwbcsd3_wpftmp.sourcelink.json", "JSON", 0, 0, 0, 1, 0, 0, 0, 1
"c:\Users\chris\source\repos\Cell\Cell\obj\Debug\net8.0-windows\Cell_xc4mlhbj_wpftmp.AssemblyInfo.cs", "C#", 11, 0, 0, 0, 0, 10, 5, 26
"c:\Users\chris\source\repos\Cell\Cell\obj\Debug\net8.0-windows\Cell_xc4mlhbj_wpftmp.GeneratedMSBuildEditorConfig.editorconfig", "Properties", 0, 0, 0, 0, 21, 0, 1, 22
"c:\Users\chris\source\repos\Cell\Cell\obj\Debug\net8.0-windows\Cell_xc4mlhbj_wpftmp.GlobalUsings.g.cs", "C#", 5, 0, 0, 0, 0, 1, 1, 7
"c:\Users\chris\source\repos\Cell\Cell\obj\Debug\net8.0-windows\Cell_xcu2dbk1_wpftmp.AssemblyInfo.cs", "C#", 11, 0, 0, 0, 0, 10, 5, 26
"c:\Users\chris\source\repos\Cell\Cell\obj\Debug\net8.0-windows\Cell_xcu2dbk1_wpftmp.GeneratedMSBuildEditorConfig.editorconfig", "Properties", 0, 0, 0, 0, 21, 0, 1, 22
"c:\Users\chris\source\repos\Cell\Cell\obj\Debug\net8.0-windows\Cell_xcu2dbk1_wpftmp.GlobalUsings.g.cs", "C#", 5, 0, 0, 0, 0, 1, 1, 7
"c:\Users\chris\source\repos\Cell\Cell\obj\Debug\net8.0-windows\Cell_xcu2dbk1_wpftmp.sourcelink.json", "JSON", 0, 0, 0, 1, 0, 0, 0, 1
"c:\Users\chris\source\repos\Cell\Cell\obj\Debug\net8.0-windows\Cell_xdbqs5sd_wpftmp.AssemblyInfo.cs", "C#", 11, 0, 0, 0, 0, 10, 5, 26
"c:\Users\chris\source\repos\Cell\Cell\obj\Debug\net8.0-windows\Cell_xdbqs5sd_wpftmp.GeneratedMSBuildEditorConfig.editorconfig", "Properties", 0, 0, 0, 0, 21, 0, 1, 22
"c:\Users\chris\source\repos\Cell\Cell\obj\Debug\net8.0-windows\Cell_xdbqs5sd_wpftmp.GlobalUsings.g.cs", "C#", 5, 0, 0, 0, 0, 1, 1, 7
"c:\Users\chris\source\repos\Cell\Cell\obj\Debug\net8.0-windows\Cell_xdbqs5sd_wpftmp.sourcelink.json", "JSON", 0, 0, 0, 1, 0, 0, 0, 1
"c:\Users\chris\source\repos\Cell\Cell\obj\Debug\net8.0-windows\Cell_xge2ugtp_wpftmp.AssemblyInfo.cs", "C#", 11, 0, 0, 0, 0, 10, 5, 26
"c:\Users\chris\source\repos\Cell\Cell\obj\Debug\net8.0-windows\Cell_xge2ugtp_wpftmp.GeneratedMSBuildEditorConfig.editorconfig", "Properties", 0, 0, 0, 0, 21, 0, 1, 22
"c:\Users\chris\source\repos\Cell\Cell\obj\Debug\net8.0-windows\Cell_xge2ugtp_wpftmp.GlobalUsings.g.cs", "C#", 5, 0, 0, 0, 0, 1, 1, 7
"c:\Users\chris\source\repos\Cell\Cell\obj\Debug\net8.0-windows\Cell_xge2ugtp_wpftmp.sourcelink.json", "JSON", 0, 0, 0, 1, 0, 0, 0, 1
"c:\Users\chris\source\repos\Cell\Cell\obj\Debug\net8.0-windows\Cell_xh4v3j4h_wpftmp.AssemblyInfo.cs", "C#", 11, 0, 0, 0, 0, 10, 5, 26
"c:\Users\chris\source\repos\Cell\Cell\obj\Debug\net8.0-windows\Cell_xh4v3j4h_wpftmp.GeneratedMSBuildEditorConfig.editorconfig", "Properties", 0, 0, 0, 0, 21, 0, 1, 22
"c:\Users\chris\source\repos\Cell\Cell\obj\Debug\net8.0-windows\Cell_xh4v3j4h_wpftmp.GlobalUsings.g.cs", "C#", 5, 0, 0, 0, 0, 1, 1, 7
"c:\Users\chris\source\repos\Cell\Cell\obj\Debug\net8.0-windows\Cell_xhrgon1c_wpftmp.AssemblyInfo.cs", "C#", 11, 0, 0, 0, 0, 10, 5, 26
"c:\Users\chris\source\repos\Cell\Cell\obj\Debug\net8.0-windows\Cell_xhrgon1c_wpftmp.GeneratedMSBuildEditorConfig.editorconfig", "Properties", 0, 0, 0, 0, 21, 0, 1, 22
"c:\Users\chris\source\repos\Cell\Cell\obj\Debug\net8.0-windows\Cell_xhrgon1c_wpftmp.GlobalUsings.g.cs", "C#", 5, 0, 0, 0, 0, 1, 1, 7
"c:\Users\chris\source\repos\Cell\Cell\obj\Debug\net8.0-windows\Cell_xhrgon1c_wpftmp.sourcelink.json", "JSON", 0, 0, 0, 1, 0, 0, 0, 1
"c:\Users\chris\source\repos\Cell\Cell\obj\Debug\net8.0-windows\Cell_xi2s52do_wpftmp.AssemblyInfo.cs", "C#", 11, 0, 0, 0, 0, 10, 5, 26
"c:\Users\chris\source\repos\Cell\Cell\obj\Debug\net8.0-windows\Cell_xi2s52do_wpftmp.GeneratedMSBuildEditorConfig.editorconfig", "Properties", 0, 0, 0, 0, 21, 0, 1, 22
"c:\Users\chris\source\repos\Cell\Cell\obj\Debug\net8.0-windows\Cell_xi2s52do_wpftmp.GlobalUsings.g.cs", "C#", 5, 0, 0, 0, 0, 1, 1, 7
"c:\Users\chris\source\repos\Cell\Cell\obj\Debug\net8.0-windows\Cell_xi2s52do_wpftmp.sourcelink.json", "JSON", 0, 0, 0, 1, 0, 0, 0, 1
"c:\Users\chris\source\repos\Cell\Cell\obj\Debug\net8.0-windows\Cell_xixcns4p_wpftmp.AssemblyInfo.cs", "C#", 11, 0, 0, 0, 0, 10, 5, 26
"c:\Users\chris\source\repos\Cell\Cell\obj\Debug\net8.0-windows\Cell_xixcns4p_wpftmp.GeneratedMSBuildEditorConfig.editorconfig", "Properties", 0, 0, 0, 0, 21, 0, 1, 22
"c:\Users\chris\source\repos\Cell\Cell\obj\Debug\net8.0-windows\Cell_xixcns4p_wpftmp.GlobalUsings.g.cs", "C#", 5, 0, 0, 0, 0, 1, 1, 7
"c:\Users\chris\source\repos\Cell\Cell\obj\Debug\net8.0-windows\Cell_xixcns4p_wpftmp.sourcelink.json", "JSON", 0, 0, 0, 1, 0, 0, 0, 1
"c:\Users\chris\source\repos\Cell\Cell\obj\Debug\net8.0-windows\Cell_xkny3xhu_wpftmp.AssemblyInfo.cs", "C#", 11, 0, 0, 0, 0, 10, 5, 26
"c:\Users\chris\source\repos\Cell\Cell\obj\Debug\net8.0-windows\Cell_xkny3xhu_wpftmp.GeneratedMSBuildEditorConfig.editorconfig", "Properties", 0, 0, 0, 0, 21, 0, 1, 22
"c:\Users\chris\source\repos\Cell\Cell\obj\Debug\net8.0-windows\Cell_xkny3xhu_wpftmp.GlobalUsings.g.cs", "C#", 5, 0, 0, 0, 0, 1, 1, 7
"c:\Users\chris\source\repos\Cell\Cell\obj\Debug\net8.0-windows\Cell_xkny3xhu_wpftmp.sourcelink.json", "JSON", 0, 0, 0, 1, 0, 0, 0, 1
"c:\Users\chris\source\repos\Cell\Cell\obj\Debug\net8.0-windows\Cell_xkwg0cjl_wpftmp.AssemblyInfo.cs", "C#", 11, 0, 0, 0, 0, 10, 5, 26
"c:\Users\chris\source\repos\Cell\Cell\obj\Debug\net8.0-windows\Cell_xkwg0cjl_wpftmp.GeneratedMSBuildEditorConfig.editorconfig", "Properties", 0, 0, 0, 0, 21, 0, 1, 22
"c:\Users\chris\source\repos\Cell\Cell\obj\Debug\net8.0-windows\Cell_xkwg0cjl_wpftmp.GlobalUsings.g.cs", "C#", 5, 0, 0, 0, 0, 1, 1, 7
"c:\Users\chris\source\repos\Cell\Cell\obj\Debug\net8.0-windows\Cell_xkwg0cjl_wpftmp.sourcelink.json", "JSON", 0, 0, 0, 1, 0, 0, 0, 1
"c:\Users\chris\source\repos\Cell\Cell\obj\Debug\net8.0-windows\Cell_xl0kwjyu_wpftmp.AssemblyInfo.cs", "C#", 11, 0, 0, 0, 0, 10, 5, 26
"c:\Users\chris\source\repos\Cell\Cell\obj\Debug\net8.0-windows\Cell_xl0kwjyu_wpftmp.GeneratedMSBuildEditorConfig.editorconfig", "Properties", 0, 0, 0, 0, 21, 0, 1, 22
"c:\Users\chris\source\repos\Cell\Cell\obj\Debug\net8.0-windows\Cell_xl0kwjyu_wpftmp.GlobalUsings.g.cs", "C#", 5, 0, 0, 0, 0, 1, 1, 7
"c:\Users\chris\source\repos\Cell\Cell\obj\Debug\net8.0-windows\Cell_xl0kwjyu_wpftmp.sourcelink.json", "JSON", 0, 0, 0, 1, 0, 0, 0, 1
"c:\Users\chris\source\repos\Cell\Cell\obj\Debug\net8.0-windows\Cell_xl1s5nuq_wpftmp.AssemblyInfo.cs", "C#", 11, 0, 0, 0, 0, 10, 5, 26
"c:\Users\chris\source\repos\Cell\Cell\obj\Debug\net8.0-windows\Cell_xl1s5nuq_wpftmp.GeneratedMSBuildEditorConfig.editorconfig", "Properties", 0, 0, 0, 0, 21, 0, 1, 22
"c:\Users\chris\source\repos\Cell\Cell\obj\Debug\net8.0-windows\Cell_xl1s5nuq_wpftmp.GlobalUsings.g.cs", "C#", 5, 0, 0, 0, 0, 1, 1, 7
"c:\Users\chris\source\repos\Cell\Cell\obj\Debug\net8.0-windows\Cell_xl1s5nuq_wpftmp.sourcelink.json", "JSON", 0, 0, 0, 1, 0, 0, 0, 1
"c:\Users\chris\source\repos\Cell\Cell\obj\Debug\net8.0-windows\Cell_xlgw04gf_wpftmp.AssemblyInfo.cs", "C#", 11, 0, 0, 0, 0, 10, 5, 26
"c:\Users\chris\source\repos\Cell\Cell\obj\Debug\net8.0-windows\Cell_xlgw04gf_wpftmp.GeneratedMSBuildEditorConfig.editorconfig", "Properties", 0, 0, 0, 0, 21, 0, 1, 22
"c:\Users\chris\source\repos\Cell\Cell\obj\Debug\net8.0-windows\Cell_xlgw04gf_wpftmp.GlobalUsings.g.cs", "C#", 5, 0, 0, 0, 0, 1, 1, 7
"c:\Users\chris\source\repos\Cell\Cell\obj\Debug\net8.0-windows\Cell_xlgw04gf_wpftmp.sourcelink.json", "JSON", 0, 0, 0, 1, 0, 0, 0, 1
"c:\Users\chris\source\repos\Cell\Cell\obj\Debug\net8.0-windows\Cell_xm33s3lp_wpftmp.AssemblyInfo.cs", "C#", 11, 0, 0, 0, 0, 10, 5, 26
"c:\Users\chris\source\repos\Cell\Cell\obj\Debug\net8.0-windows\Cell_xm33s3lp_wpftmp.GeneratedMSBuildEditorConfig.editorconfig", "Properties", 0, 0, 0, 0, 21, 0, 1, 22
"c:\Users\chris\source\repos\Cell\Cell\obj\Debug\net8.0-windows\Cell_xm33s3lp_wpftmp.GlobalUsings.g.cs", "C#", 5, 0, 0, 0, 0, 1, 1, 7
"c:\Users\chris\source\repos\Cell\Cell\obj\Debug\net8.0-windows\Cell_xm33s3lp_wpftmp.sourcelink.json", "JSON", 0, 0, 0, 1, 0, 0, 0, 1
"c:\Users\chris\source\repos\Cell\Cell\obj\Debug\net8.0-windows\Cell_xmwmspes_wpftmp.AssemblyInfo.cs", "C#", 11, 0, 0, 0, 0, 10, 5, 26
"c:\Users\chris\source\repos\Cell\Cell\obj\Debug\net8.0-windows\Cell_xmwmspes_wpftmp.GeneratedMSBuildEditorConfig.editorconfig", "Properties", 0, 0, 0, 0, 21, 0, 1, 22
"c:\Users\chris\source\repos\Cell\Cell\obj\Debug\net8.0-windows\Cell_xmwmspes_wpftmp.GlobalUsings.g.cs", "C#", 5, 0, 0, 0, 0, 1, 1, 7
"c:\Users\chris\source\repos\Cell\Cell\obj\Debug\net8.0-windows\Cell_xmwmspes_wpftmp.sourcelink.json", "JSON", 0, 0, 0, 1, 0, 0, 0, 1
"c:\Users\chris\source\repos\Cell\Cell\obj\Debug\net8.0-windows\Cell_xp1zntcv_wpftmp.AssemblyInfo.cs", "C#", 11, 0, 0, 0, 0, 10, 5, 26
"c:\Users\chris\source\repos\Cell\Cell\obj\Debug\net8.0-windows\Cell_xp1zntcv_wpftmp.GeneratedMSBuildEditorConfig.editorconfig", "Properties", 0, 0, 0, 0, 21, 0, 1, 22
"c:\Users\chris\source\repos\Cell\Cell\obj\Debug\net8.0-windows\Cell_xp1zntcv_wpftmp.GlobalUsings.g.cs", "C#", 5, 0, 0, 0, 0, 1, 1, 7
"c:\Users\chris\source\repos\Cell\Cell\obj\Debug\net8.0-windows\Cell_xp1zntcv_wpftmp.sourcelink.json", "JSON", 0, 0, 0, 1, 0, 0, 0, 1
"c:\Users\chris\source\repos\Cell\Cell\obj\Debug\net8.0-windows\Cell_xpe52dzn_wpftmp.AssemblyInfo.cs", "C#", 11, 0, 0, 0, 0, 10, 5, 26
"c:\Users\chris\source\repos\Cell\Cell\obj\Debug\net8.0-windows\Cell_xpe52dzn_wpftmp.GeneratedMSBuildEditorConfig.editorconfig", "Properties", 0, 0, 0, 0, 21, 0, 1, 22
"c:\Users\chris\source\repos\Cell\Cell\obj\Debug\net8.0-windows\Cell_xpe52dzn_wpftmp.GlobalUsings.g.cs", "C#", 5, 0, 0, 0, 0, 1, 1, 7
"c:\Users\chris\source\repos\Cell\Cell\obj\Debug\net8.0-windows\Cell_xpe52dzn_wpftmp.sourcelink.json", "JSON", 0, 0, 0, 1, 0, 0, 0, 1
"c:\Users\chris\source\repos\Cell\Cell\obj\Debug\net8.0-windows\Cell_xppy1nqh_wpftmp.AssemblyInfo.cs", "C#", 11, 0, 0, 0, 0, 10, 5, 26
"c:\Users\chris\source\repos\Cell\Cell\obj\Debug\net8.0-windows\Cell_xppy1nqh_wpftmp.GeneratedMSBuildEditorConfig.editorconfig", "Properties", 0, 0, 0, 0, 21, 0, 1, 22
"c:\Users\chris\source\repos\Cell\Cell\obj\Debug\net8.0-windows\Cell_xppy1nqh_wpftmp.GlobalUsings.g.cs", "C#", 5, 0, 0, 0, 0, 1, 1, 7
"c:\Users\chris\source\repos\Cell\Cell\obj\Debug\net8.0-windows\Cell_xppy1nqh_wpftmp.sourcelink.json", "JSON", 0, 0, 0, 1, 0, 0, 0, 1
"c:\Users\chris\source\repos\Cell\Cell\obj\Debug\net8.0-windows\Cell_xqfw1n13_wpftmp.AssemblyInfo.cs", "C#", 11, 0, 0, 0, 0, 10, 5, 26
"c:\Users\chris\source\repos\Cell\Cell\obj\Debug\net8.0-windows\Cell_xqfw1n13_wpftmp.GeneratedMSBuildEditorConfig.editorconfig", "Properties", 0, 0, 0, 0, 21, 0, 1, 22
"c:\Users\chris\source\repos\Cell\Cell\obj\Debug\net8.0-windows\Cell_xqfw1n13_wpftmp.GlobalUsings.g.cs", "C#", 5, 0, 0, 0, 0, 1, 1, 7
"c:\Users\chris\source\repos\Cell\Cell\obj\Debug\net8.0-windows\Cell_xqfw1n13_wpftmp.sourcelink.json", "JSON", 0, 0, 0, 1, 0, 0, 0, 1
"c:\Users\chris\source\repos\Cell\Cell\obj\Debug\net8.0-windows\Cell_xqtjbri0_wpftmp.AssemblyInfo.cs", "C#", 11, 0, 0, 0, 0, 10, 5, 26
"c:\Users\chris\source\repos\Cell\Cell\obj\Debug\net8.0-windows\Cell_xqtjbri0_wpftmp.GeneratedMSBuildEditorConfig.editorconfig", "Properties", 0, 0, 0, 0, 21, 0, 1, 22
"c:\Users\chris\source\repos\Cell\Cell\obj\Debug\net8.0-windows\Cell_xqtjbri0_wpftmp.GlobalUsings.g.cs", "C#", 5, 0, 0, 0, 0, 1, 1, 7
"c:\Users\chris\source\repos\Cell\Cell\obj\Debug\net8.0-windows\Cell_xqtjbri0_wpftmp.sourcelink.json", "JSON", 0, 0, 0, 1, 0, 0, 0, 1
"c:\Users\chris\source\repos\Cell\Cell\obj\Debug\net8.0-windows\Cell_xr3wv0nl_wpftmp.AssemblyInfo.cs", "C#", 11, 0, 0, 0, 0, 10, 5, 26
"c:\Users\chris\source\repos\Cell\Cell\obj\Debug\net8.0-windows\Cell_xr3wv0nl_wpftmp.GeneratedMSBuildEditorConfig.editorconfig", "Properties", 0, 0, 0, 0, 21, 0, 1, 22
"c:\Users\chris\source\repos\Cell\Cell\obj\Debug\net8.0-windows\Cell_xr3wv0nl_wpftmp.GlobalUsings.g.cs", "C#", 5, 0, 0, 0, 0, 1, 1, 7
"c:\Users\chris\source\repos\Cell\Cell\obj\Debug\net8.0-windows\Cell_xr3wv0nl_wpftmp.sourcelink.json", "JSON", 0, 0, 0, 1, 0, 0, 0, 1
"c:\Users\chris\source\repos\Cell\Cell\obj\Debug\net8.0-windows\Cell_xrdgjt3o_wpftmp.AssemblyInfo.cs", "C#", 11, 0, 0, 0, 0, 10, 5, 26
"c:\Users\chris\source\repos\Cell\Cell\obj\Debug\net8.0-windows\Cell_xrdgjt3o_wpftmp.GeneratedMSBuildEditorConfig.editorconfig", "Properties", 0, 0, 0, 0, 21, 0, 1, 22
"c:\Users\chris\source\repos\Cell\Cell\obj\Debug\net8.0-windows\Cell_xrdgjt3o_wpftmp.GlobalUsings.g.cs", "C#", 5, 0, 0, 0, 0, 1, 1, 7
"c:\Users\chris\source\repos\Cell\Cell\obj\Debug\net8.0-windows\Cell_xrdgjt3o_wpftmp.sourcelink.json", "JSON", 0, 0, 0, 1, 0, 0, 0, 1
"c:\Users\chris\source\repos\Cell\Cell\obj\Debug\net8.0-windows\Cell_xt01el2b_wpftmp.AssemblyInfo.cs", "C#", 11, 0, 0, 0, 0, 10, 5, 26
"c:\Users\chris\source\repos\Cell\Cell\obj\Debug\net8.0-windows\Cell_xt01el2b_wpftmp.GeneratedMSBuildEditorConfig.editorconfig", "Properties", 0, 0, 0, 0, 21, 0, 1, 22
"c:\Users\chris\source\repos\Cell\Cell\obj\Debug\net8.0-windows\Cell_xt01el2b_wpftmp.GlobalUsings.g.cs", "C#", 5, 0, 0, 0, 0, 1, 1, 7
"c:\Users\chris\source\repos\Cell\Cell\obj\Debug\net8.0-windows\Cell_xt01el2b_wpftmp.sourcelink.json", "JSON", 0, 0, 0, 1, 0, 0, 0, 1
"c:\Users\chris\source\repos\Cell\Cell\obj\Debug\net8.0-windows\Cell_xtabk5kn_wpftmp.AssemblyInfo.cs", "C#", 11, 0, 0, 0, 0, 10, 5, 26
"c:\Users\chris\source\repos\Cell\Cell\obj\Debug\net8.0-windows\Cell_xtabk5kn_wpftmp.GeneratedMSBuildEditorConfig.editorconfig", "Properties", 0, 0, 0, 0, 13, 0, 1, 14
"c:\Users\chris\source\repos\Cell\Cell\obj\Debug\net8.0-windows\Cell_xtabk5kn_wpftmp.GlobalUsings.g.cs", "C#", 5, 0, 0, 0, 0, 1, 1, 7
"c:\Users\chris\source\repos\Cell\Cell\obj\Debug\net8.0-windows\Cell_xvypre1e_wpftmp.AssemblyInfo.cs", "C#", 11, 0, 0, 0, 0, 10, 5, 26
"c:\Users\chris\source\repos\Cell\Cell\obj\Debug\net8.0-windows\Cell_xvypre1e_wpftmp.GeneratedMSBuildEditorConfig.editorconfig", "Properties", 0, 0, 0, 0, 21, 0, 1, 22
"c:\Users\chris\source\repos\Cell\Cell\obj\Debug\net8.0-windows\Cell_xvypre1e_wpftmp.GlobalUsings.g.cs", "C#", 5, 0, 0, 0, 0, 1, 1, 7
"c:\Users\chris\source\repos\Cell\Cell\obj\Debug\net8.0-windows\Cell_xvypre1e_wpftmp.sourcelink.json", "JSON", 0, 0, 0, 1, 0, 0, 0, 1
"c:\Users\chris\source\repos\Cell\Cell\obj\Debug\net8.0-windows\Cell_xwiotsnz_wpftmp.AssemblyInfo.cs", "C#", 11, 0, 0, 0, 0, 10, 5, 26
"c:\Users\chris\source\repos\Cell\Cell\obj\Debug\net8.0-windows\Cell_xwiotsnz_wpftmp.GeneratedMSBuildEditorConfig.editorconfig", "Properties", 0, 0, 0, 0, 21, 0, 1, 22
"c:\Users\chris\source\repos\Cell\Cell\obj\Debug\net8.0-windows\Cell_xwiotsnz_wpftmp.GlobalUsings.g.cs", "C#", 5, 0, 0, 0, 0, 1, 1, 7
"c:\Users\chris\source\repos\Cell\Cell\obj\Debug\net8.0-windows\Cell_xwiotsnz_wpftmp.sourcelink.json", "JSON", 0, 0, 0, 1, 0, 0, 0, 1
"c:\Users\chris\source\repos\Cell\Cell\obj\Debug\net8.0-windows\Cell_xyrtg5ad_wpftmp.AssemblyInfo.cs", "C#", 11, 0, 0, 0, 0, 10, 5, 26
"c:\Users\chris\source\repos\Cell\Cell\obj\Debug\net8.0-windows\Cell_xyrtg5ad_wpftmp.GeneratedMSBuildEditorConfig.editorconfig", "Properties", 0, 0, 0, 0, 21, 0, 1, 22
"c:\Users\chris\source\repos\Cell\Cell\obj\Debug\net8.0-windows\Cell_xyrtg5ad_wpftmp.GlobalUsings.g.cs", "C#", 5, 0, 0, 0, 0, 1, 1, 7
"c:\Users\chris\source\repos\Cell\Cell\obj\Debug\net8.0-windows\Cell_xyrtg5ad_wpftmp.sourcelink.json", "JSON", 0, 0, 0, 1, 0, 0, 0, 1
"c:\Users\chris\source\repos\Cell\Cell\obj\Debug\net8.0-windows\Cell_xzph3isr_wpftmp.AssemblyInfo.cs", "C#", 11, 0, 0, 0, 0, 10, 5, 26
"c:\Users\chris\source\repos\Cell\Cell\obj\Debug\net8.0-windows\Cell_xzph3isr_wpftmp.GeneratedMSBuildEditorConfig.editorconfig", "Properties", 0, 0, 0, 0, 21, 0, 1, 22
"c:\Users\chris\source\repos\Cell\Cell\obj\Debug\net8.0-windows\Cell_xzph3isr_wpftmp.GlobalUsings.g.cs", "C#", 5, 0, 0, 0, 0, 1, 1, 7
"c:\Users\chris\source\repos\Cell\Cell\obj\Debug\net8.0-windows\Cell_xzph3isr_wpftmp.sourcelink.json", "JSON", 0, 0, 0, 1, 0, 0, 0, 1
"c:\Users\chris\source\repos\Cell\Cell\obj\Debug\net8.0-windows\Cell_y2ncba0i_wpftmp.AssemblyInfo.cs", "C#", 11, 0, 0, 0, 0, 10, 5, 26
"c:\Users\chris\source\repos\Cell\Cell\obj\Debug\net8.0-windows\Cell_y2ncba0i_wpftmp.GeneratedMSBuildEditorConfig.editorconfig", "Properties", 0, 0, 0, 0, 21, 0, 1, 22
"c:\Users\chris\source\repos\Cell\Cell\obj\Debug\net8.0-windows\Cell_y2ncba0i_wpftmp.GlobalUsings.g.cs", "C#", 5, 0, 0, 0, 0, 1, 1, 7
"c:\Users\chris\source\repos\Cell\Cell\obj\Debug\net8.0-windows\Cell_y2ncba0i_wpftmp.sourcelink.json", "JSON", 0, 0, 0, 1, 0, 0, 0, 1
"c:\Users\chris\source\repos\Cell\Cell\obj\Debug\net8.0-windows\Cell_y2ogbqot_wpftmp.AssemblyInfo.cs", "C#", 11, 0, 0, 0, 0, 10, 5, 26
"c:\Users\chris\source\repos\Cell\Cell\obj\Debug\net8.0-windows\Cell_y2ogbqot_wpftmp.GeneratedMSBuildEditorConfig.editorconfig", "Properties", 0, 0, 0, 0, 13, 0, 1, 14
"c:\Users\chris\source\repos\Cell\Cell\obj\Debug\net8.0-windows\Cell_y2ogbqot_wpftmp.GlobalUsings.g.cs", "C#", 5, 0, 0, 0, 0, 1, 1, 7
"c:\Users\chris\source\repos\Cell\Cell\obj\Debug\net8.0-windows\Cell_y3ppsncp_wpftmp.AssemblyInfo.cs", "C#", 11, 0, 0, 0, 0, 10, 5, 26
"c:\Users\chris\source\repos\Cell\Cell\obj\Debug\net8.0-windows\Cell_y3ppsncp_wpftmp.GeneratedMSBuildEditorConfig.editorconfig", "Properties", 0, 0, 0, 0, 21, 0, 1, 22
"c:\Users\chris\source\repos\Cell\Cell\obj\Debug\net8.0-windows\Cell_y3ppsncp_wpftmp.GlobalUsings.g.cs", "C#", 5, 0, 0, 0, 0, 1, 1, 7
"c:\Users\chris\source\repos\Cell\Cell\obj\Debug\net8.0-windows\Cell_y3ppsncp_wpftmp.sourcelink.json", "JSON", 0, 0, 0, 1, 0, 0, 0, 1
"c:\Users\chris\source\repos\Cell\Cell\obj\Debug\net8.0-windows\Cell_y3q3wucf_wpftmp.AssemblyInfo.cs", "C#", 11, 0, 0, 0, 0, 10, 5, 26
"c:\Users\chris\source\repos\Cell\Cell\obj\Debug\net8.0-windows\Cell_y3q3wucf_wpftmp.GeneratedMSBuildEditorConfig.editorconfig", "Properties", 0, 0, 0, 0, 21, 0, 1, 22
"c:\Users\chris\source\repos\Cell\Cell\obj\Debug\net8.0-windows\Cell_y3q3wucf_wpftmp.GlobalUsings.g.cs", "C#", 5, 0, 0, 0, 0, 1, 1, 7
"c:\Users\chris\source\repos\Cell\Cell\obj\Debug\net8.0-windows\Cell_y3q3wucf_wpftmp.sourcelink.json", "JSON", 0, 0, 0, 1, 0, 0, 0, 1
"c:\Users\chris\source\repos\Cell\Cell\obj\Debug\net8.0-windows\Cell_y3rw24kr_wpftmp.AssemblyInfo.cs", "C#", 11, 0, 0, 0, 0, 10, 5, 26
"c:\Users\chris\source\repos\Cell\Cell\obj\Debug\net8.0-windows\Cell_y3rw24kr_wpftmp.GeneratedMSBuildEditorConfig.editorconfig", "Properties", 0, 0, 0, 0, 21, 0, 1, 22
"c:\Users\chris\source\repos\Cell\Cell\obj\Debug\net8.0-windows\Cell_y3rw24kr_wpftmp.GlobalUsings.g.cs", "C#", 5, 0, 0, 0, 0, 1, 1, 7
"c:\Users\chris\source\repos\Cell\Cell\obj\Debug\net8.0-windows\Cell_y3rw24kr_wpftmp.sourcelink.json", "JSON", 0, 0, 0, 1, 0, 0, 0, 1
"c:\Users\chris\source\repos\Cell\Cell\obj\Debug\net8.0-windows\Cell_y3tdihny_wpftmp.AssemblyInfo.cs", "C#", 11, 0, 0, 0, 0, 10, 5, 26
"c:\Users\chris\source\repos\Cell\Cell\obj\Debug\net8.0-windows\Cell_y3tdihny_wpftmp.GeneratedMSBuildEditorConfig.editorconfig", "Properties", 0, 0, 0, 0, 21, 0, 1, 22
"c:\Users\chris\source\repos\Cell\Cell\obj\Debug\net8.0-windows\Cell_y3tdihny_wpftmp.GlobalUsings.g.cs", "C#", 5, 0, 0, 0, 0, 1, 1, 7
"c:\Users\chris\source\repos\Cell\Cell\obj\Debug\net8.0-windows\Cell_y3tdihny_wpftmp.sourcelink.json", "JSON", 0, 0, 0, 1, 0, 0, 0, 1
"c:\Users\chris\source\repos\Cell\Cell\obj\Debug\net8.0-windows\Cell_y4hsbcn5_wpftmp.AssemblyInfo.cs", "C#", 11, 0, 0, 0, 0, 10, 5, 26
"c:\Users\chris\source\repos\Cell\Cell\obj\Debug\net8.0-windows\Cell_y4hsbcn5_wpftmp.GeneratedMSBuildEditorConfig.editorconfig", "Properties", 0, 0, 0, 0, 21, 0, 1, 22
"c:\Users\chris\source\repos\Cell\Cell\obj\Debug\net8.0-windows\Cell_y4hsbcn5_wpftmp.GlobalUsings.g.cs", "C#", 5, 0, 0, 0, 0, 1, 1, 7
"c:\Users\chris\source\repos\Cell\Cell\obj\Debug\net8.0-windows\Cell_y4hsbcn5_wpftmp.sourcelink.json", "JSON", 0, 0, 0, 1, 0, 0, 0, 1
"c:\Users\chris\source\repos\Cell\Cell\obj\Debug\net8.0-windows\Cell_y4ztva4f_wpftmp.AssemblyInfo.cs", "C#", 11, 0, 0, 0, 0, 10, 5, 26
"c:\Users\chris\source\repos\Cell\Cell\obj\Debug\net8.0-windows\Cell_y4ztva4f_wpftmp.GeneratedMSBuildEditorConfig.editorconfig", "Properties", 0, 0, 0, 0, 21, 0, 1, 22
"c:\Users\chris\source\repos\Cell\Cell\obj\Debug\net8.0-windows\Cell_y4ztva4f_wpftmp.GlobalUsings.g.cs", "C#", 5, 0, 0, 0, 0, 1, 1, 7
"c:\Users\chris\source\repos\Cell\Cell\obj\Debug\net8.0-windows\Cell_y4ztva4f_wpftmp.sourcelink.json", "JSON", 0, 0, 0, 1, 0, 0, 0, 1
"c:\Users\chris\source\repos\Cell\Cell\obj\Debug\net8.0-windows\Cell_y5l5iqlt_wpftmp.AssemblyInfo.cs", "C#", 11, 0, 0, 0, 0, 10, 5, 26
"c:\Users\chris\source\repos\Cell\Cell\obj\Debug\net8.0-windows\Cell_y5l5iqlt_wpftmp.GeneratedMSBuildEditorConfig.editorconfig", "Properties", 0, 0, 0, 0, 13, 0, 1, 14
"c:\Users\chris\source\repos\Cell\Cell\obj\Debug\net8.0-windows\Cell_y5l5iqlt_wpftmp.GlobalUsings.g.cs", "C#", 5, 0, 0, 0, 0, 1, 1, 7
"c:\Users\chris\source\repos\Cell\Cell\obj\Debug\net8.0-windows\Cell_y5oy2uti_wpftmp.AssemblyInfo.cs", "C#", 11, 0, 0, 0, 0, 10, 5, 26
"c:\Users\chris\source\repos\Cell\Cell\obj\Debug\net8.0-windows\Cell_y5oy2uti_wpftmp.GeneratedMSBuildEditorConfig.editorconfig", "Properties", 0, 0, 0, 0, 21, 0, 1, 22
"c:\Users\chris\source\repos\Cell\Cell\obj\Debug\net8.0-windows\Cell_y5oy2uti_wpftmp.GlobalUsings.g.cs", "C#", 5, 0, 0, 0, 0, 1, 1, 7
"c:\Users\chris\source\repos\Cell\Cell\obj\Debug\net8.0-windows\Cell_y5oy2uti_wpftmp.sourcelink.json", "JSON", 0, 0, 0, 1, 0, 0, 0, 1
"c:\Users\chris\source\repos\Cell\Cell\obj\Debug\net8.0-windows\Cell_ybxzug12_wpftmp.AssemblyInfo.cs", "C#", 11, 0, 0, 0, 0, 10, 5, 26
"c:\Users\chris\source\repos\Cell\Cell\obj\Debug\net8.0-windows\Cell_ybxzug12_wpftmp.GeneratedMSBuildEditorConfig.editorconfig", "Properties", 0, 0, 0, 0, 21, 0, 1, 22
"c:\Users\chris\source\repos\Cell\Cell\obj\Debug\net8.0-windows\Cell_ybxzug12_wpftmp.GlobalUsings.g.cs", "C#", 5, 0, 0, 0, 0, 1, 1, 7
"c:\Users\chris\source\repos\Cell\Cell\obj\Debug\net8.0-windows\Cell_ybxzug12_wpftmp.sourcelink.json", "JSON", 0, 0, 0, 1, 0, 0, 0, 1
"c:\Users\chris\source\repos\Cell\Cell\obj\Debug\net8.0-windows\Cell_ycpkrclg_wpftmp.AssemblyInfo.cs", "C#", 11, 0, 0, 0, 0, 10, 5, 26
"c:\Users\chris\source\repos\Cell\Cell\obj\Debug\net8.0-windows\Cell_ycpkrclg_wpftmp.GeneratedMSBuildEditorConfig.editorconfig", "Properties", 0, 0, 0, 0, 21, 0, 1, 22
"c:\Users\chris\source\repos\Cell\Cell\obj\Debug\net8.0-windows\Cell_ycpkrclg_wpftmp.GlobalUsings.g.cs", "C#", 5, 0, 0, 0, 0, 1, 1, 7
"c:\Users\chris\source\repos\Cell\Cell\obj\Debug\net8.0-windows\Cell_ycpkrclg_wpftmp.sourcelink.json", "JSON", 0, 0, 0, 1, 0, 0, 0, 1
"c:\Users\chris\source\repos\Cell\Cell\obj\Debug\net8.0-windows\Cell_yghf0ucc_wpftmp.AssemblyInfo.cs", "C#", 11, 0, 0, 0, 0, 10, 5, 26
"c:\Users\chris\source\repos\Cell\Cell\obj\Debug\net8.0-windows\Cell_yghf0ucc_wpftmp.GeneratedMSBuildEditorConfig.editorconfig", "Properties", 0, 0, 0, 0, 21, 0, 1, 22
"c:\Users\chris\source\repos\Cell\Cell\obj\Debug\net8.0-windows\Cell_yghf0ucc_wpftmp.GlobalUsings.g.cs", "C#", 5, 0, 0, 0, 0, 1, 1, 7
"c:\Users\chris\source\repos\Cell\Cell\obj\Debug\net8.0-windows\Cell_yghf0ucc_wpftmp.sourcelink.json", "JSON", 0, 0, 0, 1, 0, 0, 0, 1
"c:\Users\chris\source\repos\Cell\Cell\obj\Debug\net8.0-windows\Cell_yhg1c0jr_wpftmp.AssemblyInfo.cs", "C#", 11, 0, 0, 0, 0, 10, 5, 26
"c:\Users\chris\source\repos\Cell\Cell\obj\Debug\net8.0-windows\Cell_yhg1c0jr_wpftmp.GeneratedMSBuildEditorConfig.editorconfig", "Properties", 0, 0, 0, 0, 21, 0, 1, 22
"c:\Users\chris\source\repos\Cell\Cell\obj\Debug\net8.0-windows\Cell_yhg1c0jr_wpftmp.GlobalUsings.g.cs", "C#", 5, 0, 0, 0, 0, 1, 1, 7
"c:\Users\chris\source\repos\Cell\Cell\obj\Debug\net8.0-windows\Cell_yhg1c0jr_wpftmp.sourcelink.json", "JSON", 0, 0, 0, 1, 0, 0, 0, 1
"c:\Users\chris\source\repos\Cell\Cell\obj\Debug\net8.0-windows\Cell_yhxiewzd_wpftmp.AssemblyInfo.cs", "C#", 11, 0, 0, 0, 0, 10, 5, 26
"c:\Users\chris\source\repos\Cell\Cell\obj\Debug\net8.0-windows\Cell_yhxiewzd_wpftmp.GeneratedMSBuildEditorConfig.editorconfig", "Properties", 0, 0, 0, 0, 21, 0, 1, 22
"c:\Users\chris\source\repos\Cell\Cell\obj\Debug\net8.0-windows\Cell_yhxiewzd_wpftmp.GlobalUsings.g.cs", "C#", 5, 0, 0, 0, 0, 1, 1, 7
"c:\Users\chris\source\repos\Cell\Cell\obj\Debug\net8.0-windows\Cell_yhxiewzd_wpftmp.sourcelink.json", "JSON", 0, 0, 0, 1, 0, 0, 0, 1
"c:\Users\chris\source\repos\Cell\Cell\obj\Debug\net8.0-windows\Cell_yikil5pa_wpftmp.AssemblyInfo.cs", "C#", 11, 0, 0, 0, 0, 10, 5, 26
"c:\Users\chris\source\repos\Cell\Cell\obj\Debug\net8.0-windows\Cell_yikil5pa_wpftmp.GeneratedMSBuildEditorConfig.editorconfig", "Properties", 0, 0, 0, 0, 21, 0, 1, 22
"c:\Users\chris\source\repos\Cell\Cell\obj\Debug\net8.0-windows\Cell_yikil5pa_wpftmp.GlobalUsings.g.cs", "C#", 5, 0, 0, 0, 0, 1, 1, 7
"c:\Users\chris\source\repos\Cell\Cell\obj\Debug\net8.0-windows\Cell_yikil5pa_wpftmp.sourcelink.json", "JSON", 0, 0, 0, 1, 0, 0, 0, 1
"c:\Users\chris\source\repos\Cell\Cell\obj\Debug\net8.0-windows\Cell_yilswbw3_wpftmp.AssemblyInfo.cs", "C#", 11, 0, 0, 0, 0, 10, 5, 26
"c:\Users\chris\source\repos\Cell\Cell\obj\Debug\net8.0-windows\Cell_yilswbw3_wpftmp.GeneratedMSBuildEditorConfig.editorconfig", "Properties", 0, 0, 0, 0, 13, 0, 1, 14
"c:\Users\chris\source\repos\Cell\Cell\obj\Debug\net8.0-windows\Cell_yilswbw3_wpftmp.GlobalUsings.g.cs", "C#", 5, 0, 0, 0, 0, 1, 1, 7
"c:\Users\chris\source\repos\Cell\Cell\obj\Debug\net8.0-windows\Cell_yjnghec4_wpftmp.AssemblyInfo.cs", "C#", 11, 0, 0, 0, 0, 10, 5, 26
"c:\Users\chris\source\repos\Cell\Cell\obj\Debug\net8.0-windows\Cell_yjnghec4_wpftmp.GeneratedMSBuildEditorConfig.editorconfig", "Properties", 0, 0, 0, 0, 21, 0, 1, 22
"c:\Users\chris\source\repos\Cell\Cell\obj\Debug\net8.0-windows\Cell_yjnghec4_wpftmp.GlobalUsings.g.cs", "C#", 5, 0, 0, 0, 0, 1, 1, 7
"c:\Users\chris\source\repos\Cell\Cell\obj\Debug\net8.0-windows\Cell_yjnghec4_wpftmp.sourcelink.json", "JSON", 0, 0, 0, 1, 0, 0, 0, 1
"c:\Users\chris\source\repos\Cell\Cell\obj\Debug\net8.0-windows\Cell_yl354bxg_wpftmp.AssemblyInfo.cs", "C#", 11, 0, 0, 0, 0, 10, 5, 26
"c:\Users\chris\source\repos\Cell\Cell\obj\Debug\net8.0-windows\Cell_yl354bxg_wpftmp.GeneratedMSBuildEditorConfig.editorconfig", "Properties", 0, 0, 0, 0, 21, 0, 1, 22
"c:\Users\chris\source\repos\Cell\Cell\obj\Debug\net8.0-windows\Cell_yl354bxg_wpftmp.GlobalUsings.g.cs", "C#", 5, 0, 0, 0, 0, 1, 1, 7
"c:\Users\chris\source\repos\Cell\Cell\obj\Debug\net8.0-windows\Cell_yl354bxg_wpftmp.sourcelink.json", "JSON", 0, 0, 0, 1, 0, 0, 0, 1
"c:\Users\chris\source\repos\Cell\Cell\obj\Debug\net8.0-windows\Cell_ynthkk5k_wpftmp.AssemblyInfo.cs", "C#", 11, 0, 0, 0, 0, 10, 5, 26
"c:\Users\chris\source\repos\Cell\Cell\obj\Debug\net8.0-windows\Cell_ynthkk5k_wpftmp.GeneratedMSBuildEditorConfig.editorconfig", "Properties", 0, 0, 0, 0, 21, 0, 1, 22
"c:\Users\chris\source\repos\Cell\Cell\obj\Debug\net8.0-windows\Cell_ynthkk5k_wpftmp.GlobalUsings.g.cs", "C#", 5, 0, 0, 0, 0, 1, 1, 7
"c:\Users\chris\source\repos\Cell\Cell\obj\Debug\net8.0-windows\Cell_ynthkk5k_wpftmp.sourcelink.json", "JSON", 0, 0, 0, 1, 0, 0, 0, 1
"c:\Users\chris\source\repos\Cell\Cell\obj\Debug\net8.0-windows\Cell_yohqjpcq_wpftmp.AssemblyInfo.cs", "C#", 11, 0, 0, 0, 0, 10, 5, 26
"c:\Users\chris\source\repos\Cell\Cell\obj\Debug\net8.0-windows\Cell_yohqjpcq_wpftmp.GeneratedMSBuildEditorConfig.editorconfig", "Properties", 0, 0, 0, 0, 13, 0, 1, 14
"c:\Users\chris\source\repos\Cell\Cell\obj\Debug\net8.0-windows\Cell_yohqjpcq_wpftmp.GlobalUsings.g.cs", "C#", 5, 0, 0, 0, 0, 1, 1, 7
"c:\Users\chris\source\repos\Cell\Cell\obj\Debug\net8.0-windows\Cell_yoiokckc_wpftmp.AssemblyInfo.cs", "C#", 11, 0, 0, 0, 0, 10, 5, 26
"c:\Users\chris\source\repos\Cell\Cell\obj\Debug\net8.0-windows\Cell_yoiokckc_wpftmp.GeneratedMSBuildEditorConfig.editorconfig", "Properties", 0, 0, 0, 0, 21, 0, 1, 22
"c:\Users\chris\source\repos\Cell\Cell\obj\Debug\net8.0-windows\Cell_yoiokckc_wpftmp.GlobalUsings.g.cs", "C#", 5, 0, 0, 0, 0, 1, 1, 7
"c:\Users\chris\source\repos\Cell\Cell\obj\Debug\net8.0-windows\Cell_yoofb2uz_wpftmp.AssemblyInfo.cs", "C#", 11, 0, 0, 0, 0, 10, 5, 26
"c:\Users\chris\source\repos\Cell\Cell\obj\Debug\net8.0-windows\Cell_yoofb2uz_wpftmp.GeneratedMSBuildEditorConfig.editorconfig", "Properties", 0, 0, 0, 0, 13, 0, 1, 14
"c:\Users\chris\source\repos\Cell\Cell\obj\Debug\net8.0-windows\Cell_yoofb2uz_wpftmp.GlobalUsings.g.cs", "C#", 5, 0, 0, 0, 0, 1, 1, 7
"c:\Users\chris\source\repos\Cell\Cell\obj\Debug\net8.0-windows\Cell_yphy00s0_wpftmp.AssemblyInfo.cs", "C#", 11, 0, 0, 0, 0, 10, 5, 26
"c:\Users\chris\source\repos\Cell\Cell\obj\Debug\net8.0-windows\Cell_yphy00s0_wpftmp.GeneratedMSBuildEditorConfig.editorconfig", "Properties", 0, 0, 0, 0, 13, 0, 1, 14
"c:\Users\chris\source\repos\Cell\Cell\obj\Debug\net8.0-windows\Cell_yphy00s0_wpftmp.GlobalUsings.g.cs", "C#", 5, 0, 0, 0, 0, 1, 1, 7
"c:\Users\chris\source\repos\Cell\Cell\obj\Debug\net8.0-windows\Cell_yppcvqnv_wpftmp.AssemblyInfo.cs", "C#", 11, 0, 0, 0, 0, 10, 5, 26
"c:\Users\chris\source\repos\Cell\Cell\obj\Debug\net8.0-windows\Cell_yppcvqnv_wpftmp.GeneratedMSBuildEditorConfig.editorconfig", "Properties", 0, 0, 0, 0, 21, 0, 1, 22
"c:\Users\chris\source\repos\Cell\Cell\obj\Debug\net8.0-windows\Cell_yppcvqnv_wpftmp.GlobalUsings.g.cs", "C#", 5, 0, 0, 0, 0, 1, 1, 7
"c:\Users\chris\source\repos\Cell\Cell\obj\Debug\net8.0-windows\Cell_yppcvqnv_wpftmp.sourcelink.json", "JSON", 0, 0, 0, 1, 0, 0, 0, 1
"c:\Users\chris\source\repos\Cell\Cell\obj\Debug\net8.0-windows\Cell_yqbmezau_wpftmp.AssemblyInfo.cs", "C#", 11, 0, 0, 0, 0, 10, 5, 26
"c:\Users\chris\source\repos\Cell\Cell\obj\Debug\net8.0-windows\Cell_yqbmezau_wpftmp.GeneratedMSBuildEditorConfig.editorconfig", "Properties", 0, 0, 0, 0, 13, 0, 1, 14
"c:\Users\chris\source\repos\Cell\Cell\obj\Debug\net8.0-windows\Cell_yqbmezau_wpftmp.GlobalUsings.g.cs", "C#", 5, 0, 0, 0, 0, 1, 1, 7
"c:\Users\chris\source\repos\Cell\Cell\obj\Debug\net8.0-windows\Cell_yqqwh2hv_wpftmp.AssemblyInfo.cs", "C#", 11, 0, 0, 0, 0, 10, 5, 26
"c:\Users\chris\source\repos\Cell\Cell\obj\Debug\net8.0-windows\Cell_yqqwh2hv_wpftmp.GeneratedMSBuildEditorConfig.editorconfig", "Properties", 0, 0, 0, 0, 13, 0, 1, 14
"c:\Users\chris\source\repos\Cell\Cell\obj\Debug\net8.0-windows\Cell_yqqwh2hv_wpftmp.GlobalUsings.g.cs", "C#", 5, 0, 0, 0, 0, 1, 1, 7
"c:\Users\chris\source\repos\Cell\Cell\obj\Debug\net8.0-windows\Cell_ytadn2bx_wpftmp.AssemblyInfo.cs", "C#", 11, 0, 0, 0, 0, 10, 5, 26
"c:\Users\chris\source\repos\Cell\Cell\obj\Debug\net8.0-windows\Cell_ytadn2bx_wpftmp.GeneratedMSBuildEditorConfig.editorconfig", "Properties", 0, 0, 0, 0, 21, 0, 1, 22
"c:\Users\chris\source\repos\Cell\Cell\obj\Debug\net8.0-windows\Cell_ytadn2bx_wpftmp.GlobalUsings.g.cs", "C#", 5, 0, 0, 0, 0, 1, 1, 7
"c:\Users\chris\source\repos\Cell\Cell\obj\Debug\net8.0-windows\Cell_ytadn2bx_wpftmp.sourcelink.json", "JSON", 0, 0, 0, 1, 0, 0, 0, 1
"c:\Users\chris\source\repos\Cell\Cell\obj\Debug\net8.0-windows\Cell_yujupgro_wpftmp.AssemblyInfo.cs", "C#", 11, 0, 0, 0, 0, 10, 5, 26
"c:\Users\chris\source\repos\Cell\Cell\obj\Debug\net8.0-windows\Cell_yujupgro_wpftmp.GeneratedMSBuildEditorConfig.editorconfig", "Properties", 0, 0, 0, 0, 13, 0, 1, 14
"c:\Users\chris\source\repos\Cell\Cell\obj\Debug\net8.0-windows\Cell_yujupgro_wpftmp.GlobalUsings.g.cs", "C#", 5, 0, 0, 0, 0, 1, 1, 7
"c:\Users\chris\source\repos\Cell\Cell\obj\Debug\net8.0-windows\Cell_yvfk4yce_wpftmp.AssemblyInfo.cs", "C#", 11, 0, 0, 0, 0, 10, 5, 26
"c:\Users\chris\source\repos\Cell\Cell\obj\Debug\net8.0-windows\Cell_yvfk4yce_wpftmp.GeneratedMSBuildEditorConfig.editorconfig", "Properties", 0, 0, 0, 0, 21, 0, 1, 22
"c:\Users\chris\source\repos\Cell\Cell\obj\Debug\net8.0-windows\Cell_yvfk4yce_wpftmp.GlobalUsings.g.cs", "C#", 5, 0, 0, 0, 0, 1, 1, 7
"c:\Users\chris\source\repos\Cell\Cell\obj\Debug\net8.0-windows\Cell_yvfk4yce_wpftmp.sourcelink.json", "JSON", 0, 0, 0, 1, 0, 0, 0, 1
"c:\Users\chris\source\repos\Cell\Cell\obj\Debug\net8.0-windows\Cell_yvyxxrir_wpftmp.AssemblyInfo.cs", "C#", 11, 0, 0, 0, 0, 10, 5, 26
"c:\Users\chris\source\repos\Cell\Cell\obj\Debug\net8.0-windows\Cell_yvyxxrir_wpftmp.GeneratedMSBuildEditorConfig.editorconfig", "Properties", 0, 0, 0, 0, 21, 0, 1, 22
"c:\Users\chris\source\repos\Cell\Cell\obj\Debug\net8.0-windows\Cell_yvyxxrir_wpftmp.GlobalUsings.g.cs", "C#", 5, 0, 0, 0, 0, 1, 1, 7
"c:\Users\chris\source\repos\Cell\Cell\obj\Debug\net8.0-windows\Cell_yvyxxrir_wpftmp.sourcelink.json", "JSON", 0, 0, 0, 1, 0, 0, 0, 1
"c:\Users\chris\source\repos\Cell\Cell\obj\Debug\net8.0-windows\Cell_ywzsvqub_wpftmp.AssemblyInfo.cs", "C#", 11, 0, 0, 0, 0, 10, 5, 26
"c:\Users\chris\source\repos\Cell\Cell\obj\Debug\net8.0-windows\Cell_ywzsvqub_wpftmp.GeneratedMSBuildEditorConfig.editorconfig", "Properties", 0, 0, 0, 0, 21, 0, 1, 22
"c:\Users\chris\source\repos\Cell\Cell\obj\Debug\net8.0-windows\Cell_ywzsvqub_wpftmp.GlobalUsings.g.cs", "C#", 5, 0, 0, 0, 0, 1, 1, 7
"c:\Users\chris\source\repos\Cell\Cell\obj\Debug\net8.0-windows\Cell_ywzsvqub_wpftmp.sourcelink.json", "JSON", 0, 0, 0, 1, 0, 0, 0, 1
"c:\Users\chris\source\repos\Cell\Cell\obj\Debug\net8.0-windows\Cell_yxgxopvu_wpftmp.AssemblyInfo.cs", "C#", 11, 0, 0, 0, 0, 10, 5, 26
"c:\Users\chris\source\repos\Cell\Cell\obj\Debug\net8.0-windows\Cell_yxgxopvu_wpftmp.GeneratedMSBuildEditorConfig.editorconfig", "Properties", 0, 0, 0, 0, 21, 0, 1, 22
"c:\Users\chris\source\repos\Cell\Cell\obj\Debug\net8.0-windows\Cell_yxgxopvu_wpftmp.GlobalUsings.g.cs", "C#", 5, 0, 0, 0, 0, 1, 1, 7
"c:\Users\chris\source\repos\Cell\Cell\obj\Debug\net8.0-windows\Cell_yxgxopvu_wpftmp.sourcelink.json", "JSON", 0, 0, 0, 1, 0, 0, 0, 1
"c:\Users\chris\source\repos\Cell\Cell\obj\Debug\net8.0-windows\Cell_yxkxrwnx_wpftmp.AssemblyInfo.cs", "C#", 11, 0, 0, 0, 0, 10, 5, 26
"c:\Users\chris\source\repos\Cell\Cell\obj\Debug\net8.0-windows\Cell_yxkxrwnx_wpftmp.GeneratedMSBuildEditorConfig.editorconfig", "Properties", 0, 0, 0, 0, 21, 0, 1, 22
"c:\Users\chris\source\repos\Cell\Cell\obj\Debug\net8.0-windows\Cell_yxkxrwnx_wpftmp.GlobalUsings.g.cs", "C#", 5, 0, 0, 0, 0, 1, 1, 7
"c:\Users\chris\source\repos\Cell\Cell\obj\Debug\net8.0-windows\Cell_yxkxrwnx_wpftmp.sourcelink.json", "JSON", 0, 0, 0, 1, 0, 0, 0, 1
"c:\Users\chris\source\repos\Cell\Cell\obj\Debug\net8.0-windows\Cell_yyf1pztp_wpftmp.AssemblyInfo.cs", "C#", 11, 0, 0, 0, 0, 10, 5, 26
"c:\Users\chris\source\repos\Cell\Cell\obj\Debug\net8.0-windows\Cell_yyf1pztp_wpftmp.GeneratedMSBuildEditorConfig.editorconfig", "Properties", 0, 0, 0, 0, 21, 0, 1, 22
"c:\Users\chris\source\repos\Cell\Cell\obj\Debug\net8.0-windows\Cell_yyf1pztp_wpftmp.GlobalUsings.g.cs", "C#", 5, 0, 0, 0, 0, 1, 1, 7
"c:\Users\chris\source\repos\Cell\Cell\obj\Debug\net8.0-windows\Cell_yyf1pztp_wpftmp.sourcelink.json", "JSON", 0, 0, 0, 1, 0, 0, 0, 1
"c:\Users\chris\source\repos\Cell\Cell\obj\Debug\net8.0-windows\Cell_yygxnau3_wpftmp.AssemblyInfo.cs", "C#", 11, 0, 0, 0, 0, 10, 5, 26
"c:\Users\chris\source\repos\Cell\Cell\obj\Debug\net8.0-windows\Cell_yygxnau3_wpftmp.GeneratedMSBuildEditorConfig.editorconfig", "Properties", 0, 0, 0, 0, 21, 0, 1, 22
"c:\Users\chris\source\repos\Cell\Cell\obj\Debug\net8.0-windows\Cell_yygxnau3_wpftmp.GlobalUsings.g.cs", "C#", 5, 0, 0, 0, 0, 1, 1, 7
"c:\Users\chris\source\repos\Cell\Cell\obj\Debug\net8.0-windows\Cell_yyotw3h2_wpftmp.AssemblyInfo.cs", "C#", 11, 0, 0, 0, 0, 10, 5, 26
"c:\Users\chris\source\repos\Cell\Cell\obj\Debug\net8.0-windows\Cell_yyotw3h2_wpftmp.GeneratedMSBuildEditorConfig.editorconfig", "Properties", 0, 0, 0, 0, 21, 0, 1, 22
"c:\Users\chris\source\repos\Cell\Cell\obj\Debug\net8.0-windows\Cell_yyotw3h2_wpftmp.GlobalUsings.g.cs", "C#", 5, 0, 0, 0, 0, 1, 1, 7
"c:\Users\chris\source\repos\Cell\Cell\obj\Debug\net8.0-windows\Cell_yyotw3h2_wpftmp.sourcelink.json", "JSON", 0, 0, 0, 1, 0, 0, 0, 1
"c:\Users\chris\source\repos\Cell\Cell\obj\Debug\net8.0-windows\Cell_z0dt5ibr_wpftmp.AssemblyInfo.cs", "C#", 11, 0, 0, 0, 0, 10, 5, 26
"c:\Users\chris\source\repos\Cell\Cell\obj\Debug\net8.0-windows\Cell_z0dt5ibr_wpftmp.GeneratedMSBuildEditorConfig.editorconfig", "Properties", 0, 0, 0, 0, 21, 0, 1, 22
"c:\Users\chris\source\repos\Cell\Cell\obj\Debug\net8.0-windows\Cell_z0dt5ibr_wpftmp.GlobalUsings.g.cs", "C#", 5, 0, 0, 0, 0, 1, 1, 7
"c:\Users\chris\source\repos\Cell\Cell\obj\Debug\net8.0-windows\Cell_z0dt5ibr_wpftmp.sourcelink.json", "JSON", 0, 0, 0, 1, 0, 0, 0, 1
"c:\Users\chris\source\repos\Cell\Cell\obj\Debug\net8.0-windows\Cell_z1ptp4u5_wpftmp.AssemblyInfo.cs", "C#", 11, 0, 0, 0, 0, 10, 5, 26
"c:\Users\chris\source\repos\Cell\Cell\obj\Debug\net8.0-windows\Cell_z1ptp4u5_wpftmp.GeneratedMSBuildEditorConfig.editorconfig", "Properties", 0, 0, 0, 0, 21, 0, 1, 22
"c:\Users\chris\source\repos\Cell\Cell\obj\Debug\net8.0-windows\Cell_z1ptp4u5_wpftmp.GlobalUsings.g.cs", "C#", 5, 0, 0, 0, 0, 1, 1, 7
"c:\Users\chris\source\repos\Cell\Cell\obj\Debug\net8.0-windows\Cell_z1ptp4u5_wpftmp.sourcelink.json", "JSON", 0, 0, 0, 1, 0, 0, 0, 1
"c:\Users\chris\source\repos\Cell\Cell\obj\Debug\net8.0-windows\Cell_z20xaa5a_wpftmp.AssemblyInfo.cs", "C#", 11, 0, 0, 0, 0, 10, 5, 26
"c:\Users\chris\source\repos\Cell\Cell\obj\Debug\net8.0-windows\Cell_z20xaa5a_wpftmp.GeneratedMSBuildEditorConfig.editorconfig", "Properties", 0, 0, 0, 0, 21, 0, 1, 22
"c:\Users\chris\source\repos\Cell\Cell\obj\Debug\net8.0-windows\Cell_z20xaa5a_wpftmp.GlobalUsings.g.cs", "C#", 5, 0, 0, 0, 0, 1, 1, 7
"c:\Users\chris\source\repos\Cell\Cell\obj\Debug\net8.0-windows\Cell_z20xaa5a_wpftmp.sourcelink.json", "JSON", 0, 0, 0, 1, 0, 0, 0, 1
"c:\Users\chris\source\repos\Cell\Cell\obj\Debug\net8.0-windows\Cell_z24pfdti_wpftmp.AssemblyInfo.cs", "C#", 11, 0, 0, 0, 0, 10, 5, 26
"c:\Users\chris\source\repos\Cell\Cell\obj\Debug\net8.0-windows\Cell_z24pfdti_wpftmp.GeneratedMSBuildEditorConfig.editorconfig", "Properties", 0, 0, 0, 0, 21, 0, 1, 22
"c:\Users\chris\source\repos\Cell\Cell\obj\Debug\net8.0-windows\Cell_z24pfdti_wpftmp.GlobalUsings.g.cs", "C#", 5, 0, 0, 0, 0, 1, 1, 7
"c:\Users\chris\source\repos\Cell\Cell\obj\Debug\net8.0-windows\Cell_z24pfdti_wpftmp.sourcelink.json", "JSON", 0, 0, 0, 1, 0, 0, 0, 1
"c:\Users\chris\source\repos\Cell\Cell\obj\Debug\net8.0-windows\Cell_z2ddejkz_wpftmp.AssemblyInfo.cs", "C#", 11, 0, 0, 0, 0, 10, 5, 26
"c:\Users\chris\source\repos\Cell\Cell\obj\Debug\net8.0-windows\Cell_z2ddejkz_wpftmp.GeneratedMSBuildEditorConfig.editorconfig", "Properties", 0, 0, 0, 0, 21, 0, 1, 22
"c:\Users\chris\source\repos\Cell\Cell\obj\Debug\net8.0-windows\Cell_z2ddejkz_wpftmp.GlobalUsings.g.cs", "C#", 5, 0, 0, 0, 0, 1, 1, 7
"c:\Users\chris\source\repos\Cell\Cell\obj\Debug\net8.0-windows\Cell_z2ddejkz_wpftmp.sourcelink.json", "JSON", 0, 0, 0, 1, 0, 0, 0, 1
"c:\Users\chris\source\repos\Cell\Cell\obj\Debug\net8.0-windows\Cell_z2hctwic_wpftmp.AssemblyInfo.cs", "C#", 11, 0, 0, 0, 0, 10, 5, 26
"c:\Users\chris\source\repos\Cell\Cell\obj\Debug\net8.0-windows\Cell_z2hctwic_wpftmp.GeneratedMSBuildEditorConfig.editorconfig", "Properties", 0, 0, 0, 0, 21, 0, 1, 22
"c:\Users\chris\source\repos\Cell\Cell\obj\Debug\net8.0-windows\Cell_z2hctwic_wpftmp.GlobalUsings.g.cs", "C#", 5, 0, 0, 0, 0, 1, 1, 7
"c:\Users\chris\source\repos\Cell\Cell\obj\Debug\net8.0-windows\Cell_z2hctwic_wpftmp.sourcelink.json", "JSON", 0, 0, 0, 1, 0, 0, 0, 1
"c:\Users\chris\source\repos\Cell\Cell\obj\Debug\net8.0-windows\Cell_z3gztt2r_wpftmp.AssemblyInfo.cs", "C#", 11, 0, 0, 0, 0, 10, 5, 26
"c:\Users\chris\source\repos\Cell\Cell\obj\Debug\net8.0-windows\Cell_z3gztt2r_wpftmp.GeneratedMSBuildEditorConfig.editorconfig", "Properties", 0, 0, 0, 0, 21, 0, 1, 22
"c:\Users\chris\source\repos\Cell\Cell\obj\Debug\net8.0-windows\Cell_z3gztt2r_wpftmp.GlobalUsings.g.cs", "C#", 5, 0, 0, 0, 0, 1, 1, 7
"c:\Users\chris\source\repos\Cell\Cell\obj\Debug\net8.0-windows\Cell_z3gztt2r_wpftmp.sourcelink.json", "JSON", 0, 0, 0, 1, 0, 0, 0, 1
"c:\Users\chris\source\repos\Cell\Cell\obj\Debug\net8.0-windows\Cell_z43nt4dm_wpftmp.AssemblyInfo.cs", "C#", 11, 0, 0, 0, 0, 10, 5, 26
"c:\Users\chris\source\repos\Cell\Cell\obj\Debug\net8.0-windows\Cell_z43nt4dm_wpftmp.GeneratedMSBuildEditorConfig.editorconfig", "Properties", 0, 0, 0, 0, 13, 0, 1, 14
"c:\Users\chris\source\repos\Cell\Cell\obj\Debug\net8.0-windows\Cell_z43nt4dm_wpftmp.GlobalUsings.g.cs", "C#", 5, 0, 0, 0, 0, 1, 1, 7
"c:\Users\chris\source\repos\Cell\Cell\obj\Debug\net8.0-windows\Cell_z4xkptzq_wpftmp.AssemblyInfo.cs", "C#", 11, 0, 0, 0, 0, 10, 5, 26
"c:\Users\chris\source\repos\Cell\Cell\obj\Debug\net8.0-windows\Cell_z4xkptzq_wpftmp.GeneratedMSBuildEditorConfig.editorconfig", "Properties", 0, 0, 0, 0, 13, 0, 1, 14
"c:\Users\chris\source\repos\Cell\Cell\obj\Debug\net8.0-windows\Cell_z4xkptzq_wpftmp.GlobalUsings.g.cs", "C#", 5, 0, 0, 0, 0, 1, 1, 7
"c:\Users\chris\source\repos\Cell\Cell\obj\Debug\net8.0-windows\Cell_z4yd0431_wpftmp.AssemblyInfo.cs", "C#", 11, 0, 0, 0, 0, 10, 5, 26
"c:\Users\chris\source\repos\Cell\Cell\obj\Debug\net8.0-windows\Cell_z4yd0431_wpftmp.GeneratedMSBuildEditorConfig.editorconfig", "Properties", 0, 0, 0, 0, 13, 0, 1, 14
"c:\Users\chris\source\repos\Cell\Cell\obj\Debug\net8.0-windows\Cell_z4yd0431_wpftmp.GlobalUsings.g.cs", "C#", 5, 0, 0, 0, 0, 1, 1, 7
"c:\Users\chris\source\repos\Cell\Cell\obj\Debug\net8.0-windows\Cell_z5qkbzfu_wpftmp.AssemblyInfo.cs", "C#", 11, 0, 0, 0, 0, 10, 5, 26
"c:\Users\chris\source\repos\Cell\Cell\obj\Debug\net8.0-windows\Cell_z5qkbzfu_wpftmp.GeneratedMSBuildEditorConfig.editorconfig", "Properties", 0, 0, 0, 0, 21, 0, 1, 22
"c:\Users\chris\source\repos\Cell\Cell\obj\Debug\net8.0-windows\Cell_z5qkbzfu_wpftmp.GlobalUsings.g.cs", "C#", 5, 0, 0, 0, 0, 1, 1, 7
"c:\Users\chris\source\repos\Cell\Cell\obj\Debug\net8.0-windows\Cell_z5qkbzfu_wpftmp.sourcelink.json", "JSON", 0, 0, 0, 1, 0, 0, 0, 1
"c:\Users\chris\source\repos\Cell\Cell\obj\Debug\net8.0-windows\Cell_z5uuna22_wpftmp.AssemblyInfo.cs", "C#", 11, 0, 0, 0, 0, 10, 5, 26
"c:\Users\chris\source\repos\Cell\Cell\obj\Debug\net8.0-windows\Cell_z5uuna22_wpftmp.GeneratedMSBuildEditorConfig.editorconfig", "Properties", 0, 0, 0, 0, 21, 0, 1, 22
"c:\Users\chris\source\repos\Cell\Cell\obj\Debug\net8.0-windows\Cell_z5uuna22_wpftmp.GlobalUsings.g.cs", "C#", 5, 0, 0, 0, 0, 1, 1, 7
"c:\Users\chris\source\repos\Cell\Cell\obj\Debug\net8.0-windows\Cell_z5uuna22_wpftmp.sourcelink.json", "JSON", 0, 0, 0, 1, 0, 0, 0, 1
"c:\Users\chris\source\repos\Cell\Cell\obj\Debug\net8.0-windows\Cell_zclw3sg1_wpftmp.AssemblyInfo.cs", "C#", 11, 0, 0, 0, 0, 10, 5, 26
"c:\Users\chris\source\repos\Cell\Cell\obj\Debug\net8.0-windows\Cell_zclw3sg1_wpftmp.GeneratedMSBuildEditorConfig.editorconfig", "Properties", 0, 0, 0, 0, 21, 0, 1, 22
"c:\Users\chris\source\repos\Cell\Cell\obj\Debug\net8.0-windows\Cell_zclw3sg1_wpftmp.GlobalUsings.g.cs", "C#", 5, 0, 0, 0, 0, 1, 1, 7
"c:\Users\chris\source\repos\Cell\Cell\obj\Debug\net8.0-windows\Cell_zclw3sg1_wpftmp.sourcelink.json", "JSON", 0, 0, 0, 1, 0, 0, 0, 1
"c:\Users\chris\source\repos\Cell\Cell\obj\Debug\net8.0-windows\Cell_zcypbuq2_wpftmp.AssemblyInfo.cs", "C#", 11, 0, 0, 0, 0, 10, 5, 26
"c:\Users\chris\source\repos\Cell\Cell\obj\Debug\net8.0-windows\Cell_zcypbuq2_wpftmp.GeneratedMSBuildEditorConfig.editorconfig", "Properties", 0, 0, 0, 0, 21, 0, 1, 22
"c:\Users\chris\source\repos\Cell\Cell\obj\Debug\net8.0-windows\Cell_zcypbuq2_wpftmp.GlobalUsings.g.cs", "C#", 5, 0, 0, 0, 0, 1, 1, 7
"c:\Users\chris\source\repos\Cell\Cell\obj\Debug\net8.0-windows\Cell_zcypbuq2_wpftmp.sourcelink.json", "JSON", 0, 0, 0, 1, 0, 0, 0, 1
"c:\Users\chris\source\repos\Cell\Cell\obj\Debug\net8.0-windows\Cell_zddwz4tg_wpftmp.AssemblyInfo.cs", "C#", 11, 0, 0, 0, 0, 10, 5, 26
"c:\Users\chris\source\repos\Cell\Cell\obj\Debug\net8.0-windows\Cell_zddwz4tg_wpftmp.GeneratedMSBuildEditorConfig.editorconfig", "Properties", 0, 0, 0, 0, 21, 0, 1, 22
"c:\Users\chris\source\repos\Cell\Cell\obj\Debug\net8.0-windows\Cell_zddwz4tg_wpftmp.GlobalUsings.g.cs", "C#", 5, 0, 0, 0, 0, 1, 1, 7
"c:\Users\chris\source\repos\Cell\Cell\obj\Debug\net8.0-windows\Cell_zddwz4tg_wpftmp.sourcelink.json", "JSON", 0, 0, 0, 1, 0, 0, 0, 1
"c:\Users\chris\source\repos\Cell\Cell\obj\Debug\net8.0-windows\Cell_zdlnavfh_wpftmp.AssemblyInfo.cs", "C#", 11, 0, 0, 0, 0, 10, 5, 26
"c:\Users\chris\source\repos\Cell\Cell\obj\Debug\net8.0-windows\Cell_zdlnavfh_wpftmp.GeneratedMSBuildEditorConfig.editorconfig", "Properties", 0, 0, 0, 0, 21, 0, 1, 22
"c:\Users\chris\source\repos\Cell\Cell\obj\Debug\net8.0-windows\Cell_zdlnavfh_wpftmp.GlobalUsings.g.cs", "C#", 5, 0, 0, 0, 0, 1, 1, 7
"c:\Users\chris\source\repos\Cell\Cell\obj\Debug\net8.0-windows\Cell_zdlnavfh_wpftmp.sourcelink.json", "JSON", 0, 0, 0, 1, 0, 0, 0, 1
"c:\Users\chris\source\repos\Cell\Cell\obj\Debug\net8.0-windows\Cell_zdmx3tft_wpftmp.AssemblyInfo.cs", "C#", 11, 0, 0, 0, 0, 10, 5, 26
"c:\Users\chris\source\repos\Cell\Cell\obj\Debug\net8.0-windows\Cell_zdmx3tft_wpftmp.GeneratedMSBuildEditorConfig.editorconfig", "Properties", 0, 0, 0, 0, 21, 0, 1, 22
"c:\Users\chris\source\repos\Cell\Cell\obj\Debug\net8.0-windows\Cell_zdmx3tft_wpftmp.GlobalUsings.g.cs", "C#", 5, 0, 0, 0, 0, 1, 1, 7
"c:\Users\chris\source\repos\Cell\Cell\obj\Debug\net8.0-windows\Cell_zdmx3tft_wpftmp.sourcelink.json", "JSON", 0, 0, 0, 1, 0, 0, 0, 1
"c:\Users\chris\source\repos\Cell\Cell\obj\Debug\net8.0-windows\Cell_zemf5guc_wpftmp.AssemblyInfo.cs", "C#", 11, 0, 0, 0, 0, 10, 5, 26
"c:\Users\chris\source\repos\Cell\Cell\obj\Debug\net8.0-windows\Cell_zemf5guc_wpftmp.GeneratedMSBuildEditorConfig.editorconfig", "Properties", 0, 0, 0, 0, 21, 0, 1, 22
"c:\Users\chris\source\repos\Cell\Cell\obj\Debug\net8.0-windows\Cell_zemf5guc_wpftmp.GlobalUsings.g.cs", "C#", 5, 0, 0, 0, 0, 1, 1, 7
"c:\Users\chris\source\repos\Cell\Cell\obj\Debug\net8.0-windows\Cell_zemf5guc_wpftmp.sourcelink.json", "JSON", 0, 0, 0, 1, 0, 0, 0, 1
"c:\Users\chris\source\repos\Cell\Cell\obj\Debug\net8.0-windows\Cell_zg0j4igr_wpftmp.AssemblyInfo.cs", "C#", 11, 0, 0, 0, 0, 10, 5, 26
"c:\Users\chris\source\repos\Cell\Cell\obj\Debug\net8.0-windows\Cell_zg0j4igr_wpftmp.GeneratedMSBuildEditorConfig.editorconfig", "Properties", 0, 0, 0, 0, 21, 0, 1, 22
"c:\Users\chris\source\repos\Cell\Cell\obj\Debug\net8.0-windows\Cell_zg0j4igr_wpftmp.GlobalUsings.g.cs", "C#", 5, 0, 0, 0, 0, 1, 1, 7
"c:\Users\chris\source\repos\Cell\Cell\obj\Debug\net8.0-windows\Cell_zg0j4igr_wpftmp.sourcelink.json", "JSON", 0, 0, 0, 1, 0, 0, 0, 1
"c:\Users\chris\source\repos\Cell\Cell\obj\Debug\net8.0-windows\Cell_zgcy0lpp_wpftmp.AssemblyInfo.cs", "C#", 11, 0, 0, 0, 0, 10, 5, 26
"c:\Users\chris\source\repos\Cell\Cell\obj\Debug\net8.0-windows\Cell_zgcy0lpp_wpftmp.GeneratedMSBuildEditorConfig.editorconfig", "Properties", 0, 0, 0, 0, 13, 0, 1, 14
"c:\Users\chris\source\repos\Cell\Cell\obj\Debug\net8.0-windows\Cell_zgcy0lpp_wpftmp.GlobalUsings.g.cs", "C#", 5, 0, 0, 0, 0, 1, 1, 7
"c:\Users\chris\source\repos\Cell\Cell\obj\Debug\net8.0-windows\Cell_zhpd5voh_wpftmp.AssemblyInfo.cs", "C#", 11, 0, 0, 0, 0, 10, 5, 26
"c:\Users\chris\source\repos\Cell\Cell\obj\Debug\net8.0-windows\Cell_zhpd5voh_wpftmp.GeneratedMSBuildEditorConfig.editorconfig", "Properties", 0, 0, 0, 0, 21, 0, 1, 22
"c:\Users\chris\source\repos\Cell\Cell\obj\Debug\net8.0-windows\Cell_zhpd5voh_wpftmp.GlobalUsings.g.cs", "C#", 5, 0, 0, 0, 0, 1, 1, 7
"c:\Users\chris\source\repos\Cell\Cell\obj\Debug\net8.0-windows\Cell_zhpd5voh_wpftmp.sourcelink.json", "JSON", 0, 0, 0, 1, 0, 0, 0, 1
"c:\Users\chris\source\repos\Cell\Cell\obj\Debug\net8.0-windows\Cell_zhsjmnsq_wpftmp.AssemblyInfo.cs", "C#", 11, 0, 0, 0, 0, 10, 5, 26
"c:\Users\chris\source\repos\Cell\Cell\obj\Debug\net8.0-windows\Cell_zhsjmnsq_wpftmp.GeneratedMSBuildEditorConfig.editorconfig", "Properties", 0, 0, 0, 0, 21, 0, 1, 22
"c:\Users\chris\source\repos\Cell\Cell\obj\Debug\net8.0-windows\Cell_zhsjmnsq_wpftmp.GlobalUsings.g.cs", "C#", 5, 0, 0, 0, 0, 1, 1, 7
"c:\Users\chris\source\repos\Cell\Cell\obj\Debug\net8.0-windows\Cell_zhulfahh_wpftmp.AssemblyInfo.cs", "C#", 11, 0, 0, 0, 0, 10, 5, 26
"c:\Users\chris\source\repos\Cell\Cell\obj\Debug\net8.0-windows\Cell_zhulfahh_wpftmp.GeneratedMSBuildEditorConfig.editorconfig", "Properties", 0, 0, 0, 0, 21, 0, 1, 22
"c:\Users\chris\source\repos\Cell\Cell\obj\Debug\net8.0-windows\Cell_zhulfahh_wpftmp.GlobalUsings.g.cs", "C#", 5, 0, 0, 0, 0, 1, 1, 7
"c:\Users\chris\source\repos\Cell\Cell\obj\Debug\net8.0-windows\Cell_zhulfahh_wpftmp.sourcelink.json", "JSON", 0, 0, 0, 1, 0, 0, 0, 1
"c:\Users\chris\source\repos\Cell\Cell\obj\Debug\net8.0-windows\Cell_ziicbvlv_wpftmp.AssemblyInfo.cs", "C#", 11, 0, 0, 0, 0, 10, 5, 26
"c:\Users\chris\source\repos\Cell\Cell\obj\Debug\net8.0-windows\Cell_ziicbvlv_wpftmp.GeneratedMSBuildEditorConfig.editorconfig", "Properties", 0, 0, 0, 0, 21, 0, 1, 22
"c:\Users\chris\source\repos\Cell\Cell\obj\Debug\net8.0-windows\Cell_ziicbvlv_wpftmp.GlobalUsings.g.cs", "C#", 5, 0, 0, 0, 0, 1, 1, 7
"c:\Users\chris\source\repos\Cell\Cell\obj\Debug\net8.0-windows\Cell_ziicbvlv_wpftmp.sourcelink.json", "JSON", 0, 0, 0, 1, 0, 0, 0, 1
"c:\Users\chris\source\repos\Cell\Cell\obj\Debug\net8.0-windows\Cell_zik5cxlo_wpftmp.AssemblyInfo.cs", "C#", 11, 0, 0, 0, 0, 10, 5, 26
"c:\Users\chris\source\repos\Cell\Cell\obj\Debug\net8.0-windows\Cell_zik5cxlo_wpftmp.GeneratedMSBuildEditorConfig.editorconfig", "Properties", 0, 0, 0, 0, 13, 0, 1, 14
"c:\Users\chris\source\repos\Cell\Cell\obj\Debug\net8.0-windows\Cell_zik5cxlo_wpftmp.GlobalUsings.g.cs", "C#", 5, 0, 0, 0, 0, 1, 1, 7
"c:\Users\chris\source\repos\Cell\Cell\obj\Debug\net8.0-windows\Cell_zj141hlm_wpftmp.AssemblyInfo.cs", "C#", 11, 0, 0, 0, 0, 10, 5, 26
"c:\Users\chris\source\repos\Cell\Cell\obj\Debug\net8.0-windows\Cell_zj141hlm_wpftmp.GeneratedMSBuildEditorConfig.editorconfig", "Properties", 0, 0, 0, 0, 21, 0, 1, 22
"c:\Users\chris\source\repos\Cell\Cell\obj\Debug\net8.0-windows\Cell_zj141hlm_wpftmp.GlobalUsings.g.cs", "C#", 5, 0, 0, 0, 0, 1, 1, 7
"c:\Users\chris\source\repos\Cell\Cell\obj\Debug\net8.0-windows\Cell_zj141hlm_wpftmp.sourcelink.json", "JSON", 0, 0, 0, 1, 0, 0, 0, 1
"c:\Users\chris\source\repos\Cell\Cell\obj\Debug\net8.0-windows\Cell_zj5ggbqn_wpftmp.AssemblyInfo.cs", "C#", 11, 0, 0, 0, 0, 10, 5, 26
"c:\Users\chris\source\repos\Cell\Cell\obj\Debug\net8.0-windows\Cell_zj5ggbqn_wpftmp.GeneratedMSBuildEditorConfig.editorconfig", "Properties", 0, 0, 0, 0, 21, 0, 1, 22
"c:\Users\chris\source\repos\Cell\Cell\obj\Debug\net8.0-windows\Cell_zj5ggbqn_wpftmp.GlobalUsings.g.cs", "C#", 5, 0, 0, 0, 0, 1, 1, 7
"c:\Users\chris\source\repos\Cell\Cell\obj\Debug\net8.0-windows\Cell_zj5ggbqn_wpftmp.sourcelink.json", "JSON", 0, 0, 0, 1, 0, 0, 0, 1
"c:\Users\chris\source\repos\Cell\Cell\obj\Debug\net8.0-windows\Cell_zjni53hk_wpftmp.AssemblyInfo.cs", "C#", 11, 0, 0, 0, 0, 10, 5, 26
"c:\Users\chris\source\repos\Cell\Cell\obj\Debug\net8.0-windows\Cell_zjni53hk_wpftmp.GeneratedMSBuildEditorConfig.editorconfig", "Properties", 0, 0, 0, 0, 21, 0, 1, 22
"c:\Users\chris\source\repos\Cell\Cell\obj\Debug\net8.0-windows\Cell_zjni53hk_wpftmp.GlobalUsings.g.cs", "C#", 5, 0, 0, 0, 0, 1, 1, 7
"c:\Users\chris\source\repos\Cell\Cell\obj\Debug\net8.0-windows\Cell_zjni53hk_wpftmp.sourcelink.json", "JSON", 0, 0, 0, 1, 0, 0, 0, 1
"c:\Users\chris\source\repos\Cell\Cell\obj\Debug\net8.0-windows\Cell_zkfg0skb_wpftmp.AssemblyInfo.cs", "C#", 11, 0, 0, 0, 0, 10, 5, 26
"c:\Users\chris\source\repos\Cell\Cell\obj\Debug\net8.0-windows\Cell_zkfg0skb_wpftmp.GeneratedMSBuildEditorConfig.editorconfig", "Properties", 0, 0, 0, 0, 21, 0, 1, 22
"c:\Users\chris\source\repos\Cell\Cell\obj\Debug\net8.0-windows\Cell_zkfg0skb_wpftmp.GlobalUsings.g.cs", "C#", 5, 0, 0, 0, 0, 1, 1, 7
"c:\Users\chris\source\repos\Cell\Cell\obj\Debug\net8.0-windows\Cell_zkfg0skb_wpftmp.sourcelink.json", "JSON", 0, 0, 0, 1, 0, 0, 0, 1
"c:\Users\chris\source\repos\Cell\Cell\obj\Debug\net8.0-windows\Cell_zljeluel_wpftmp.AssemblyInfo.cs", "C#", 11, 0, 0, 0, 0, 10, 5, 26
"c:\Users\chris\source\repos\Cell\Cell\obj\Debug\net8.0-windows\Cell_zljeluel_wpftmp.GeneratedMSBuildEditorConfig.editorconfig", "Properties", 0, 0, 0, 0, 21, 0, 1, 22
"c:\Users\chris\source\repos\Cell\Cell\obj\Debug\net8.0-windows\Cell_zljeluel_wpftmp.GlobalUsings.g.cs", "C#", 5, 0, 0, 0, 0, 1, 1, 7
"c:\Users\chris\source\repos\Cell\Cell\obj\Debug\net8.0-windows\Cell_zljeluel_wpftmp.sourcelink.json", "JSON", 0, 0, 0, 1, 0, 0, 0, 1
"c:\Users\chris\source\repos\Cell\Cell\obj\Debug\net8.0-windows\Cell_zlogo3zi_wpftmp.AssemblyInfo.cs", "C#", 11, 0, 0, 0, 0, 10, 5, 26
"c:\Users\chris\source\repos\Cell\Cell\obj\Debug\net8.0-windows\Cell_zlogo3zi_wpftmp.GeneratedMSBuildEditorConfig.editorconfig", "Properties", 0, 0, 0, 0, 21, 0, 1, 22
"c:\Users\chris\source\repos\Cell\Cell\obj\Debug\net8.0-windows\Cell_zlogo3zi_wpftmp.GlobalUsings.g.cs", "C#", 5, 0, 0, 0, 0, 1, 1, 7
"c:\Users\chris\source\repos\Cell\Cell\obj\Debug\net8.0-windows\Cell_zlogo3zi_wpftmp.sourcelink.json", "JSON", 0, 0, 0, 1, 0, 0, 0, 1
"c:\Users\chris\source\repos\Cell\Cell\obj\Debug\net8.0-windows\Cell_zlp0wzvt_wpftmp.AssemblyInfo.cs", "C#", 11, 0, 0, 0, 0, 10, 5, 26
"c:\Users\chris\source\repos\Cell\Cell\obj\Debug\net8.0-windows\Cell_zlp0wzvt_wpftmp.GeneratedMSBuildEditorConfig.editorconfig", "Properties", 0, 0, 0, 0, 21, 0, 1, 22
"c:\Users\chris\source\repos\Cell\Cell\obj\Debug\net8.0-windows\Cell_zlp0wzvt_wpftmp.GlobalUsings.g.cs", "C#", 5, 0, 0, 0, 0, 1, 1, 7
"c:\Users\chris\source\repos\Cell\Cell\obj\Debug\net8.0-windows\Cell_zlp0wzvt_wpftmp.sourcelink.json", "JSON", 0, 0, 0, 1, 0, 0, 0, 1
"c:\Users\chris\source\repos\Cell\Cell\obj\Debug\net8.0-windows\Cell_zn0kzw2v_wpftmp.AssemblyInfo.cs", "C#", 11, 0, 0, 0, 0, 10, 5, 26
"c:\Users\chris\source\repos\Cell\Cell\obj\Debug\net8.0-windows\Cell_zn0kzw2v_wpftmp.GeneratedMSBuildEditorConfig.editorconfig", "Properties", 0, 0, 0, 0, 21, 0, 1, 22
"c:\Users\chris\source\repos\Cell\Cell\obj\Debug\net8.0-windows\Cell_zn0kzw2v_wpftmp.GlobalUsings.g.cs", "C#", 5, 0, 0, 0, 0, 1, 1, 7
"c:\Users\chris\source\repos\Cell\Cell\obj\Debug\net8.0-windows\Cell_zn0kzw2v_wpftmp.sourcelink.json", "JSON", 0, 0, 0, 1, 0, 0, 0, 1
"c:\Users\chris\source\repos\Cell\Cell\obj\Debug\net8.0-windows\Cell_znczmuba_wpftmp.AssemblyInfo.cs", "C#", 11, 0, 0, 0, 0, 10, 5, 26
"c:\Users\chris\source\repos\Cell\Cell\obj\Debug\net8.0-windows\Cell_znczmuba_wpftmp.GeneratedMSBuildEditorConfig.editorconfig", "Properties", 0, 0, 0, 0, 21, 0, 1, 22
"c:\Users\chris\source\repos\Cell\Cell\obj\Debug\net8.0-windows\Cell_znczmuba_wpftmp.GlobalUsings.g.cs", "C#", 5, 0, 0, 0, 0, 1, 1, 7
"c:\Users\chris\source\repos\Cell\Cell\obj\Debug\net8.0-windows\Cell_znczmuba_wpftmp.sourcelink.json", "JSON", 0, 0, 0, 1, 0, 0, 0, 1
"c:\Users\chris\source\repos\Cell\Cell\obj\Debug\net8.0-windows\Cell_znsnpmje_wpftmp.AssemblyInfo.cs", "C#", 11, 0, 0, 0, 0, 10, 5, 26
"c:\Users\chris\source\repos\Cell\Cell\obj\Debug\net8.0-windows\Cell_znsnpmje_wpftmp.GeneratedMSBuildEditorConfig.editorconfig", "Properties", 0, 0, 0, 0, 21, 0, 1, 22
"c:\Users\chris\source\repos\Cell\Cell\obj\Debug\net8.0-windows\Cell_znsnpmje_wpftmp.GlobalUsings.g.cs", "C#", 5, 0, 0, 0, 0, 1, 1, 7
"c:\Users\chris\source\repos\Cell\Cell\obj\Debug\net8.0-windows\Cell_znsnpmje_wpftmp.sourcelink.json", "JSON", 0, 0, 0, 1, 0, 0, 0, 1
"c:\Users\chris\source\repos\Cell\Cell\obj\Debug\net8.0-windows\Cell_znwp1wtq_wpftmp.AssemblyInfo.cs", "C#", 11, 0, 0, 0, 0, 10, 5, 26
"c:\Users\chris\source\repos\Cell\Cell\obj\Debug\net8.0-windows\Cell_znwp1wtq_wpftmp.GeneratedMSBuildEditorConfig.editorconfig", "Properties", 0, 0, 0, 0, 21, 0, 1, 22
"c:\Users\chris\source\repos\Cell\Cell\obj\Debug\net8.0-windows\Cell_znwp1wtq_wpftmp.GlobalUsings.g.cs", "C#", 5, 0, 0, 0, 0, 1, 1, 7
"c:\Users\chris\source\repos\Cell\Cell\obj\Debug\net8.0-windows\Cell_znwp1wtq_wpftmp.sourcelink.json", "JSON", 0, 0, 0, 1, 0, 0, 0, 1
"c:\Users\chris\source\repos\Cell\Cell\obj\Debug\net8.0-windows\Cell_zoes0zn2_wpftmp.AssemblyInfo.cs", "C#", 11, 0, 0, 0, 0, 10, 5, 26
"c:\Users\chris\source\repos\Cell\Cell\obj\Debug\net8.0-windows\Cell_zoes0zn2_wpftmp.GeneratedMSBuildEditorConfig.editorconfig", "Properties", 0, 0, 0, 0, 13, 0, 1, 14
"c:\Users\chris\source\repos\Cell\Cell\obj\Debug\net8.0-windows\Cell_zoes0zn2_wpftmp.GlobalUsings.g.cs", "C#", 5, 0, 0, 0, 0, 1, 1, 7
"c:\Users\chris\source\repos\Cell\Cell\obj\Debug\net8.0-windows\Cell_zp0abt4x_wpftmp.AssemblyInfo.cs", "C#", 11, 0, 0, 0, 0, 10, 5, 26
"c:\Users\chris\source\repos\Cell\Cell\obj\Debug\net8.0-windows\Cell_zp0abt4x_wpftmp.GeneratedMSBuildEditorConfig.editorconfig", "Properties", 0, 0, 0, 0, 21, 0, 1, 22
"c:\Users\chris\source\repos\Cell\Cell\obj\Debug\net8.0-windows\Cell_zp0abt4x_wpftmp.GlobalUsings.g.cs", "C#", 5, 0, 0, 0, 0, 1, 1, 7
"c:\Users\chris\source\repos\Cell\Cell\obj\Debug\net8.0-windows\Cell_zp0abt4x_wpftmp.sourcelink.json", "JSON", 0, 0, 0, 1, 0, 0, 0, 1
"c:\Users\chris\source\repos\Cell\Cell\obj\Debug\net8.0-windows\Cell_zqhcgoaj_wpftmp.AssemblyInfo.cs", "C#", 11, 0, 0, 0, 0, 10, 5, 26
"c:\Users\chris\source\repos\Cell\Cell\obj\Debug\net8.0-windows\Cell_zqhcgoaj_wpftmp.GeneratedMSBuildEditorConfig.editorconfig", "Properties", 0, 0, 0, 0, 21, 0, 1, 22
"c:\Users\chris\source\repos\Cell\Cell\obj\Debug\net8.0-windows\Cell_zqhcgoaj_wpftmp.GlobalUsings.g.cs", "C#", 5, 0, 0, 0, 0, 1, 1, 7
"c:\Users\chris\source\repos\Cell\Cell\obj\Debug\net8.0-windows\Cell_zqhcgoaj_wpftmp.sourcelink.json", "JSON", 0, 0, 0, 1, 0, 0, 0, 1
"c:\Users\chris\source\repos\Cell\Cell\obj\Debug\net8.0-windows\Cell_zrbnxueb_wpftmp.AssemblyInfo.cs", "C#", 11, 0, 0, 0, 0, 10, 5, 26
"c:\Users\chris\source\repos\Cell\Cell\obj\Debug\net8.0-windows\Cell_zrbnxueb_wpftmp.GeneratedMSBuildEditorConfig.editorconfig", "Properties", 0, 0, 0, 0, 21, 0, 1, 22
"c:\Users\chris\source\repos\Cell\Cell\obj\Debug\net8.0-windows\Cell_zrbnxueb_wpftmp.GlobalUsings.g.cs", "C#", 5, 0, 0, 0, 0, 1, 1, 7
"c:\Users\chris\source\repos\Cell\Cell\obj\Debug\net8.0-windows\Cell_zrbnxueb_wpftmp.sourcelink.json", "JSON", 0, 0, 0, 1, 0, 0, 0, 1
"c:\Users\chris\source\repos\Cell\Cell\obj\Debug\net8.0-windows\Cell_zshk2r0q_wpftmp.AssemblyInfo.cs", "C#", 11, 0, 0, 0, 0, 10, 5, 26
"c:\Users\chris\source\repos\Cell\Cell\obj\Debug\net8.0-windows\Cell_zshk2r0q_wpftmp.GeneratedMSBuildEditorConfig.editorconfig", "Properties", 0, 0, 0, 0, 21, 0, 1, 22
"c:\Users\chris\source\repos\Cell\Cell\obj\Debug\net8.0-windows\Cell_zshk2r0q_wpftmp.GlobalUsings.g.cs", "C#", 5, 0, 0, 0, 0, 1, 1, 7
"c:\Users\chris\source\repos\Cell\Cell\obj\Debug\net8.0-windows\Cell_zshk2r0q_wpftmp.sourcelink.json", "JSON", 0, 0, 0, 1, 0, 0, 0, 1
"c:\Users\chris\source\repos\Cell\Cell\obj\Debug\net8.0-windows\Cell_zuq0gi1f_wpftmp.AssemblyInfo.cs", "C#", 11, 0, 0, 0, 0, 10, 5, 26
"c:\Users\chris\source\repos\Cell\Cell\obj\Debug\net8.0-windows\Cell_zuq0gi1f_wpftmp.GeneratedMSBuildEditorConfig.editorconfig", "Properties", 0, 0, 0, 0, 21, 0, 1, 22
"c:\Users\chris\source\repos\Cell\Cell\obj\Debug\net8.0-windows\Cell_zuq0gi1f_wpftmp.GlobalUsings.g.cs", "C#", 5, 0, 0, 0, 0, 1, 1, 7
"c:\Users\chris\source\repos\Cell\Cell\obj\Debug\net8.0-windows\Cell_zuq0gi1f_wpftmp.sourcelink.json", "JSON", 0, 0, 0, 1, 0, 0, 0, 1
"c:\Users\chris\source\repos\Cell\Cell\obj\Debug\net8.0-windows\Cell_zvbpcoc0_wpftmp.AssemblyInfo.cs", "C#", 11, 0, 0, 0, 0, 10, 5, 26
"c:\Users\chris\source\repos\Cell\Cell\obj\Debug\net8.0-windows\Cell_zvbpcoc0_wpftmp.GeneratedMSBuildEditorConfig.editorconfig", "Properties", 0, 0, 0, 0, 21, 0, 1, 22
"c:\Users\chris\source\repos\Cell\Cell\obj\Debug\net8.0-windows\Cell_zvbpcoc0_wpftmp.GlobalUsings.g.cs", "C#", 5, 0, 0, 0, 0, 1, 1, 7
"c:\Users\chris\source\repos\Cell\Cell\obj\Debug\net8.0-windows\Cell_zvbpcoc0_wpftmp.sourcelink.json", "JSON", 0, 0, 0, 1, 0, 0, 0, 1
"c:\Users\chris\source\repos\Cell\Cell\obj\Debug\net8.0-windows\Cell_zvoahpfo_wpftmp.AssemblyInfo.cs", "C#", 11, 0, 0, 0, 0, 10, 5, 26
"c:\Users\chris\source\repos\Cell\Cell\obj\Debug\net8.0-windows\Cell_zvoahpfo_wpftmp.GeneratedMSBuildEditorConfig.editorconfig", "Properties", 0, 0, 0, 0, 21, 0, 1, 22
"c:\Users\chris\source\repos\Cell\Cell\obj\Debug\net8.0-windows\Cell_zvoahpfo_wpftmp.GlobalUsings.g.cs", "C#", 5, 0, 0, 0, 0, 1, 1, 7
"c:\Users\chris\source\repos\Cell\Cell\obj\Debug\net8.0-windows\Cell_zvoahpfo_wpftmp.sourcelink.json", "JSON", 0, 0, 0, 1, 0, 0, 0, 1
"c:\Users\chris\source\repos\Cell\Cell\obj\Debug\net8.0-windows\Cell_zvwgua4x_wpftmp.AssemblyInfo.cs", "C#", 11, 0, 0, 0, 0, 10, 5, 26
"c:\Users\chris\source\repos\Cell\Cell\obj\Debug\net8.0-windows\Cell_zvwgua4x_wpftmp.GeneratedMSBuildEditorConfig.editorconfig", "Properties", 0, 0, 0, 0, 21, 0, 1, 22
"c:\Users\chris\source\repos\Cell\Cell\obj\Debug\net8.0-windows\Cell_zvwgua4x_wpftmp.GlobalUsings.g.cs", "C#", 5, 0, 0, 0, 0, 1, 1, 7
"c:\Users\chris\source\repos\Cell\Cell\obj\Debug\net8.0-windows\Cell_zvwgua4x_wpftmp.sourcelink.json", "JSON", 0, 0, 0, 1, 0, 0, 0, 1
"c:\Users\chris\source\repos\Cell\Cell\obj\Debug\net8.0-windows\Cell_zvwxvwpx_wpftmp.AssemblyInfo.cs", "C#", 11, 0, 0, 0, 0, 10, 5, 26
"c:\Users\chris\source\repos\Cell\Cell\obj\Debug\net8.0-windows\Cell_zvwxvwpx_wpftmp.GeneratedMSBuildEditorConfig.editorconfig", "Properties", 0, 0, 0, 0, 21, 0, 1, 22
"c:\Users\chris\source\repos\Cell\Cell\obj\Debug\net8.0-windows\Cell_zvwxvwpx_wpftmp.GlobalUsings.g.cs", "C#", 5, 0, 0, 0, 0, 1, 1, 7
"c:\Users\chris\source\repos\Cell\Cell\obj\Debug\net8.0-windows\Cell_zvwxvwpx_wpftmp.sourcelink.json", "JSON", 0, 0, 0, 1, 0, 0, 0, 1
"c:\Users\chris\source\repos\Cell\Cell\obj\Debug\net8.0-windows\Cell_zyxufis0_wpftmp.AssemblyInfo.cs", "C#", 11, 0, 0, 0, 0, 10, 5, 26
"c:\Users\chris\source\repos\Cell\Cell\obj\Debug\net8.0-windows\Cell_zyxufis0_wpftmp.GeneratedMSBuildEditorConfig.editorconfig", "Properties", 0, 0, 0, 0, 21, 0, 1, 22
"c:\Users\chris\source\repos\Cell\Cell\obj\Debug\net8.0-windows\Cell_zyxufis0_wpftmp.GlobalUsings.g.cs", "C#", 5, 0, 0, 0, 0, 1, 1, 7
"c:\Users\chris\source\repos\Cell\Cell\obj\Debug\net8.0-windows\Cell_zyxufis0_wpftmp.sourcelink.json", "JSON", 0, 0, 0, 1, 0, 0, 0, 1
"c:\Users\chris\source\repos\Cell\Cell\obj\Debug\net8.0-windows\Controls\CodeEditor.g.i.cs", "C#", 73, 0, 0, 0, 0, 15, 17, 105
"c:\Users\chris\source\repos\Cell\Cell\obj\Debug\net8.0-windows\Controls\PanAndZoomCanvas.g.i.cs", "C#", 51, 0, 0, 0, 0, 15, 12, 78
"c:\Users\chris\source\repos\Cell\Cell\obj\Debug\net8.0-windows\GeneratedInternalTypeHelper.g.cs", "C#", 26, 0, 0, 0, 0, 27, 10, 63
"c:\Users\chris\source\repos\Cell\Cell\obj\Debug\net8.0-windows\GeneratedInternalTypeHelper.g.i.cs", "C#", 26, 0, 0, 0, 0, 27, 10, 63
"c:\Users\chris\source\repos\Cell\Cell\obj\Debug\net8.0-windows\MainWindow.g.i.cs", "C#", 129, 0, 0, 0, 0, 15, 38, 182
"c:\Users\chris\source\repos\Cell\Cell\obj\Debug\net8.0-windows\PanAndZoomCanvas.g.i.cs", "C#", 50, 0, 0, 0, 0, 15, 12, 77
"c:\Users\chris\source\repos\Cell\Cell\obj\Debug\net8.0-windows\View\ApplicationView.g.cs", "C#", 135, 0, 0, 0, 0, 15, 42, 192
"c:\Users\chris\source\repos\Cell\Cell\obj\Debug\net8.0-windows\View\ApplicationView.g.i.cs", "C#", 135, 0, 0, 0, 0, 15, 42, 192
"c:\Users\chris\source\repos\Cell\Cell\obj\Debug\net8.0-windows\View\CellTextEditBar.g.cs", "C#", 69, 0, 0, 0, 0, 15, 15, 99
"c:\Users\chris\source\repos\Cell\Cell\obj\Debug\net8.0-windows\View\CellTextEditBar.g.i.cs", "C#", 69, 0, 0, 0, 0, 15, 15, 99
"c:\Users\chris\source\repos\Cell\Cell\obj\Debug\net8.0-windows\View\CodeEditor.g.cs", "C#", 130, 0, 0, 0, 0, 15, 38, 183
"c:\Users\chris\source\repos\Cell\Cell\obj\Debug\net8.0-windows\View\CodeEditor.g.i.cs", "C#", 130, 0, 0, 0, 0, 15, 38, 183
"c:\Users\chris\source\repos\Cell\Cell\obj\Debug\net8.0-windows\View\Controls\BetterCheckBox.g.i.cs", "C#", 51, 0, 0, 0, 0, 15, 12, 78
"c:\Users\chris\source\repos\Cell\Cell\obj\Debug\net8.0-windows\View\Controls\BetterComboBox.g.i.cs", "C#", 51, 0, 0, 0, 0, 15, 12, 78
"c:\Users\chris\source\repos\Cell\Cell\obj\Debug\net8.0-windows\View\Controls\generic.g.i.cs", "C#", 69, 0, 0, 0, 0, 15, 15, 99
"c:\Users\chris\source\repos\Cell\Cell\obj\Debug\net8.0-windows\View\EditCellPanel - Copy.g.i.cs", "C#", 243, 0, 0, 0, 0, 15, 73, 331
"c:\Users\chris\source\repos\Cell\Cell\obj\Debug\net8.0-windows\View\EditCellPanel.g.cs", "C#", 338, 0, 0, 0, 0, 15, 99, 452
"c:\Users\chris\source\repos\Cell\Cell\obj\Debug\net8.0-windows\View\EditCellPanel.g.i.cs", "C#", 338, 0, 0, 0, 0, 15, 99, 452
"c:\Users\chris\source\repos\Cell\Cell\obj\Debug\net8.0-windows\View\MainWindow.g.i.cs", "C#", 129, 0, 0, 0, 0, 15, 40, 184
"c:\Users\chris\source\repos\Cell\Cell\obj\Debug\net8.0-windows\View\PanAndZoomCanvas.g.cs", "C#", 51, 0, 0, 0, 0, 15, 12, 78
"c:\Users\chris\source\repos\Cell\Cell\obj\Debug\net8.0-windows\View\PanAndZoomCanvas.g.i.cs", "C#", 51, 0, 0, 0, 0, 15, 12, 78
"c:\Users\chris\source\repos\Cell\Cell\obj\Debug\net8.0-windows\View\SheetView.g.cs", "C#", 88, 0, 0, 0, 0, 15, 23, 126
"c:\Users\chris\source\repos\Cell\Cell\obj\Debug\net8.0-windows\View\SheetView.g.i.cs", "C#", 88, 0, 0, 0, 0, 15, 23, 126
"c:\Users\chris\source\repos\Cell\Cell\obj\Debug\net8.0-windows\View\TitleBarSheetNavigation.g.cs", "C#", 77, 0, 0, 0, 0, 15, 17, 109
"c:\Users\chris\source\repos\Cell\Cell\obj\Debug\net8.0-windows\View\TitleBarSheetNavigation.g.i.cs", "C#", 77, 0, 0, 0, 0, 15, 17, 109
"c:\Users\chris\source\repos\Cell\Cell\obj\Debug\net8.0-windows\View\TypeSpecificEditCellPanel.g.cs", "C#", 75, 0, 0, 0, 0, 15, 17, 107
"c:\Users\chris\source\repos\Cell\Cell\obj\Debug\net8.0-windows\View\TypeSpecificEditCellPanel.g.i.cs", "C#", 75, 0, 0, 0, 0, 15, 17, 107
"c:\Users\chris\source\repos\Cell\Cell\obj\project.assets.json", "JSON", 0, 0, 0, 1287, 0, 0, 0, 1287
"Total", "-", 30240, 4, 4774, 12690, 27486, 15929, 11417, 102540